آخر	ʔ aː x ɪ r
آخر	ʔ æː x ɪ r
آخرة	ʔ æː x r e
آذار	ʔ a zˤ ɑː rˤ
آذار	ʔ a ðˤ ɑː rˤ
آسف	ʔ æː s ɪ f
آلة	ʔ æː l e
آمن	ʔ æː m a n
آنس	ʔ æː n a s
آه	ʔ ɑː
أباجور	ʔ a b a ʒ oː r
أبدا	ʔ a b a d a n
أبدع	ʔ a b d a ʕ
أبرز	ʔ a b r a z
أبسط	ʔ ɑ b sˤ ɑ tˤ
أبطل	ʔ ɑ b tˤ ɑ l
أبعد	ʔ a b ʕ a d
أبن	ʔ a b b a n
أتر	ʔ a t t a r
أتلج	ʔ a t l a d͡ʒ
أتلج	ʔ a t l a ʒ
أثبت	ʔ a s b a t
أثر	ʔ a s s a r
أثر	ʔ a θ θ a r
أجار	ʔ ɑ j ɑː rˤ
أجر	ʔ a ʒ ʒ a r
أجل	ʔ a d d͡ʒ a l
أجل	ʔ a ʒ ʒ a l
أجنبي	ʔ a d͡ʒ n a b i
أجنبي	ʔ a ʒ n a b i
أحرج	ʔ a ħ r a d͡ʒ
أحرج	ʔ a ħ r a ʒ
أحرز	ʔ a ħ r a z
أخد	ʔ a x a d
أخطى	ʔ ɑ x tˤ ɑ
أخفى	ʔ a x f a
أخلى	ʔ a x l a
أخيرا	ʔ a xː i r a n
أدار	ʔ a d ɑː r
أدمن	ʔ a d m a n
أذى	ʔ a z a
أربع	ʔ a r b ɑ ʔ
أربعة	ʔ a r b ɑ ʕ a
أربعتعش	ʔ a r b ɑ ʕ tˤ ɑ ʃ
أرجل	ʔ a r ɡ a l
أرجيلة	ʔ a r ɡ iː l e
أرشد	ʔ a r ʃ a d
أرض	ʔ ɑ rˤ dˤ
أرضى	ʔ ɑ rˤ dˤ ɑ
أرمني	ʔ a r m a n i
أرمينيا	ʔ a r m iː n j a
أرنب	ʔ a r n a b
أزعج	ʔ a z ʕ a d͡ʒ
أزعج	ʔ a z ʕ a ʒ
أزمة	ʔ a z m e
أسبوع	ʔ ʊ s b uː ʕ
أسرع	ʔ a s r a ʕ
أسس	ʔ a s s a s
أسكر	ʔ a s k a r
أشتى	ʔ a ʃ t a
أشخاص	ʔ a ʃ x ɑː sˤ
أشر	ʔ a ʃ ʃ a r
أشرك	ʔ a ʃ r a k
أشهر	ʔ a ʃ h o r
أصاب	ʔ ɑ sˤ ɑː b
أصبح	ʔ ɑ sˤ b ɑ ħ
أصبع	ʔ ʊ sˤ b ɑ ʕ
أصحاب	ʔ ʌ sˤ ħ ɑː b
أصدقاء	ʔ ʌ sˤ dˤ ɪ q ɑː ʔ
أصلح	ʔ ɑ sˤ lˤ ɑ ħ
أضاف	ʔ a dˤ ɑː f
أضرب	ʔ a dˤ rˤ ɑ b
أضفر	ʔ ʊ dˤ f ɑ rˤ
أعار	ʔ a ʕ ɑː rˤ
أعجب	ʔ a ʕ d͡ʒ a b
أعجب	ʔ a ʕ ʒ a b
أعدى	ʔ a ʕ d a
أعطى	ʔ a ʕ tˤ ɑ
أعفى	ʔ a ʕ f a
أعلن	ʔ a ʕ l a n
أعمى	ʔ a ʕ m a
أغرى	ʔ a ɣ r a
أفاد	ʔ a f æː d
أفرج	ʔ a f r a d͡ʒ
أفرج	ʔ a f r a ʒ
أفرح	ʔ ɑ f rˤ ɑ ħ
أفلس	ʔ a f l a s
أقل	ʔ a ɡ a l
أقل	ʔ a ʔ a l
أقنع	ʔ ɑ q n a ʕ
أكد	ʔ a k k a d
أكرم	ʔ a k r a m
أكل	ʔ a k a l
أكل	ʔ a k ɪ l
أكلة	ʔ a k l e
أكم	ʔ a k a m
أكيل	ʔ a k k iː l
ألغى	ʔ a l ɣ a
ألف	ʔ a l l a f
ألمانيا	ʔ a l mˤ ɑː n j a
ألهى	ʔ a l h a
أما	ʔ a m m a
أمر	ʔ ɑ m ɑ rˤ
أمم	ʔ a m m a m
أمن	ʔ a m m a n
أمهل	ʔ a m h a l
أنا	ʔ a n a
أنعم	ʔ a n ʕ a m
أنف	ʔ a n f
أنقذ	ʔ ɑ n q ɑ z
أنهى	ʔ a n h a
أهان	ʔ a h æː n
أهدى	ʔ a h d a
أهل	ʔ a h ɪ l
أهمل	ʔ a h m a l
أواعي	ʔ a w æː ʕ i
أوتيل	ʔ o t eː l
أوضة	ʔ oː dˤ ɑ
أيام	ʔ a j j æː m
أيد	ʔ a j j a d
إبريق	ʔ ɪ b r iː ʔ
إجا	ʔ i d͡ʒ a
إجا	ʔ i ʒ a
إجازة	ʔ ɪ d͡ʒ æː z e
إجازة	ʔ ɪ ʒ æː z e
إنجاص	ʔ ɪ n d͡ʒ ɑː sˤ
إنجاص	ʔ ɪ n ʒ ɑː sˤ
إيش	ʔ eː ʃ
ابتز	ɪ b t a z
ابتسم	ɪ b t a s a m
اتحد	ɪ t t a ħ a d
اتصل	ɪ tˤ tˤ ɑ sˤ ɑ l
اتفق	ɪ t t a f a ʔ
اتكل	ɪ t t a k a l
اتهم	ɪ t t a h a m
اجتماع	ɪ d͡ʒ t i m æː ʕ
اجتماع	ɪ ʒ t i m æː ʕ
اجتمع	ɪ d͡ʒ t a m a ʕ
اجتمع	ɪ ʒ t a m a ʕ
اجر	ʔ i ʒ ɪ r
احتاج	ɪ ħ t æː d͡ʒ
احتاج	ɪ ħ t æː ʒ
احتج	ɪ ħ t a d͡ʒ
احتج	ɪ ħ t a ʒ
احترم	ɪ ħ t a r a m
احتفل	ɪ ħ t a f a l
احتل	ɪ ħ t a l l
احنا	ʔ ɪ ħ n a
اختار	ɪ x tˤ ɑː rˤ
اخترع	ɪ x t a r a ʕ
اختصر	ɪ x t ɑ sˤ ɑ r
اختفى	ɪ x t a f a
اختلط	ɪ x tˤ ɑ l ɑ tˤ
اختلف	ɪ x t a l a f
ارتاح	ɪ r t æː ħ
ارتكب	ɪ r t a k a b
استأجر	ɪ s t a ʔ d͡ʒ a r
استأجر	ɪ s t a ʔ ʒ a r
استاهل	ɪ s t æː h a l
استثمر	ɪ s t a θ m a r
استجوب	ɪ s t a d͡ʒ w a b
استجوب	ɪ s t a ʒ w a b
استحق	ɪ s t a ħ a ɡ
استحق	ɪ s t a ħ a ʔ
استحلى	ɪ s t a ħ l a
استحى	ɪ s t a ħ a
استخدم	ɪ s t a x d a m
استخف	ɪ s t a x a f
استراح	ɪ s t a rˤ ɑː ħ
استراحة	ɪ s t i r ɑː ħ ɑ
استسلم	ɪ s t a s l a m
استشار	ɪ s t a ʃ ɑː rˤ
استشهد	ɪ s t a ʃ h a d
استعار	ɪ s t a ʕ ɑː r
استعجل	ɪ s t a ʕ d͡ʒ a l
استعجل	ɪ s t a ʕ ʒ a l
استعمر	ɪ s t a ʕ m a r
استعمل	ɪ s t a ʕ m a l
استغرب	ɪ s t a ɣ r a b
استغنى	ɪ s t a ɣ n a
استفاد	ɪ s t a f æː d
استفز	ɪ s t a f a z
استقال	ɪ s t a q ɑː l
استقبل	ɪ s t a ʔ b a l
استقل	ɪ s t a ɡ a l
استقل	ɪ s t a ʔ a l
استلذ	ɪ s t a l a z
استمر	ɪ s t a m a r
استنى	ɪ s t a n n a
استورد	ɪ s t a w r a d
استوطن	ɪ s tˤ ɑ w tˤ ɑ n
استوى	ɪ s t a w a
اسم	ʔ i s ɪ m
اسم	ʔ u s ʊ m
اشتاق	ɪ ʃ t æː ʔ
اشترك	ɪ ʃ t a r a k
اشترى	ɪ ʃ t a r a
اشتغل	ɪ ʃ t a ɣ a l
اضطر	ɪ tˤ tˤ ɑ rˤ
اعتبر	ɪ ʕ t a b a r
اعتذر	ɪ ʕ t a z a r
اعترض	ɪ ʕ tˤ ʌ rˤ ʌ dˤ
اعترف	ɪ ʕ t a r a f
اعتزل	ɪ ʕ t a z a l
اعتقد	ɪ ʕ t a ɡ a d
اعتقد	ɪ ʕ t a ʔ a d
اعتقل	ɪ ʕ t a q a l
اعتمد	ɪ ʕ t a m a d
اغتال	ɪ ɣ t æː l
اغتصب	ɪ ɣ t ɑ sˤ ɑ b
افتخر	ɪ f t a x a r
افترض	ɪ f t ɑ rˤ ɑ dˤ
اقتحم	ɪ q tˤ ɑ ħ ɑ m
اقترح	ɪ q tˤ ɑ rˤ ɑ ħ
اكتشف	ɪ k t a ʃ a f
الأحد	ɪ l ʔ a ħ a d
الأربعا	ɪ l ʔ a r b ɪ ʕ a
الأردن	ɪ l ʔ u r d ʊ n
الإتنين	ɪ l ʔ ɪ t n eː n
البترا	ɪ l b ɑ t r ɑ
التخم	ɪ l t a x a m
التزم	ɪ l t a z a m
التغى	ɪ l t a ɣ a
التقى	ɪ l t a ʔ a
التلاتا	ɪ t t a l æː t a
التلاتا	ɪ t t u l aː t a
التهب	ɪ l t a h a b
الجليل	ɪ l d͡ʒ a l iː l
الجليل	ɪ l ʒ a l iː l
الجمعة	ɪ l d͡ʒ ʊ m ʕ a
الجمعة	ɪ l ʒ ʊ m ʕ a
الجمعة	ɪ ʒ ʒ ʊ m ʕ a
الجولان	ɪ l d͡ʒ uː l æː n
الجولان	ɪ l ʒ uː l æː n
الخليل	ɪ l x a l iː l
الخميس	ɪ l x a m iː s
السبت	ɪ s s a b ɪ t
القدس	ɪ l ʔ ʊ d s
الله	ʔ ɑ lˤ lˤ ɑ
الله	ʔ ɑ lˤ lˤ ɑː h
الليلة	i l l eː l e
الناصرة	ɪ n n ɑː sˤ r ɑ
النقب	ɪ n n ɑ q ɑ b
اليوم	i l y oː m
اليونان	ɪ l j uː n aː n
امتنع	ɪ m t a n a ʕ
انأذى	ɪ n ʔ a z a
انباع	ɪ n b æː ʕ
انبسط	ɪ n b ɑ s ɑ tˤ
انبل	ɪ n b a l
انت	ʔ ɪ n t a
انت	ʔ ɪ n t e
انتاك	ɪ n t æː k
انتبه	ɪ n t a b a h
انتحر	ɪ n t a ħ a r
انتخب	ɪ n t a x a b
انتشر	ɪ n t a ʃ a r
انتصر	ɪ n tˤ ɑ sˤ ɑ r
انتفخ	ɪ n t a f a x
انتقل	ɪ n t a ɡ a l
انتقل	ɪ n t a ʔ a l
انتمى	i n t a m a
انتو	ʔ ɪ n t u
انتي	ʔ ɪ n t i
انجرح	ɪ n d͡ʒ a r a ħ
انجرح	ɪ n ʒ a r a ħ
انحاز	ɪ n ħ æː z
انحبس	ɪ n ħ a b a s
انحرج	ɪ n ħ a r a d͡ʒ
انحرج	ɪ n ħ a r a ʒ
انحرق	ɪ n ħ ɑ r ɑ ɡ
انحرق	ɪ n ħ ɑ r ɑ ʔ
انحكى	ɪ n ħ a k a
انحل	ɪ n ħ a l
اندمج	ɪ n d a m a d͡ʒ
اندمج	ɪ n d a m a ʒ
انزاد	ɪ n z æː d
انزار	ɪ n z ɑː rˤ
انزعج	ɪ n z a ʕ a d͡ʒ
انزعج	ɪ n z a ʕ a ʒ
انسجن	ɪ n s a d͡ʒ a n
انسجن	ɪ n s a ʒ a n
انسحب	ɪ n s a ħ a b
انسرق	ɪ n s a r a ɡ
انسرق	ɪ n s a r a ʔ
انشاف	ɪ n ʃ æː f
انشغل	ɪ n ʃ a ɣ a l
انشفى	ɪ n ʃ a f a
انشهر	ɪ n ʃ a h a rˤ
انضم	ɪ n dˤ ɑ m
انعدى	ɪ n ʕ a d a
انعمل	ɪ n ʕ a m a l
انعمى	ɪ n ʕ a m a
انغلى	ɪ n ɣ a l a
انفتح	ɪ n f a t a ħ
انفجر	ɪ n f a d͡ʒ a r
انفجر	ɪ n f a ʒ a r
انفصل	ɪ n f ɑ sˤ ɑ l
انفضح	ɪ n f ɑ dˤ ɑ ħ
انفك	ɪ n f a k
انفهق	ɪ n f a h a ɡ
انقال	ɪ n ɡ æː l
انقال	ɪ n ʔ æː l
انقطع	ɪ n ʔ ɑ tˤ ɑ ʕ
انكب	ɪ n k a b
انكتب	ɪ n k a t a b
انمسك	ɪ n m a s a k
انهار	ɪ n h ɑː rˤ
انولد	ɪ n w a l a d
اهتم	i h t a m
ايد	ʔ iː d
باب	b æː b
بابا	b ɑˤː bˤ ɑ
باحث	b æː ħ ɪ s
بارد	b æː r ɪ d
بارك	b æː r a k
بازلا	b æː z e l l a
باس	b æː s
باص	b ɑː sˤ
باع	b æː ʕ
بال	b æː l
بالغ	b æː l a ɣ
بان	b æː n
باي	bˤ ɑː j
ببو	b u b b u
بتر	b a t a r
بتنجان	b e t i n d͡ʒ æː n
بتنجان	b e t i n ʒ æː n
بث	b a θ
بحث	b a ħ a s
بحر	b ɑ ħ ɑ rˤ
بحيرة	b ʊ ħ a j rˤ ɑ
بد	b ɪ d
بدا	b a d a
بداية	b i d æː j e
بدري	b a d r i
بدع	b a d d a ʕ
بدل	b a d d a l
بدون	b ɪ d uː n
بذر	b i z ɪ r
برد	b a r a d
برد	b a r d
برد	b a r r a d
بردان	b a r d æː n
برداية	b u r d æː j e
بردقان	b u r d ʔ æː n
برر	b a r r a r
برضه	b ʌ rˤ dˤ o
برق	b a r a ɡ
برق	b a r a ʔ
برنامج	b a r n æː m ɪ d͡ʒ
برنامج	b a r n æː m ɪ ʒ
برودة	b u r uː d e
بس	b a s
بس	b ɪ s
بسرعة	b s ʊ r ʕ a
بسط	b ɑ s s ɑ tˤ
بسيدر	b s eː d ɪ r
بشع	b a ʃ ʃ a ʕ
بصل	b ɑ sˤ ɑ l
بطل	b ɑ tˤ tˤ ɑ l
بطيخ	b ɑ tˤ tˤ iː x
بعبش	b a ʕ b a ʃ
بعت	b a ʕ a t
بعتر	b a ʕ t a r
بعد	b a ʕ ɪ d
بعدين	b a ʕ d eː n
بعزق	b a ʕ z a ɡ
بعزق	b a ʕ z a ʔ
بعص	b ɑ ʕ ɑ sˤ
بعض	b a ʕ dˤ
بعيد	b a ʕ iː d
بقى	b a k a
بقي	b i ɡ i
بقي	b i ʔ i
بكر	b a k k a r
بكرة	b u k rˤ ɑ
بكى	b a k a
بكير	b a k k iː r
بل	b a l
بلا	b a l a
بلاش	b a l æː ʃ
بلش	b a l l a ʃ
بلغ	b a l l a ɣ
بلف	b a l a f
بنات	b a n æː t
بناية	b ɪ n aː j e
بناية	b ɪ n æː j e
بنت	b ɪ n t
بندورة	b a n d oː rˤ ɑ
بنى	b a n a
بهار	b h ɑː rˤ
بهدل	b a h d a l
بول	b a w w a l
بيت	b eː t
بين	b a j j a n
بين	b eː n
بينما	b e j n a m a
ة	a
ة	e
ة	ɑ
ة	ɛ
تأخر	ɪ t ʔ a x x a r
تأذى	ɪ t ʔ a z z a
تأكد	ɪ t ʔ a k k a d
تأهل	ɪ t ʔ a h h a l
تار	t ɑː rˤ
تبادل	ɪ t b æː d a l
تبخر	ɪ t b a x x a r
تبدل	ɪ t b a d d a l
تبرع	ɪ t b a r r a ʕ
تبع	t a b a ʕ
تجاهل	ɪ d d͡ʒ æː h a l
تجاهل	ɪ d ʒ æː h a l
تجمع	ɪ d d͡ʒ a m m a ʕ
تجمع	ɪ d ʒ a m m a ʕ
تجنب	ɪ d d͡ʒ a n n a b
تجنب	ɪ d ʒ a n n a b
تجوز	i d d͡ʒ a w w a z
تجوز	i d ʒ a w w a z
تجول	ɪ d d͡ʒ a w w a l
تجول	ɪ d ʒ a w w a l
تحارب	ɪ t ħ æː r a b
تحت	t a ħ t
تحدث	ɪ t ħ a d d a s
تحدى	ɪ t ħ a d d a
تحرش	ɪ t ħ a r r a ʃ
تحرك	ɪ t ħ a r r a k
تحسن	ɪ t ħ a s s a n
تحكم	ɪ t ħ a k k a m
تحمس	ɪ t ħ a m m a s
تحمل	ɪ t ħ a m m a l
تحمم	ɪ t ħ a m m a m
تحول	ɪ t ħ a w w a l
تخانق	ɪ t x æː n a ɡ
تخانق	ɪ t x æː n a ʔ
تخبى	ɪ t x a b b a
تخجل	ɪ t x a d d͡ʒ a l
تخجل	ɪ t x a ʒ ʒ a l
تخرج	ɪ t x a r r a d͡ʒ
تخرج	ɪ t x a r r a ʒ
تخرف	ɪ t x ɑ rˤ rˤ ɑ f
تخصص	ɪ t x ɑ sˤ sˤ ɑ sˤ
تخلف	ɪ t x a l l a f
تخلى	ɪ t x a l l a
تخوت	ɪ t x a w w a t
تخوف	ɪ t x a w w a f
تخيل	ɪ t x a j j a l
تدخل	ɪ d d a x x a l
تدرب	ɪ d d a r r a b
تدوش	ɪ d d a w w a ʃ
تذكر	ɪ d z a k k a r
تذكرة	t a z k ɑ rˤ ɑ
تراجع	ɪ t r æː d͡ʒ a ʕ
تراجع	ɪ t r æː ʒ a ʕ
تراهن	ɪ t rˤ ɑː h ɑ n
تربى	ɪ t rˤ ɑ b b ɑ
ترجم	t a r d͡ʒ a m
ترجم	t a r ʒ a m
ترك	t a r a k
تزوج	i d z a w w a d͡ʒ
تزوج	i d z a w w a ʒ
تساءل	ɪ t s æː ʔ a l
تسرب	ɪ t s a r r a b
تسرع	ɪ t s a r r a ʕ
تسع	t i s ʕ
تسعة	t ɪ s ʕ a
تسعتعش	t i s a ʕ tˤ ɑ ʃ
تسكر	ɪ t s a k k a r
تسلى	ɪ t s a l l a
تشتت	ɪ t ʃ a t t a t
تشمس	ɪ t ʃ a m m a s
تصالح	ɪ t sˤ ɑː lˤ ɑ ħ
تصرف	ɪ t sˤ ɑ rˤ rˤ ɑ f
تصور	ɪ t sˤ ɑ w w ɑ rˤ
تضايق	ɪ d d æː j a ʔ
تطلع	ɪ tˤ tˤ ʌ l l a ʕ
تطمن	ɪ tˤ tˤ ɑ m m ɑ n
تطور	ɪ tˤ tˤ ʌ w w ʌ r
تعامل	ɪ t ʕ æː m a l
تعاون	ɪ t ʕ æː w a n
تعايش	ɪ t ʕ æː j a ʃ
تعب	t a ʕ ʕ a b
تعب	t i ʕ ɪ b
تعبان	t a ʕ b æː n
تعجب	ɪ t ʕ a d d͡ʒ a b
تعجب	ɪ t ʕ a ʒ ʒ a b
تعدى	ɪ t ʕ a d d a
تعرض	ɪ t ʕ a r r a dˤ
تعرف	ɪ t ʕ ɑ rˤ rˤ ɑ f
تعشى	ɪ t ʕ a ʃ ʃ a
تعلق	ɪ t ʕ a l l a ʔ
تعلم	ɪ t ʕ a l l a m
تعود	ɪ t ʕ a w w a d
تغدى	ɪ t ɣ a d d a
تغسل	ɪ t ɣ a s s a l
تغلب	ɪ t ɣ a l l a b
تغير	ɪ d ɣ a j j a r
تف	t a f
تفاجأ	ɪ t f æː d͡ʒ a ʔ
تفاجأ	ɪ t f æː ʒ a ʔ
تفاح	t u f f æː ħ
تفرج	ɪ t f a r r a d͡ʒ
تفرج	ɪ t f a r r a ʒ
تفضل	ɪ t f ɑ dˤ dˤ ɑ l
تقابل	ɪ t ɡ æː b a l
تقابل	ɪ t ʔ æː b a l
تقاتل	ɪ t ɡ æː t a l
تقاتل	ɪ t ʔ æː t a l
تقارب	ɪ t ʔ ɑː rˤ ɑ b
تقاسم	ɪ t ʔ æː s a m
تقاعد	ɪ t q ɑː ʕ ɑ d
تقبل	ɪ t ʔ a b b a l
تقدم	ɪ d ɡ a d d a m
تقدم	ɪ t ʔ a d d a m
تكبر	ɪ t k a b b a r
تلات	t a l aː t
تلات	t a l æː t
تلاتة	t a l aː t e
تلاتة	t a l æː t e
تلاتة	t l aː t e
تلاتة	t l æː t e
تلاعب	ɪ t l æː ʕ a b
تلتعش	t a l a tˤ tˤ ɑ ʃ
تلج	t a l l a d͡ʒ
تلج	t a l l a ʒ
تلفن	t a l f a n
تم	t ɪ m
تمام	t a m æː m
تمانية	t a m a n j e
تمدد	ɪ t m a d d a d
تمر	t a m ɪ r
تمرد	ɪ t m a r r a d
تمرن	ɪ t m a r r a n
تمشى	ɪ t m a ʃ ʃ a
تمن	t a m a n
تمنتعش	t a m a n tˤ ɑ ʃ
تمنى	ɪ t m a n n a
تنازل	ɪ t n æː z a l
تنتين	t ɪ n t eː n
تندم	ɪ t n a d d a m
تنصت	ɪ t n ɑ sˤ sˤ ɑ t
تنعش	tˤ n ɑ ʃ
تنفس	ɪ t n a f f a s
تنكر	ɪ t n a k k a r
تنمر	ɪ t n a m m a r
تنى	t a n a
تنين	t n eː n
تهاوش	ɪ t h æː w a ʃ
تهرب	ɪ t h ʌ rˤ rˤ ʌ b
تواصل	ɪ t w ɑː sˤ ɑ l
توب	t oː b
توبة	t oː b e
توج	t a w w a d͡ʒ
توج	t a w w a ʒ
توجه	ɪ t w a d d͡ʒ a h
توجه	ɪ t w a ʒ ʒ a h
توسع	ɪ t w a s s a ʕ
توصل	ɪ t w ɑ sˤ sˤ ɑ l
توفى	ɪ t w a f f a
توقع	ɪ t w a ɡ ɡ a ʕ
توقع	ɪ t w a ʔ ʔ a ʕ
توقف	ɪ t w a ʔ ʔ a f
ثانية	s aː n j e
ثانية	s æː n j e
ثانية	θ aː n j e
ثانية	θ æː n j e
ثقف	θ ɑ q q ɑ f
ثلج	t a l l a d͡ʒ
ثلج	t a l l a ʒ
جاب	d͡ʒ aː b
جاب	d͡ʒ æː b
جاب	ʒ aː b
جاب	ʒ æː b
جاع	d͡ʒ æː ʕ
جاع	ʒ æː ʕ
جاهد	d͡ʒ æː h a d
جاهد	ʒ æː h a d
جاوب	d͡ʒ æː w a b
جاوب	ʒ æː w a b
جاي	d͡ʒ æː j
جاي	ʒ æː j
جبر	d͡ʒ a b a r
جبر	ʒ a b a r
جبنة	d͡ʒ ɪ b n e
جبنة	ʒ ɪ b n e
جدد	d͡ʒ a d d a d
جدد	ʒ a d d a d
جرب	d͡ʒ ɑ rˤ rˤ ɑ b
جرب	ʒ ɑ rˤ rˤ ɑ b
جرح	d͡ʒ a r a ħ
جرح	ʒ a r a ħ
جزر	d͡ʒ a z ɑ rˤ
جزر	ʒ a z ɑ rˤ
جسر	d͡ʒ ɪ s e r
جسر	ʒ ɪ s e r
جلى	d͡ʒ a l a
جلى	ʒ a l a
جمد	d͡ʒ a m m a d
جمد	d͡ʒ i m ɪ d
جمد	ʒ a m m a d
جمد	ʒ i m ɪ d
جمع	d͡ʒ a m a ʕ
جمع	ʒ a m a ʕ
جمل	d͡ʒ a m m a l
جمل	ʒ a m m a l
جنب	d͡ʒ a m b
جنب	ʒ a m b
جند	d͡ʒ a n n a d
جند	ʒ a n n a d
جنن	d͡ʒ a n n a n
جنن	ʒ a n n a n
جهز	d͡ʒ a h h a z
جهز	ʒ a h h a z
جوز	ʒ oː z
جوع	d͡ʒ a w w a ʕ
جوع	ʒ a w w a ʕ
جوعان	d͡ʒ u ʕ æː n
جوعان	ʒ u ʕ æː n
حابب	ħ æː b ɪ b
حارب	ħ æː r a b
حاسس	ħ æː s ɪ s
حاطط	ħ ɑː tˤ ɨ tˤ
حافظ	ħ ɑː f ɑ zˤ
حاليا	ħ aː l i j j a n
حاليا	ħ æː l i j j a n
حامي	ħ æː m i
حاول	ħ æː w a l
حب	ħ a b
حبة	ħ a b b e
حبس	ħ a b a s
حبيب	ħ a b iː b
حتى	ħ a t t a
حجز	ħ a d͡ʒ a z
حجز	ħ a ʒ a z
حد	ħ a d
حدث	ħ a d d a s
حدد	ħ a d d a d
حدعش	ħ d a ʃ
حذر	ħ a z z a r
حذر	ħ a ð ð a r
حذف	ħ a z a f
حر	ħ a r
حرارة	ħ a rˤ ɑː rˤ ɑ
حرر	ħ a r r a r
حرق	ħ a r a ʔ
حرق	ħ ɑ r ɑ ɡ
حرك	ħ a r r a k
حرم	ħ a r r a m
حزر	ħ i z ɪ r
حزن	ħ a z z a n
حزن	ħ i z ɪ n
حزنان	ħ a z n æː n
حس	ħ a s
حسب	ħ a s a b
حسد	ħ a s a d
حسس	ħ a s s a s
حسن	ħ a s s a n
حشى	ħ a ʃ a
حضر	ħ i dˤ ɪ r
حضر	ħ ɑ dˤ dˤ ɑ rˤ
حط	ħ ɑ tˤ
حفظ	ħ ɪ f ɪ zˤ
حق	ħ a ʔ
حقق	ħ a ɡ ɡ a ɡ
حقق	ħ a ʔ ʔ a ʔ
حك	ħ a k
حكم	ħ a k a m
حكم	ħ a k k a m
حكى	ħ a k a
حل	ħ a l
حلق	ħ a l a ʔ
حلل	ħ a l l a l
حلم	ħ i l ɪ m
حلو	ħ ɪ l ʊ
حلى	ħ a l l a
حليب	ħ a l iː b
حم	ħ a m
حمس	ħ a m m a s
حمص	ħ ɑ m m ɑ sˤ
حمق	ħ i m ɪ ɡ
حمق	ħ i m ɪ ʔ
حمل	ħ a m a l
حمل	ħ a m m a l
حمم	ħ a m m a m
حمى	ħ a m a
حمي	ħ i m i
حميان	ħ a m j æː n
حن	ħ a n
حول	ħ a w w a l
حياة	ħ a j æː
حيفا	ħ eː f a
خاشوقة	x ɑː ʃ uː q a
خاشوقة	x ɑː ʃ uː ɡ a
خاف	x æː f
خالف	x æː l a f
خبر	x a b b a r
خبز	x a b a z
خبز	x ʊ b ɪ z
خبط	x ɑ b ɑ tˤ
خبى	x a b b a
خجل	x a d d͡ʒ a l
خجل	x a ʒ ʒ a l
خدم	x a d a m
خرب	x a r r a b
خرب	x i r ɪ b
خربان	x ɑ rˤ b ɑː n
خربش	x a r b a ʃ
خربط	x ɑ rˤ b ɑ tˤ
خرس	x i r ɪ s
خرف	x a r r a f
خري	x i r i
خس	x a s
خسر	x i s ɪ r
خش	x a ʃ
خص	x ɑ sˤ
خصص	x ɑ sˤ sˤ ɑ sˤ
خضرة	x ʊ dˤ r ɑ
خطب	x ɑ tˤ ɑ b
خطط	x ɑ tˤ tˤ ɑ tˤ
خطف	x ɑ tˤ ɑ f
خفف	x a f f a f
خلص	x ɑ l l ɑ sˤ
خلص	x ɑ l ɑ sˤ
خلط	x ɑ lˤ lˤ ɑ tˤ
خلط	x ɑ lˤ ɑ tˤ
خلع	x a l a ʕ
خلف	x a l a f
خلف	x a l l a f
خلى	x a l l a
خمس	x a m s
خمسة	x a m s e
خمستعش	x a m ɪ s tˤ ɑ ʃ
خنق	x a n a ɡ
خنق	x a n a ʔ
خوخ	x oː x
خوف	x a w w a f
خيار	x j ɑː rˤ
خيار	x ɪ j ɑː rˤ
خير	x a j j a r
داب	d æː b
داخ	d æː x
دار	d ɑː r
دافع	d æː f a ʕ
دافي	d æː f i
داق	d æː ʔ
دايما	d aː j m a n
دايما	d æː j m a n
دبح	d a b a ħ
دبر	d a b b a r
دخل	d a x a l
دخل	d a x x a l
دخن	d a x x a n
درب	d a r r a b
دربس	d a r b a s
دردش	d a r d a ʃ
درس	d a r a s
دعم	d a ʕ a m
دعى	d a ʕ a
دغري	d ʊ ɣ r i
دفا	d a f a
دفش	d a f a ʃ
دفع	d a f a ʕ
دفن	d a f a n
دفى	d a f f a
دفي	d i f i
دفيان	d a f j æː n
دق	d a ʔ
دقق	d a ʔ ʔ a ʔ
دقيقة	d a ɡ iː ɡ e
دقيقة	d a ʔ iː ʔ a
دكان	d u k k aː n
دكان	d u k k æː n
دل	d a l
دلل	d a l l a l
دمر	d a m m a r
دوام	d a w aː m
دوام	d a w æː m
دوب	d a w w a b
دور	d a w w a r
دوزن	d oː z a n
ذكر	z a k a r
ذكر	z a k k a r
راتب	r aː t ɪ b
راتب	r æː t ɪ b
راجع	r æː d͡ʒ a ʕ
راجع	r æː d͡ʒ ɪ ʕ
راجع	r æː ʒ a ʕ
راجع	r æː ʒ ɪ ʕ
راح	rˤ ɑː ħ
راضى	rˤ ɑː dˤ ɑ
رايح	rˤ ɑː j ɪ ħ
ربح	r i b ɪ ħ
ربط	rˤ ɑ b ɑ tˤ
ربى	rˤ ɑ b b ɑ
رتب	r a t t a b
رجع	r a d d͡ʒ a ʕ
رجع	r a ʒ ʒ a ʕ
رجع	r i d͡ʒ ɪ ʕ
رجع	r i ʒ ɪ ʕ
رحل	r a ħ a l
رحلة	r ɪ ħ l e
رخص	r ɑ x x ɑ sˤ
رد	r a d
رسم	r a s a m
رش	r a ʃ
رشح	r a ʃ a ħ
رشح	r a ʃ ʃ a ħ
رفض	rˤ ɑ f ɑ dˤ
رفع	rˤ ɑ f ɑ ʕ
رقص	rˤ ɑ ɡ ɑ sˤ
رقص	rˤ ɑ ʔ ɑ sˤ
ركب	r a k k a b
ركب	r i k ɪ b
ركز	r a k k a z
ركض	r a k a d
ركع	r a k a ʕ
ركن	r a k a n
رمش	r a m a ʃ
رمش	r a m m a ʃ
رمم	r a m m a m
رمى	r a m a
رن	r a n
روج	r a w w a d͡ʒ
روج	r a w w a ʒ
روح	r a w w ɑ ħ
ريح	r a j j a ħ
ريح	r iː ħ
ريحا	r iː ħ a
ريحان	r iː ħː æ n
زاح	z æː ħ
زاد	z æː d
زار	z ɑː rˤ
زاكي	z æː k i
زبدة	z i b d e
زبط	zˤ ɑ b b ɑ tˤ
زبط	zˤ ɑ b ɑ tˤ
زبون	z b uː n
زتون	z a t uː n
زرع	z a r a ʕ
زعتر	z a ʕ tˤ ɑ rˤ
زعج	z a ʕ a d͡ʒ
زعج	z a ʕ a ʒ
زعل	z a ʕ ʕ a l
زعل	z i ʕ ɪ l
زعلان	z a ʕ l æː n
زفت	z a f f a t
زقف	z a ʔ ʔ a f
زلمة	z a l a m e
زمان	z a m aː n
زمان	z a m æː n
زنجبيل	z a n d͡ʒ a b iː l
زنجبيل	z a n ʒ a b iː l
زهق	z a h h a ɡ
زهق	z a h h a ʔ
زهق	z i h ɪ ɡ
زهق	z i h ɪ ʔ
زهقان	z a h ʔ æː n
زوج	z a w w a ʒ
زوج	z oː ʒ
زيت	z eː t
سأل	s a ʔ a l
ساب	s æː b
سابق	s æː b a ɡ
سابق	s æː b a ʔ
ساعة	s aː ʕ a
ساعة	s æː ʕ a
ساعد	s æː ʕ a d
سافر	s æː f a r
ساق	s æː ɡ
ساق	s æː ʔ
ساكن	s æː k ɪ n
سامح	s æː m a ħ
سامع	s æː m ɪ ʕ
ساوى	s æː w a
سب	s a b
سبب	s a b b a b
سبح	s a b a ħ
سبسب	s a b s a b
سبع	s a b ʕ
سبعة	s a b ʕ a
سبعتعش	s a b a ʕ tˤ ɑ ʃ
سبق	s a b a ɡ
سبق	s a b a ʔ
ست	s i t
ستة	s ɪ t t e
ستعش	s i tˤ tˤ ɑ ʃ
سجل	s a d d͡ʒ a l
سجل	s a ʒ ʒ a l
سجن	s a d͡ʒ a n
سجن	s a ʒ a n
سحب	s a ħ a b
سحل	s a ħ a l
سحل	s a ħ ħ a l
سخن	s a x a n
سخن	s a x x a n
سخن	sˤ ʊ x o n
سرق	s a r a ɡ
سرق	s a r a ʔ
سطح	sˤ ɑ tˤ tˤ ɑ ħ
سقط	sˤ ɑ ɡ ɑ tˤ
سقط	sˤ ɑ ʔ ɑ tˤ
سكت	s a k a t
سكر	s a k k a r
سكر	s i k ɪ r
سكر	s u k k ɑ rˤ
سكران	s ɑ k rˤ ɑː n
سكن	s a k a n
سكينة	s ɪ k k iː n e
سلخ	s a l a x
سلق	s a l a ʔ
سلك	s a l a k
سلم	s a l l a m
سلى	s a l l a
سمح	s a m a ħ
سمع	s i m ɪ ʕ
سمى	s a m m a
سنة	s a n e
سهر	s i h ɪ r
سوق	s a w w a ʔ
سوى	s a w w a
سيارة	s a j j ɑː r ɑ
شاب	ʃ a b
شارع	ʃ aː r ɪ ʕ
شارع	ʃ æː r ɪ ʕ
شارك	ʃ æː r a k
شاطر	ʃ ɑː tˤ ɪ r
شاف	ʃ æː f
شال	ʃ æː l
شاهد	ʃ æː h a d
شاهد	ʃ æː h ɪ d
شاي	ʃ æː j
شايف	ʃ æː j ɪ f
شباب	ʃ a b æː b
شبع	ʃ i b ɪ ʕ
شبعان	ʃ a b ʕ æː n
شبه	ʃ a b a h
شتت	ʃ a t t a t
شتى	ʃ a t t a
شجع	ʃ a d d͡ʒ a ʕ
شجع	ʃ a ʒ ʒ a ʕ
شحن	ʃ a ħ a n
شخ	ʃ a x
شخص	ʃ ʌ x sˤ
شد	ʃ a d
شدد	ʃ a d d a d
شراب	ʃ a rˤ ɑː b
شرب	ʃ i r ɪ b
شرح	ʃ ʌ rˤ ʌ ħ
شركة	ʃ ɪ r k e
شرى	ʃ a r a
شعل	ʃ a ʕ ʕ a l
شغل	ʃ a ɣ a l
شغل	ʃ a ɣ ɣ a l
شغل	ʃ ʊ ɣ o l
شفى	ʃ a f a
شفي	ʃ i f i
شك	ʃ a k
شكر	ʃ a k a r
شكرا	ʃ ʊ k r a n
شكل	ʃ a k k a l
شكل	ʃ ɪ k ɪ l
شكى	ʃ a k a
شلح	ʃ a l a ħ
شلفق	ʃ a l f a ɡ
شلفق	ʃ a l f a ʔ
شم	ʃ a m
شمال	ʃ m æː l
شمس	ʃ a m m a s
شمس	ʃ a m s
شهر	ʃ a h ɪ r
شهى	ʃ a h h a
شو	ʃ uː
شوب	ʃ a w w a b
شوب	ʃ oː b
شوبان	ʃ a w b æː n
شوربة	ʃ oː rˤ ɑ b ɑ
شوفير	ʃ ʊ f eː r
شوكة	ʃ oː k e
شيش	ʃ a j j a ʃ
شيك	ʃ a j j a k
صاح	sˤ ɑː ħ
صاحب	sˤ ɑː ħ ɑ b
صاحب	sˤ ɑː ħ ɪ b
صار	sˤ ɑː rˤ
صام	sˤ ɑː m
صاير	sˤ ɑː j ɪ r
صب	sˤ ɑ b
صبايا	sˤ ʌ b ɑː j a
صبح	sˤ ʊ b o ħ
صبحية	sˤ ɑ b ɑ ħ i j j e
صبر	sˤ ʌ b ʌ rˤ
صبية	sˤ a b i j j e
صحن	sˤ ʌ ħ ɪ n
صحى	sˤ ɑ ħ ħ ɑ
صحي	sˤ i ħ i
صدر	sˤ ɑ dˤ dˤ ɑ r
صدر	sˤ ɑ dˤ ɑ r
صدق	s a d d a ɡ
صدق	s a d d a ʔ
صديق	sˤ ɑ dˤ iː q
صرخ	sˤ ɑ rˤ ɑ x
صرف	sˤ ɑ rˤ ɑ f
صف	sˤ ɑ f
صفر	sˤ ɪ f e r
صلح	sˤ ɑ lˤ lˤ ɑ ħ
صلى	sˤ ɑ lˤ lˤ ɑ
صمم	sˤ ɑ m m ɑ m
صوت	sˤ oː t
صوت	sˤ ɑ w w ɑ tˤ
صور	sˤ ɑ w w ɑ rˤ
ضاع	dˤ ɑː ʕ
ضاف	dˤ ɑː f
ضايق	d æː j a ʔ
ضب	dˤ ɑ b
ضحك	dˤ i ħ ɪ k
ضحك	dˤ ɑ ħ ħ ɑ k
ضرب	dˤ ʌ rˤ ʌ b
ضعف	dˤ i ʕ ɪ f
ضعف	dˤ ɑ ʕ ʕ ɑ f
ضغط	dˤ ɑ ɣ ɑ tˤ
ضفة	dˤ ɪ f f e
ضل	dˤ ɑ lˤ
ضم	dˤ ɑ m
ضوى	dˤ ɑ w ɑ
ضيع	dˤ ɑ j j ɑ ʕ
ضيف	dˤ eː f
طاب	tˤ ɑː b
طار	tˤ ɑː r
طاق	tˤ ɑː ʔ
طالع	tˤ ɑː l ɪ ʕ
طالما	tˤ ɑː l a m a
طب	tˤ ʌ b
طبخ	tˤ ʌ b ʌ x
طبخة	tˤ ɑ b x ɑ
طبع	tˤ ɑ b b ɑ ʕ
طخ	tˤ ɑ x
طرد	tˤ ɑ rˤ ɑ dˤ
طش	tˤ ɑ ʃ
طعم	tˤ ɑ ʕ m
طعمى	tˤ ɑ ʕ m ɑ
طفى	tˤ ɑ f ɑ
طلب	tˤ ɑ l ɑ b
طلع	tˤ ɪ l ɪ ʕ
طلع	tˤ ʌ l l ʌ ʕ
طلق	tˤ ɑ lˤ lˤ ɑ ʔ
طمن	tˤ ɑ m m ɑ n
طور	tˤ ʌ w w ʌ r
طول	tˤ ʌ w w ʌ l
طيارة	tˤ ɑ j j ɑː rˤ ɑ
طيب	tˤ ɑ j j a b
طيب	tˤ ɑ j j ɪ b
طيز	tˤ iː z
ظلم	zˤ ɑ l ɑ m
ظن	zˤ ɑ n
ظهر	zˤ ɑ h ɑ rˤ
عاد	ʕ æː d
عادي	ʕ æː d i
عارض	ʕ ɑː rˤ ɑ dˤ
عارف	ʕ æː r ɪ f
عاز	ʕ æː z
عاش	ʕ æː ʃ
عاقب	ʕ ɑː q ɑ b
عالج	ʕ æː l a d͡ʒ
عالج	ʕ æː l a ʒ
عامل	ʕ æː m a l
عامل	ʕ æː m ɪ l
عاند	ʕ æː n a d
عايش	ʕ æː j ɪ ʃ
عبد	ʕ a b a d
عبد	ʕ a b b a d
عبر	ʕ a b b a r
عبط	ʕ ɑ b ɑ tˤ
عبى	ʕ a b b a
عتم	ʕ a t t a m
عجب	ʕ a d d͡ʒ a b
عجب	ʕ a d͡ʒ a b
عجب	ʕ a ʒ a b
عجب	ʕ a ʒ ʒ a b
عجل	ʕ a d d͡ʒ a l
عجل	ʕ a ʒ ʒ a l
عجن	ʕ a d͡ʒ a n
عجن	ʕ a ʒ a n
عجين	ʕ a ʒ iː n
عد	ʕ a d
عدس	ʕ a d a s
عدل	ʕ a d d a l
عدى	ʕ a d a
عذب	ʕ a z z a b
عذر	ʕ a ð a rˤ
عرب	ʕ a r r a b
عرج	ʕ a r a d͡ʒ
عرج	ʕ a r a ʒ
عرس	ʕ o r o s
عرض	ʕ ɑ r r ɑ dˤ
عرض	ʕ ɑ r ɑ dˤ
عرف	ʕ a rˤ rˤ ɑ f
عرف	ʕ i rˤ ɪ f
عرق	ʕ i r ɪ ʔ
عرقان	ʕ ɑ rˤ ʔ ɑː n
عروس	ʕ a r uː s
عريس	ʕ a r iː s
عز	ʕ a z
عزف	ʕ a z a f
عزل	ʕ a z a l
عزل	ʕ a z z a l
عزم	ʕ a z a m
عزى	ʕ a z z a
عزيز	ʕ a z iː z
عسل	ʕ a s a l
عشا	ʕ a ʃ a
عشان	ʕ a ʃ æː n
عشر	ʕ a ʃ r
عشرة	ʕ a ʃ a rˤ ɑ
عشرين	ʕ ɪ ʃ r iː n
عشق	ʕ i ʃ ɪ ɡ
عشق	ʕ i ʃ ɪ ʔ
عص	ʕ ɑ sˤ
عصارة	ʕ ɑ sˤ sˤ ɑː rˤ ɑ
عصب	ʕ ɑ sˤ sˤ ɑ b
عصر	ʕ a sˤ ɑ rˤ
عصير	ʕ a sˤ iː rˤ
عض	ʕ ɑ dˤ
عطس	ʕ ɑ tˤ ɑ sˤ
عطش	ʕ i tˤ ɪ ʃ
عطشان	ʕ ɑ tˤ ʃ ɑː n
عطل	ʕ ɑ tˤ tˤ ɑ l
عطلة	ʕ o tˤ l e
عفش	ʕ a f ɪ ʃ
عفوا	ʕ a f w a n
عفى	ʕ a f a
عقد	ʕ a ɡ a d
عقد	ʕ a ɡ ɡ a d
عقد	ʕ a ʔ a d
عقد	ʕ a ʔ ʔ a d
عقم	ʕ ɑ q q ɑ m
عكا	ʕ a k k a
عكر	ʕ a k a r
عكس	ʕ a k a s
علاقة	ʕ a l ɑː q ɑ
علق	ʕ a l l a ɡ
علق	ʕ a l l a ʔ
علق	ʕ i l ɪ ɡ
علق	ʕ i l ɪ ʔ
علم	ʕ a l l a m
على	ʕ a l l a
علي	ʕ i l i
عمارة	ʕ a m ɑː r ɑ
عمد	ʕ a m m a d
عمر	ʕ a m m a r
عمر	ʕ o m o r
عمل	ʕ a m a l
عمل	ʕ i m ɪ l
عمل	ʕ ɛ m ɪ l
عمل	ʕ ɪ m ɪ l
عمى	ʕ a m a
عنب	ʕ ɪ n e b
عنب	ʕ ʊ n o b
عند	ʕ a n n a d
عند	ʕ ɪ n d
عنوان	ʕ ɪ n w aː n
عنوان	ʕ ɪ n w æː n
عنوان	ʕ ʊ n w aː n
عنوان	ʕ ʊ n w æː n
عنى	ʕ a n a
عود	ʕ a w w a d
عوض	ʕ a w w ɑ dˤ
عوق	ʕ a w w a ɡ
عوق	ʕ a w w a ʔ
عوى	ʕ a w w a
عيد	ʕ a j j a d
عيد	ʕ iː d
عير	ʕ a j j a r
عيط	ʕ ɑ j j ɑ tˤ
عيلة	ʕ eː l e
عين	ʕ a j j a n
غاب	ɣ æː b
غار	ɣ ɑː rˤ
غدا	ɣ a d a
غرد	ɣ a r r a d
غرق	ɣ i r ɪ ʔ
غرقان	ɣ ɑ rˤ ʔ ɑː n
غريب	ɣ a r iː b
غزة	ɣ a z z e
غسل	ɣ a s a l
غسل	ɣ a s s a l
غش	ɣ a ʃ
غصب	ɣ ɑ sˤ ɑ b
غضبان	ɣ ɑ dˤ b ɑː n
غط	ɣ ɑ tˤ
غطس	ɣ ɑ tˤ ɑ sˤ
غطى	ɣ ɑ tˤ tˤ ɑ
غفي	ɣ i f i
غلب	ɣ a l a b
غلب	ɣ a l l a b
غلط	ɣ i l ɪ tˤ
غلطان	ɣ ɑ lˤ tˤ ɑː n
غلف	ɣ a l l a f
غلى	ɣ a l a
غلى	ɣ a l l a
غلي	ɣ i l i
غليان	ɣ a l j æː n
غمس	ɣ a m m a s
غمض	ɣ ɑ m m ɑ dˤ
غمي	ɣ i m i
غنى	ɣ a n n a
غير	ɣ a j j a r
غير	ɣ eː r
غيران	ɣ a j r ɑː n
غيم	ɣ a j j a m
فات	f æː t
فاجأ	f æː d͡ʒ a ʔ
فاجأ	f æː ʒ a ʔ
فار	f ɑː rˤ
فاز	f æː z
فاسد	f æː s ɪ d
فاصل	f ɑː sˤ ɑ l
فاصوليا	f a sˤ uː l j a
فاق	f æː ʔ
فاهم	f æː h ɪ m
فتاحة	f a t t æː ħ a
فتح	f a t a ħ
فترة	f a t r ɑ
فحص	f ɑ ħ ɑ sˤ
فرج	f a r a d͡ʒ
فرج	f a r a ʒ
فرجى	f a r d͡ʒ a
فرجى	f a r ʒ a
فرح	f i r ɪ ħ
فرش	f a r a ʃ
فرشى	f a r ʃ a
فرض	f ɑ rˤ ɑ dˤ
فرق	f a r a ɡ
فرق	f a r a ʔ
فرق	f a r r a ɡ
فرق	f a r r a ʔ
فشق	f a ʃ a ɡ
فشق	f a ʃ a ʔ
فشق	f a ʃ ʃ a ɡ
فشق	f a ʃ ʃ a ʔ
فصص	f ɑ sˤ sˤ ɑ sˤ
فصل	f ɑ sˤ sˤ ɑ l
فصل	f ɑ sˤ ɑ l
فضح	f ɑ dˤ ɑ ħ
فضل	f ʌ dˤ dˤ ʌ l
فضى	f ɑ dˤ dˤ ɑ
فضي	f i dˤ i
فطر	f i tˤ ɪ r
فطور	f tˤ uː rˤ
فقع	f a ɡ a ʕ
فقع	f a ɡ ɡ a ʕ
فقع	f a ʔ a ʕ
فقع	f a ʔ ʔ a ʕ
فكر	f a k k a r
فكك	f a k k a k
فلسطين	f ɑ l ɑ sˤ tˤ iː n
فلسف	f a l s a f
فلفل	f ɪ l f ɪ l
فنجان	f ɪ n d͡ʒ æː n
فنجان	f ɪ n ʒ æː n
فندق	f u n d ʊ ʔ
فهم	f a h h a m
فهم	f i h ɪ m
فهمان	f a h m æː n
فواكه	f a w æː k ɪ h
فوت	f a w w a t
فور	f a w w a r
فورص	f oː rˤ ɑ sˤ
فوق	f oː ɡ
فوق	f oː ʔ
في	f i
فيه	f iː h
قابل	ɡ æː b a l
قابل	ɡ æː b ɪ l
قابل	ʔ æː b a l
قابل	ʔ æː b ɪ l
قادر	ɡ æː d ɪ r
قادر	ʔ æː d ɪ r
قارن	q ɑː rˤ ɑ n
قاضی	ɡ ɑː dˤ ɑ
قاضی	ʔ ɑː dˤ ɑ
قاطع	ɡ ɑː tˤ ɑ ʕ
قاطع	ʔ ɑː tˤ ɑ ʕ
قاعد	ɡ æː ʕ ɪ d
قاعد	ʔ æː ʕ ɪ d
قال	ɡ æː l
قال	ʔ æː l
قام	ɡ æː m
قام	ʔ æː m
قاوم	q ɑː w a m
قاوم	ɡ æː w a m
قاوم	ʔ æː w a m
قبل	ɡ a b ɪ l
قبل	ɡ i b ɪ l
قبل	ʔ a b ɪ l
قبل	ʔ i b ɪ l
قتل	ɡ a t a l
قتل	ʔ a t a l
قح	ʔ a ħ
قدام	ɡ u d d æː m
قدام	ʔ u d d æː m
قدر	ɡ a d d a r
قدر	ɡ i d ɪ r
قدر	ʔ a d d a r
قدر	ʔ i d ɪ r
قدم	ɡ a d d a m
قدم	ʔ a d d a m
قرا	ɡ ʌ rˤ ʌ
قرا	ʔ ʌ rˤ ʌ
قرب	ɡ a r r a b
قرب	ʔ a r r a b
قرر	ɡ ʌ rˤ rˤ ʌ rˤ
قرر	ʔ ʌ rˤ rˤ ʌ rˤ
قرص	ʔ ɑ rˤ ɑ sˤ
قرض	ɡ ɑ rˤ ɑ dˤ
قرض	ʔ ɑ rˤ ɑ dˤ
قرف	ɡ i r ɪ f
قرف	ɡ ɑ rˤ rˤ ɑ f
قرف	ʔ i r ɪ f
قرف	ʔ ɑ rˤ rˤ ɑ f
قرفان	ʔ ɑ rˤ f ɑː n
قريب	ɡ a r iː b
قريب	ʔ a r iː b
قسم	ɡ a s a m
قسم	ɡ a s s a m
قسم	ʔ a s a m
قسم	ʔ a s s a m
قشطة	ɡ ɪ ʃ tˤ ɑ
قشطة	ʔ ɪ ʃ tˤ ɑ
قص	ɡ ʌ sˤ
قص	ʔ ʌ sˤ
قصد	ɡ ɑ sˤ ɑ d
قصد	ʔ ɑ sˤ ɑ d
قضى	ʔ ɑ dˤ ɑ
قطار	q ɪ tˤ ɑː rˤ
قطر	ɡ ɑ tˤ tˤ ɑ r
قطر	ɡ ɑ tˤ ɑ r
قطر	ʔ ɑ tˤ tˤ ɑ r
قطر	ʔ ɑ tˤ ɑ r
قطع	ɡ ɑ tˤ tˤ ɑ ʕ
قطع	ɡ ɑ tˤ ɑ ʕ
قطع	ʔ ɑ tˤ tˤ ɑ ʕ
قطع	ʔ ɑ tˤ ɑ ʕ
قعد	ɡ a ʕ a d
قعد	ʔ a ʕ a d
قفل	ʔ a f f a l
قلب	ɡ a l a b
قلب	ɡ a l b
قلب	ʔ a l a b
قلب	ʔ a l b
قلد	ɡ a l l a d
قلد	ʔ a l l a d
قلق	ɡ i l ɪ ɡ
قلق	ʔ i l ɪ ʔ
قلقان	ɡ a l ɡ æː n
قلقان	ʔ a l ʔ æː n
قلل	ɡ a l l a l
قلل	ʔ a l l a l
قلم	ʔ a l a m
قلى	ʔ a l a
قنينة	ɡ a n n iː n e
قنينة	ʔ a n n iː n e
قهوة	ʔ a h w e
كاسة	k æː s e
كان	k æː n
كاين	k æː j ɪ n
كب	k a b
كباية	k u b b æː j e
كبب	k a b b a b
كبر	k a b b a r
كبس	k a b a s
كبكب	k a b k a b
كتب	k a t a b
كتر	k a t t a r
كتر	k i t ɪ r
كثف	k a t t a f
كذب	k a z z a b
كرر	k a r r a r
كرم	k a r r a m
كره	k i r ɪ h
كسب	k i s ɪ b
كسر	k a s a r
كسل	k a s s a l
كسلان	k a s l æː n
كشف	k a ʃ a f
كفى	k a f f a
كلبش	k a l b a ʃ
كلف	k a l l a f
كلم	k a l l a m
كمان	k a m aː n
كمان	k a m æː n
كمرة	k ɑ m ɑ rˤ ɑ
كمل	k a m m a l
كنس	k a n n a s
كون	k a w w a n
كوى	k a w a
كويس	k w a j j ɪ s
كيف	k iː f
لاحظ	lˤ ɑː ħ ɑ zˤ
لاحق	l æː ħ a ɡ
لاحق	l æː ħ a ʔ
لازم	l æː z e m
لاقى	l æː ʔ a
لام	l æː m
لبس	l a b a s
لبس	l i b ɪ s
لبن	l a b a n
لبنة	l a b a n e
لبنة	l a b n e
لبى	l a b b a
لح	l a ħ
لحد	l a ħ a d
لحس	l a ħ a s
لحظة	l a ħ zˤ ɑ
لحق	l a ħ ħ a ɡ
لحق	l a ħ ħ a ʔ
لحق	l i ħ ɪ ɡ
لحق	l i ħ ɪ ʔ
لحم	l a ħ ɪ m
لخص	lˤ ɑ x x ɑ sˤ
لخم	l a x a m
لزق	l a z z a ɡ
لزق	l a z z a ʔ
لزم	l i z ɪ m
لسا	l ɪ s s a
لطيف	l ʌ tˤ iː f
لعب	l i ʕ ɪ b
لغى	l a ɣ a
لف	l a f
لفت	l a f a t
لفظ	lˤ ɑ f ɑ zˤ
لقب	l a ɡ ɡ a b
لقب	l a ʔ ʔ a b
لقط	lˤ ɑ ɡ ɑ tˤ
لقط	lˤ ɑ ɡ ɡ ɑ tˤ
لقط	lˤ ɑ ʔ ɑ tˤ
لقط	lˤ ɑ ʔ ʔ ɑ tˤ
لقى	l a ʔ a
للأسف	l ɪ l ʔ a s a f
لمس	l a m a s
لمون	l a m uː n
لوز	l oː z
ليل	l eː l
ليلة	l eː l e
مات	m æː t
مادام	m a d æː m
مارس	m æː r a s
ماشي	m æː ʃ i
ماضي	m ɑː dˤ i
ماضي	m ɑː ðˤ i
ماما	m ɑˤː mˤ ɑ
مبارح	m b aː r e ħ
مبارح	m b eː r e ħ
مبارح	m b æː r e ħ
مباشر	m u b aː ʃ e r
مباشر	m u b æː ʃ e r
متأخر	m i t ʔ a x x e r
متأسف	m ɪ t ʔ a s s ɪ f
مثل	m a s s a l
مثل	m a θ θ a l
محطة	m ɑ ħ ɑ tˤ tˤ ɑ
محل	m a ħ a l
محى	m a ħ a
مد	m a d
مدة	m u d d e
مدح	m a d a ħ
مدير	m u d iː r
مر	m ʌ rˤ
مرات	m a rˤ rˤ ɑː t
مرة	m ɑ rˤ rˤ ɑ
مرة	m ɑ rˤ ɑ
مرج	m a r a d͡ʒ
مرج	m a r a ʒ
مرج	m a r r a d͡ʒ
مرج	m a r r a ʒ
مرض	m i r ɪ dˤ
مرق	m a r a ɡ
مرق	m a r a ʔ
مرق	m a r r a ɡ
مرق	m a r r a ʔ
مرمية	m a r a m i j j e
مزح	m a z a ħ
مسا	m a s a
مستقبل	m u s t a ʔ b a l
مسك	m a s a k
مسك	m i s ɪ k
مش	m ɪ ʃ
مش	m ʊ ʃ
مشترك	m ʊ ʃ t a r a k
مشترك	m ʊ ʃ t a r ɪ k
مشروب	m a ʃ rˤ uː b
مشروع	m a ʃ r uː ʕ
مشمش	m ɪ ʃ m ɪ ʃ
مشمش	m ʊ ʃ m ʊ ʃ
مشوار	m ɪ ʃ w ɑː rˤ
مشوب	ɪ m ʃ a w w ɪ b
مشى	m a ʃ a
مص	m ɑ sˤ
مضرب	m ʊ dˤ rˤ ɪ b
مضغ	m ɑ dˤ ɑ ɣ
مطار	m a tˤ ɑː rˤ
مطبخ	m ɑ tˤ b ɑ x
مطعم	m ɑ tˤ ʕ ɑ m
مطلب	m ɑ tˤ lˤ ɑ b
مع	m a ʕ
معجنة	m ʕ a ʒ n e
معلقة	m a ʕ l a ɡ a
معلقة	m a ʕ l a ʔ a
معليش	m a ʕ l eː ʃ
مقهى	m a ʔ h a
مكان	m a k aː n
مكان	m a k æː n
مل	m a l
ملح	m a l ɪ ħ
ملح	m i l ɪ ħ
ملفوف	m a l f uː f
ملك	m a l a k
منشان	m i n ʃ æː n
منطقة	m ɑ n tˤ ɪ ʔ ɑ
منع	m a n a ʕ
منيح	m n iː ħ
مول	m a w w a l
مي	m a j
مي	mˤ ɑ j
مية	mˤ ɑ j j e
ميدان	m i d aː n
ميدان	m i d æː n
ميز	m a j j a z
مين	m iː n
نابلس	n æː b l ɪ s
نادرا	n aː d ɪ r a n
نادرا	n æː d ɪ r a n
نادى	n æː d a
نازل	n æː z ɪ l
ناسب	n æː s a b
ناقش	n ɑː q ɑ ʃ
ناك	n æː k
نام	n æː m
نايم	n æː j ɪ m
نبه	n a b b a h
نبيد	n b iː d
نتق	n a t a ʔ
نجح	n i d͡ʒ ɪ ħ
نجح	n i ʒ ɪ ħ
ندم	n i d ɪ m
ندمان	n a d m æː n
نرفز	n a r f a z
نزل	n a z z a l
نزل	n i z ɪ l
نسي	n i s i
نشر	n a ʃ a r
نشف	n a ʃ ʃ a f
نشف	n i ʃ ɪ f
نصح	n i sˤ ɪ ħ
نصح	n ɑ sˤ ɑ ħ
نضف	n ʌ dˤ dˤ ʌ f
نط	n ɑ tˤ
نظف	n ʌ dˤ dˤ ʌ f
نظم	n ɑ zˤ zˤ ɑ m
نعس	n i ʕ ɪ s
نعسان	n a ʕ s æː n
نعنع	n a ʕ n a ʕ
نفخ	n a f a x
نفس	n a f f a s
نفع	n a f a ʕ
نفى	n a f a
نقز	n a ɡ a z
نقز	n a ɡ ɡ a z
نقز	n a ʔ a z
نقز	n a ʔ ʔ a z
نقص	n ɑ ɡ ɡ ɑ sˤ
نقص	n ɑ ʔ ʔ ɑ sˤ
نقل	n a ɡ a l
نقل	n a ʔ a l
نقى	n a ɡ ɡ a
نقى	n a ʔ ʔ a
نكت	n a k k a t
نكر	n a k a r
نهار	n h ɑː r
نوم	n a w w a m
نوم	n oː m
نيم	n a j j a m
هاجر	h æː d͡ʒ a r
هاجر	h æː ʒ a r
هاجم	h æː d͡ʒ a m
هاجم	h æː ʒ a m
هاش	h æː ʃ
هجم	h a d͡ʒ a m
هجم	h a ʒ a m
هد	h a d
هدد	h a d d a d
هدف	h a d a f
هدى	h a d a
هدى	h a d d a
هدي	h i d i
هرب	h ɑ rˤ rˤ ɑ b
هرب	h ɑ rˤ ɑ b
هز	h a z
هلقيت	h a l k eː t
هلقيت	h a l ʔ eː t
هم	h a m
هم	h ʊ m m e
هناك	h o n æː k
هو	h ʊ w w e
هون	h oː n
هوية	h a w i j j e
هي	h i j j e
واجب	w æː d͡ʒ ɪ b
واجب	w æː ʒ ɪ b
واجه	w æː d͡ʒ a h
واجه	w æː ʒ a h
واحد	w aː ħ a d
واحدة	w a ħ d e
وافق	w æː f a ʔ
والله	w ɑ lˤ lˤ ɑ
والله	w ɑ lˤ lˤ ɑː h i
وثق	w a θ a ʔ
وجع	w a d d͡ʒ a ʕ
وجع	w a d͡ʒ a ʕ
وجع	w a ʒ a ʕ
وجع	w a ʒ ʒ a ʕ
وجع	w i d͡ʒ ɪ ʕ
وجع	w i ʒ ɪ ʕ
وجه	w a d d͡ʒ a h
وجه	w a ʒ ʒ a h
وجه	w i j ɪ h
وجه	w u j ʊ h
وحد	w a ħ ħ a d
ودع	w a d d a ʕ
ورا	w a r a
ورجى	w a r d͡ʒ a
ورجى	w a r ʒ a
ورم	w i r ɪ m
وزع	w a z z a ʕ
وسخ	w a s s a x
وسخ	w i s ɪ x
وسع	w a s s a ʕ
وسع	w i s ɪ ʕ
وصف	w ɑ sˤ ɑ f
وصل	w i sˤ ɪ l
وصل	w ɑ sˤ sˤ ɑ l
وصل	w ɑ sˤ ɑ l
وصى	w ɑ sˤ sˤ ɑ
وضح	w ʌ dˤ dˤ ʌ ħ
وطن	w ɑ tˤ tˤ ɑ n
وطن	w ɑ tˤ ɑ n
وطى	w ɑ tˤ tˤ ɑ
وطي	w i tˤ i
وظف	w ɑ zˤ zˤ ɑ f
وظيفة	w ɑ zˤ iː f e
وعد	w a ʕ a d
وعى	w a ʕ ʕ a
وعي	w i ʕ i
وفر	w a f f a r
وقت	w a ɡ ɪ t
وقت	w a ʔ ɪ t
وقع	w a ɡ ɡ a ʕ
وقع	w a ʔ ʔ a ʕ
وقع	w i ɡ ɪ ʕ
وقع	w i ʔ ɪ ʕ
وقف	w i ɡ ɪ f
وقف	w i ʔ ɪ f
وقف	w ɑ ɡ ɡ ɑ f
وقف	w ɑ ʔ ʔ ɑ f
ولاد	w l æː d
ولد	w a l a d
ولد	w i l ɪ d
ولع	w a l l a ʕ
يافا	j æː f a
يلا	j ɑ lˤ lˤ ɑ
يمين	j a m iː n
يوم	j oː m
چ	ɡ
چ	ɡ iː m
