a	a
aba	a b a
abade	a b a d e
abadegai	a b a d e ɡ a i̯
abadesa	a b a d e s̺ a
abadia	a b a d i a
abadiano	a b a d j a n o
abagune	a b a ɡ u n e
abako	a b a k o
abantaila	a b a n t a i̯ l a
abantaila	a b a n t a ʎ a
abendu	a b e n d u
abentura	a b e n t u ɾ a
abenturazale	a b e n t u ɾ a s̻ a l e
aberastasun	a b e ɾ a s̺ t a s̺ u n
aberats	a b e ɾ a t͡s̺
abere	a b e ɾ e
aberri	a b e r i
abertzale	a b e r t͡s̻ a l e
abertzaletasun	a b e r t͡s̻ a l e t a s̺ u n
abes	a b e s̺
abesbatza	a b e s̺ b a t͡s̻ a
abeslari	a b e s̺ l a ɾ i
abeste	a b e s̺ t e
abesten	a b e s̺ t e n
abesti	a b e s̺ t i
abestu	a b e s̺ t u
abestuko	a b e s̺ t u k o
abizen	a b i s̻ e n
abkhazera	a b x a s̻ e ɾ a
abkhazia	a b x a s̻ i a
abkhaziar	a b x a s̻ i a r
aboitiz	a b o i̯ t i s̻
abstraktu	a b s̺ t r a k t u
abundi	a b u n d i
abundio	a b u n d j o
aburu	a b u ɾ u
abuztu	a b u s̻ t u
adar	a d a r
adibide	a d i b i d e
adibidez	a d i b i d e s̻
adimen	a d i m e n
adiskide	a d i s̺ k i d e
adiskidetasun	a d i s̺ k i d e t a s̺ u n
aditu	a d i t u
aditz	a d i t͡s̻
aditzondo	a d i t͡s̻ o n d o
adizki	a d i s̻ k i
adizkitegi	a d i s̻ k i t e ɡ i
adolba	a d o l b a
adore	a d o ɾ e
ados	a d o s̺
adoste	a d o s̺ t e
adosten	a d o s̺ t e n
adostu	a d o s̺ t u
adostuko	a d o s̺ t u k o
adreilu	a d r e i̯ l u
adreilu	a d r e ʎ u
afari	a f a ɾ i
afganistan	a f ɡ a n i s̺ t a n
afganistandar	a f ɡ a n i s̺ t a n d a r
agate	a ɡ a t e
agi	a ɡ i
agirre	a ɡ i r e
agor	a ɡ o r
agorril	a ɡ o r i l
agur	a ɡ u r
ahabe	ã h ã b e
ahabia	a a b i a
ahabia	a h a b i a
ahai	a h̃ a i
ahal	a a l
ahal	a h a l
ahalke	a a l k e
ahalke	a h a l k e
ahate	a a t e
ahate	a h a t e
ahate	a h̃ a t e
ahatz	a a t͡s̻
ahatz	a h a t͡s̻
ahazte	a a s̻ t e
ahazte	a h a s̻ t e
ahazten	a a s̻ t e n
ahazten	a h a s̻ t e n
ahaztu	a a s̻ t u
ahaztu	a h a s̻ t u
ahaztuko	a a s̻ t u k o
ahaztuko	a h a s̻ t u k o
ahuntz	a h u n t͡s̻
ahuntz	a u n t͡s̻
aihen	a i̯ e n
aihen	a i̯ h e n
ainara	a i̯ n a ɾ a
ainarba	a i̯ n a r b a
ainarba	a ɲ a r b a
aingeru	a i̯ n ɡ e ɾ u
aingira	a i̯ n ɡ i ɾ a
ainhoa	a i̯ n o a
aintzane	a i̯ n t͡s̻ a n e
aire	a i̯ ɾ e
aise	a i̯ s̺ e
aita	a i̯ t a
aitaginarreba	a i̯ t a ɡ i n a r e b a
aitaginarreba	a i̯ t a ɡ i ɲ a r e b a
aitatxi	a i̯ t a t͡ʃ i
aitona	a i̯ t o n a
aitor	a i̯ t o r
aitzur	a i̯ t͡s̻ u r
aizkolari	a i̯ s̻ k o l a ɾ i
aizkora	a i̯ s̻ k o ɾ a
aizto	a i̯ s̻ t o
akelarre	a k e l a r e
aker	a k e r
akordeoi	a k o r d e o i̯
akrobata	a k r o b a t a
aktiba	a k t i b a
aktibatu	a k t i b a t u
aktibatuko	a k t i b a t u k o
aktibatze	a k t i b a t͡s̻ e
aktibatzen	a k t i b a t͡s̻ e n
aktore	a k t o ɾ e
alaba	a l a b a
alai	a l a i̯
albaitari	a l b a i̯ t a ɾ i
albania	a l b a n i a
albaniar	a l b a n i a r
albaniera	a l b a n i e ɾ a
alda	a l d a
aldapa	a l d a p a
aldatu	a l d a t u
aldatuko	a l d a t u k o
aldatze	a l d a t͡s̻ e
aldatzen	a l d a t͡s̻ e n
alde	a l d e
aldizkari	a l d i s̻ k a ɾ i
aleman	a l e m a n
alemanera	a l e m a n e ɾ a
alemania	a l e m a n i a
alemaniar	a l e m a n i a r
aljeria	a l j e ɾ i a
aljeria	a l x e ɾ i a
alkandora	a l k a n d o ɾ a
alkandorak	a l k a n d o ɾ a k
alkandorek	a l k a n d o ɾ e k
alkate	a l k a t e
alkohol	a l k o h o l
alkohol	a l k o o l
alkohola	a l k o h o l a
alkohola	a l k o o l a
alkoholan	a l k o h o l a n
alkoholan	a l k o o l a n
alkoholen	a l k o h o l e n
alkoholen	a l k o o l e n
alkoholi	a l k o h o l i
alkoholi	a l k o o l i
alkoholik	a l k o h o l i k
alkoholik	a l k o o l i k
altxoin	a l t͡ʃ o i̯ n
altxor	a l t͡ʃ o r
aluminio	a l u m i n i o
ama	a m a
amaginarreba	a m a ɡ i n a r e b a
amaginarreba	a m a ɡ i ɲ a r e b a
amaraun	a m a ɾ a u̯ n
amatasun	a m a t a s̺ u n
amesgaizto	a m e s̺ ɡ a i̯ s̻ t o
amets	a m e t͡s̺
ametz	a m e t͡s̻
anaia	a n a i̯ a
anana	a n a n a
andaia	a n d a i̯ a
ander	a n d e r
andere	a n d e ɾ e
andereño	a n d e ɾ e ɲ o
andorra	a n d o r a
andorratar	a n d o r a t a r
andorratarra	a n d o r a t a r a
andorratarrak	a n d o r a t a r a k
andorratarraren	a n d o r a t a r a ɾ e n
andorratarrari	a n d o r a t a r a ɾ i
andorratarrei	a n d o r a t a r e i̯
andorratarrek	a n d o r a t a r e k
andorratarren	a n d o r a t a r e n
andorratarri	a n d o r a t a r i
andre	a n d r e
angola	a n ɡ o l a
animalia	a n i m a l i a
anime	a n i m e
anker	a n k e r
antartika	a n t a r t i k a
antigua	a n t i ɡ w a
antimikrobiar	a n t i m i k r o b i a r
antton	a n c o n
antton	a n t͡ʃ o n
antxeta	a n t͡ʃ e t a
antxieta	a n t͡ʃ j e t a
antzara	a n t͡s̻ a ɾ a
apaiz	a p a i̯ s̻
apaizgai	a p a i̯ s̻ ɡ a i̯
apar	a p a r
apez	a p e s̻
apezpiku	a p e s̻ p i k u
apiril	a p i ɾ i l
apo	a p o
aprobetxategi	a p r o b e t͡ʃ a t e ɡ i
araba	a ɾ a b a
arabiera	a ɾ a b i e ɾ a
arabisagar	a ɾ a b i s̺ a ɡ a r
aramu	a ɾ a m u
aran	a ɾ a n
aranondo	a ɾ a n o n d o
arbola	a r b o l a
ardi	a r d i
ardo	a r d o
arellano	a ɾ e ʎ a n o
argi	a r ɡ i
argitsu	a r ɡ i t͡s̺ u
aristotele	a ɾ i s̺ t o t e l e
aritz	a ɾ i t͡s̻
armenia	a r m e n i a
armeniar	a r m e n i a r
armeniera	a r m e n i e ɾ a
armiarma	a r m i a r m a
arotz	a ɾ o t͡s̻
aroztegi	a ɾ o s̻ t e ɡ i
arrain	a r a i̯ n
arrano	a r a n o
arranotegi	a r a n o t e ɡ i
arrantzale	a r a n t͡s̻ a l e
arratoi	a r a t o i̯
arraun	a r a u̯ n
arrigorriaga	a r i ɡ o r i a ɡ a
arroda	a r o d a
arrosa	a r o s̺ a
arrunt	a r u n t
artaburu	a r t a b u ɾ u
arte	a r t e
artile	a r t i l e
artile	a r t i ʎ e
arto	a r t o
artseniko	a r t͡s̺ e n i k o
artxipelago	a r t͡ʃ i p e l a ɡ o
artzain	a r t͡s̻ a i̯ n
askatasun	a s̺ k a t a s̺ u n
aske	a s̺ k e
asko	a s̺ k o
aste	a s̺ t e
astearte	a s̺ t e a r t e
asteazken	a s̺ t e a s̻ k e n
asteburu	a s̺ t e b u ɾ u
astelehen	a s̺ t e l e e n
astelehen	a s̺ t e l e h e n
asteroide	a s̺ t e ɾ o i̯ d e
asto	a s̺ t o
asturiera	a s̺ t u ɾ i e ɾ a
asun	a s̺ u n
atari	a t a ɾ i
atariko	a t a ɾ i k o
ate	a t e
atena	a t e n a
atera	a t e ɾ a
atorra	a t o r a
atxeki	a t͡ʃ e k i
atxekiko	a t͡ʃ e k i k o
atxekitze	a t͡ʃ e k i t͡s̻ e
atxekitzen	a t͡ʃ e k i t͡s̻ e n
atze	a t͡s̻ e
atzean	a t͡s̻ e a n
atzelari	a t͡s̻ e l a ɾ i
atzo	a t͡s̻ o
aukera	a u̯ k e ɾ a
aukeratu	a u̯ k e ɾ a t u
aukeratuko	a u̯ k e ɾ a t u k o
aukeratze	a u̯ k e ɾ a t͡s̻ e
aukeratzen	a u̯ k e ɾ a t͡s̻ e n
aurki	a u̯ r k i
aurkitu	a u̯ r k i t u
aurkituko	a u̯ r k i t u k o
aurkitze	a u̯ r k i t͡s̻ e
aurkitzen	a u̯ r k i t͡s̻ e n
aurpegi	a u̯ r p e ɡ i
aurre	a u̯ r e
australia	a u̯ s̺ t r a l i a
austria	a u̯ s̺ t r i a
austriar	a u̯ s̺ t r i a r
autobide	a u̯ t o b i d e
auzo	a u̯ s̻ o
azal	a s̻ a l
azaro	a s̻ a ɾ o
azazkal	a s̻ a s̻ k a l
azerbaijan	a s̻ e r b a i̯ j a n
azerbaijandar	a s̻ e r b a i̯ j a n d a r
azerbaijanera	a s̻ e r b a i̯ j a n e ɾ a
azeri	a s̻ e ɾ i
azerikeria	a s̻ e ɾ i k e ɾ i a
azeriki	a s̻ e ɾ i k i
azerikume	a s̻ e ɾ i k u m e
azeritegi	a s̻ e ɾ i t e ɡ i
azkar	a s̻ k a r
azken	a s̻ k e n
azkonar	a s̻ k o n a r
azoka	a s̻ o k a
azpi	a s̻ p i
azpian	a s̻ p i a n
azpititulu	a s̻ p i t i t u l u
azukre	a s̻ u k r e
b	b e
ba	b a
baba	b a b a
babazorro	b a b a s̻ o r o
badia	b a d i a
bagenbiltza	b a ɡ e m b i l t͡s̻ a
bagenegi	b a ɡ e n e ɡ i
bagenegitza	b a ɡ e n e ɡ i t͡s̻ a
bageneki	b a ɡ e n e k i
bagenekizki	b a ɡ e n e k i s̻ k i
bagenekusa	b a ɡ e n e k u s̺ a
bagenekuski	b a ɡ e n e k u s̺ k i
bagenentzu	b a ɡ e n e n t͡s̻ u
bagenentzuzki	b a ɡ e n e n t͡s̻ u s̻ k i
bagenerakuski	b a ɡ e n e ɾ a k u s̺ k i
bagenerakutsa	b a ɡ e n e ɾ a k u t͡s̺ a
bagenihardu	b a ɡ e n i a r d u
bagenihardu	b a ɡ e n i h a r d u
bageniharduka	b a ɡ e n i a r d u k a
bageniharduka	b a ɡ e n i h a r d u k a
bagenirau	b a ɡ e n i ɾ a u̯
bagenirudi	b a ɡ e n i ɾ u d i
bagentoz	b a ɡ e n t o s̻
bageunde	b a ɡ e u̯ n d e
bagil	b a ɡ i l
bagina	b a ɡ i n a
bagina	b a ɡ i ɲ a
bagindoaz	b a ɡ i n d o a s̻
bagintez	b a ɡ i n t e s̻
bahegi	b a e ɡ i
bahegi	b a h e ɡ i
bahegitza	b a e ɡ i t͡s̻ a
bahegitza	b a h e ɡ i t͡s̻ a
baheki	b a e k i
baheki	b a h e k i
bahekizki	b a e k i s̻ k i
bahekizki	b a h e k i s̻ k i
bahekusa	b a e k u s̺ a
bahekusa	b a h e k u s̺ a
bahekuski	b a e k u s̺ k i
bahekuski	b a h e k u s̺ k i
bahenbil	b a e m b i l
bahenbil	b a h e m b i l
bahendi	b a e n d i
bahendi	b a h e n d i
bahengo	b a e n ɡ o
bahengo	b a h e n ɡ o
bahentor	b a e n t o r
bahentor	b a h e n t o r
bahentzu	b a e n t͡s̻ u
bahentzu	b a h e n t͡s̻ u
bahentzuzki	b a e n t͡s̻ u s̻ k i
bahentzuzki	b a h e n t͡s̻ u s̻ k i
baherakuski	b a e ɾ a k u s̺ k i
baherakuski	b a h e ɾ a k u s̺ k i
baherakutsa	b a e ɾ a k u t͡s̺ a
baherakutsa	b a h e ɾ a k u t͡s̺ a
bahihardu	b a h i h a r d u
bahihardu	b a i a r d u
bahiharduka	b a h i h a r d u k a
bahiharduka	b a i a r d u k a
bahindoa	b a h i n d o a
bahindoa	b a i n d o a
bahintz	b a h i n t͡s̻
bahintz	b a i n t͡s̻
bahirau	b a h i ɾ a u̯
bahirau	b a i ɾ a u̯
bahirudi	b a h i ɾ u d i
bahirudi	b a i ɾ u d i
bai	b a i̯
baina	b a i̯ n a
baina	b a ɲ a
baino	b a i̯ n o
baino	b a ɲ o
baita	b a i̯ t a
bakarrik	b a k a r i k
bake	b a k e
baketu	b a k e t u
baketuko	b a k e t u k o
baketze	b a k e t͡s̻ e
baketzen	b a k e t͡s̻ e n
bakteriofago	b a k t e ɾ i o f a ɡ o
baldin	b a l d i n
balebil	b a l e b i l
balebiltza	b a l e b i l t͡s̻ a
baledi	b a l e d i
balegi	b a l e ɡ i
balegite	b a l e ɡ i t e
balegitza	b a l e ɡ i t͡s̻ a
balegitzate	b a l e ɡ i t͡s̻ a t e
balego	b a l e ɡ o
baleki	b a l e k i
balekite	b a l e k i t e
balekizki	b a l e k i s̻ k i
balekizkite	b a l e k i s̻ k i t e
balekusa	b a l e k u s̺ a
balekusate	b a l e k u s̺ a t e
balekuski	b a l e k u s̺ k i
balekuskite	b a l e k u s̺ k i t e
balentzu	b a l e n t͡s̻ u
balentzute	b a l e n t͡s̻ u t e
balentzuzki	b a l e n t͡s̻ u s̻ k i
balentzuzkite	b a l e n t͡s̻ u s̻ k i t e
balerakuski	b a l e ɾ a k u s̺ k i
balerakuskite	b a l e ɾ a k u s̺ k i t e
balerakutsa	b a l e ɾ a k u t͡s̺ a
balerakutsate	b a l e ɾ a k u t͡s̺ a t e
baletor	b a l e t o r
baletoz	b a l e t o s̻
baleude	b a l e u̯ d e
balihardu	b a l i a r d u
balihardu	b a l i h a r d u
baliharduka	b a l i a r d u k a
baliharduka	b a l i h a r d u k a
balihardukate	b a l i a r d u k a t e
balihardukate	b a l i h a r d u k a t e
balihardute	b a l i a r d u t e
balihardute	b a l i h a r d u t e
balihoa	b a l i h o a
balihoa	b a l i o a
balihoaz	b a l i h o a s̻
balihoaz	b a l i o a s̻
balira	b a l i ɾ a
balirau	b a l i ɾ a u̯
baliraute	b a l i ɾ a u̯ t e
balirudi	b a l i ɾ u d i
balirudite	b a l i ɾ u d i t e
balitez	b a l i t e s̻
balitz	b a l i t͡s̻
bana	b a n a
banatu	b a n a t u
banatuko	b a n a t u k o
banatze	b a n a t͡s̻ e
banatzen	b a n a t͡s̻ e n
bandalismo	b a n d a l i s̺ m o
banegi	b a n e ɡ i
banegitza	b a n e ɡ i t͡s̻ a
baneki	b a n e k i
banekizki	b a n e k i s̻ k i
banekusa	b a n e k u s̺ a
banekuski	b a n e k u s̺ k i
banenbil	b a n e m b i l
banendi	b a n e n d i
banengo	b a n e n ɡ o
banentor	b a n e n t o r
banentorkio	b a n e n t o r k i o
banentzu	b a n e n t͡s̻ u
banentzuzki	b a n e n t͡s̻ u s̻ k i
banerakuski	b a n e ɾ a k u s̺ k i
banerakutsa	b a n e ɾ a k u t͡s̺ a
banihardu	b a n i a r d u
banihardu	b a n i h a r d u
baniharduka	b a n i a r d u k a
baniharduka	b a n i h a r d u k a
banindoa	b a n i n d o a
banintz	b a n i n t͡s̻
banirau	b a n i ɾ a u̯
banirudi	b a n i ɾ u d i
banpiro	b a m p i ɾ o
barantaila	b a ɾ a n t a i̯ l a
barantaila	b a ɾ a n t a ʎ a
barazkari	b a ɾ a s̻ k a ɾ i
barbuda	b a r b u d a
bare	b a ɾ e
bariku	b a ɾ i k u
barna	b a r n a
barrabil	b a r a b i l
barre	b a r e
barren	b a r e n
barrena	b a r e n a
bart	b a r t
basajaun	b a s̺ a j a u̯ n
basajaun	b a s̺ a x a u̯ n
baseliza	b a s̺ e l i s̻ a
baserri	b a s̺ e r i
baserritar	b a s̺ e r i t a r
baserritartu	b a s̺ e r i t a r t u
baserritartuko	b a s̺ e r i t a r t u k o
baserritartze	b a s̺ e r i t a r t͡s̻ e
baserritartzen	b a s̺ e r i t a r t͡s̻ e n
baso	b a s̺ o
basurde	b a s̺ u r d e
bat	b a t
bata	b a t a
bataio	b a t a i̯ o
batak	b a t a k
batean	b a t e a n
batek	b a t e k
baten	b a t e n
batera	b a t e ɾ a
batez	b a t e s̻
bati	b a t i
batzuetan	b a t͡s̻ u e t a n
bazenbiltza	b a s̻ e m b i l t͡s̻ a
bazenbiltzate	b a s̻ e m b i l t͡s̻ a t e
bazenegi	b a s̻ e n e ɡ i
bazenegite	b a s̻ e n e ɡ i t e
bazenegitza	b a s̻ e n e ɡ i t͡s̻ a
bazenegitzate	b a s̻ e n e ɡ i t͡s̻ a t e
bazeneki	b a s̻ e n e k i
bazenekite	b a s̻ e n e k i t e
bazenekizki	b a s̻ e n e k i s̻ k i
bazenekizkite	b a s̻ e n e k i s̻ k i t e
bazenekusa	b a s̻ e n e k u s̺ a
bazenekusate	b a s̻ e n e k u s̺ a t e
bazenekuski	b a s̻ e n e k u s̺ k i
bazenekuskite	b a s̻ e n e k u s̺ k i t e
bazenentzu	b a s̻ e n e n t͡s̻ u
bazenentzute	b a s̻ e n e n t͡s̻ u t e
bazenentzuzki	b a s̻ e n e n t͡s̻ u s̻ k i
bazenentzuzkite	b a s̻ e n e n t͡s̻ u s̻ k i t e
bazenerakuski	b a s̻ e n e ɾ a k u s̺ k i
bazenerakuskite	b a s̻ e n e ɾ a k u s̺ k i t e
bazenerakutsa	b a s̻ e n e ɾ a k u t͡s̺ a
bazenerakutsate	b a s̻ e n e ɾ a k u t͡s̺ a t e
bazenihardu	b a s̻ e n i a r d u
bazenihardu	b a s̻ e n i h a r d u
bazeniharduka	b a s̻ e n i a r d u k a
bazeniharduka	b a s̻ e n i h a r d u k a
bazenihardukate	b a s̻ e n i a r d u k a t e
bazenihardukate	b a s̻ e n i h a r d u k a t e
bazenihardute	b a s̻ e n i a r d u t e
bazenihardute	b a s̻ e n i h a r d u t e
bazenirau	b a s̻ e n i ɾ a u̯
bazeniraute	b a s̻ e n i ɾ a u̯ t e
bazenirudi	b a s̻ e n i ɾ u d i
bazenirudite	b a s̻ e n i ɾ u d i t e
bazentoz	b a s̻ e n t o s̻
bazentozte	b a s̻ e n t o s̻ t e
bazeunde	b a s̻ e u̯ n d e
bazeundete	b a s̻ e u̯ n d e t e
bazina	b a s̻ i n a
bazina	b a s̻ i ɲ a
bazindoaz	b a s̻ i n d o a s̻
bazindoazte	b a s̻ i n d o a s̻ t e
bazinete	b a s̻ i n e t e
bazinete	b a s̻ i ɲ e t e
bazintez	b a s̻ i n t e s̻
bazintezte	b a s̻ i n t e s̻ t e
be	b e
bebil	b e b i l
bebiltza	b e b i l t͡s̻ a
bederatzi	b e d e ɾ a t͡s̻ i
bedi	b e d i
begi	b e ɡ i
begira	b e ɡ i ɾ a
begiratu	b e ɡ i ɾ a t u
begiratuko	b e ɡ i ɾ a t u k o
begiratze	b e ɡ i ɾ a t͡s̻ e
begiratzen	b e ɡ i ɾ a t͡s̻ e n
begite	b e ɡ i t e
begitza	b e ɡ i t͡s̻ a
bego	b e ɡ o
behar	b e a r
behar	b e h a r
behartsu	b e a r t͡s̺ u
behartsu	b e h a r t͡s̺ u
behi	b e h i
behi	b e i
beki	b e k i
bekie	b e k i e
bekite	b e k i t e
bekizki	b e k i s̻ k i
bekizkite	b e k i s̻ k i t e
bekusa	b e k u s̺ a
bekusate	b e k u s̺ a t e
bekuski	b e k u s̺ k i
bekuskite	b e k u s̺ k i t e
belarri	b e l a r i
beldur	b e l d u r
bele	b e l e
belgika	b e l ɡ i k a
belgikar	b e l ɡ i k a r
beltx	b e l t͡ʃ
beltz	b e l t͡s̻
belz	b e l s̻
bentzu	b e n t͡s̻ u
bentzute	b e n t͡s̻ u t e
bentzuzki	b e n t͡s̻ u s̻ k i
bentzuzkite	b e n t͡s̻ u s̻ k i t e
bera	b e ɾ a
berakuski	b e ɾ a k u s̺ k i
berakuskite	b e ɾ a k u s̺ k i t e
berakutsa	b e ɾ a k u t͡s̺ a
berakutsate	b e ɾ a k u t͡s̺ a t e
berde	b e r d e
berdin	b e r d i n
berdintasun	b e r d i n t a s̺ u n
bere	b e ɾ e
beren	b e ɾ e n
berilio	b e ɾ i l i o
bernedo	b e r n e d o
bero	b e ɾ o
beroa	b e ɾ o a
beroate	b e ɾ o a t e
beroatza	b e ɾ o a t͡s̻ a
beroatzate	b e ɾ o a t͡s̻ a t e
berori	b e ɾ o ɾ i
berpiztu	b e r p i s̻ t u
berri	b e r i
berriro	b e r i ɾ o
bertso	b e r t͡s̺ o
bertsolari	b e r t͡s̺ o l a ɾ i
besape	b e s̺ a p e
beso	b e s̺ o
beste	b e s̺ t e
beti	b e t i
betor	b e t o r
betoz	b e t o s̻
betza	b e t͡s̻ a
beude	b e u̯ d e
beutza	b e u̯ t͡s̻ a
bi	b i
bide	b i d e
bidegorri	b i d e ɡ o r i
bidesari	b i d e s̺ a ɾ i
bielorrusia	b j e l o r u s̺ i a
bielorrusiera	b j e l o r u s̺ i e ɾ a
bigarren	b i ɡ a r e n
bihar	b i a r
bihar	b i h a r
bihardu	b i a r d u
bihardu	b i h a r d u
biharduka	b i a r d u k a
biharduka	b i h a r d u k a
bihardukate	b i a r d u k a t e
bihardukate	b i h a r d u k a t e
bihardute	b i a r d u t e
bihardute	b i h a r d u t e
bihoa	b i h o a
bihoa	b i o a
bihoaz	b i h o a s̻
bihoaz	b i o a s̻
bihotz	b i h o t͡s̻
bihotz	b i o t͡s̻
bikoitz	b i k o i̯ t͡s̻
bikote	b i k o t e
bilatu	b i l a t u
bilatu	b i ʎ a t u
bilbo	b i l b o
bildil	b i l d i l
bira	b i ɾ a
birau	b i ɾ a u̯
biraute	b i ɾ a u̯ t e
birika	b i ɾ i k a
birudi	b i ɾ u d i
birudite	b i ɾ u d i t e
bitez	b i t e s̻
bizar	b i s̻ a r
boilur	b o i̯ l u r
boilur	b o ʎ u r
boro	b o ɾ o
boronde	b o ɾ o n d e
bosgarren	b o s̺ ɡ a r e n
boskoitz	b o s̺ k o i̯ t͡s̻
bosniera	b o s̺ n i e ɾ a
bost	b o s̺
bost	b o s̺ t
bosten	b o s̺ t e n
bostortz	b o s̺ t o r t͡s̻
bozkatu	b o s̻ k a t u
bretoiera	b r e t o i̯ e ɾ a
bukatu	b u k a t u
bulgaria	b u l ɡ a ɾ i a
bulgarian	b u l ɡ a ɾ i a n
bulgariera	b u l ɡ a ɾ i e ɾ a
burdina	b u r d i n a
burdina	b u r d i ɲ a
burdinbide	b u r d i m b i d e
burdingintza	b u r d i n ɡ i n t͡s̻ a
buru	b u ɾ u
buruil	b u ɾ u i̯ l
burukomin	b u ɾ u k o m i n
burumuin	b u ɾ u m u i̯ n
buruz	b u ɾ u s̻
büü	b y y
c	s̻ e
carmeltazita	k a r m e l t a s̻ i t a
d	d e
da	d a
dabil	d a b i l
dabilela	d a b i l e l a
dabilela	d a b i ʎ e l a
dabilen	d a b i l e n
dabilen	d a b i ʎ e n
dabilke	d a b i l k e
dabiltza	d a b i l t͡s̻ a
dabiltzala	d a b i l t͡s̻ a l a
dabiltzan	d a b i l t͡s̻ a n
dabilzke	d a b i l s̻ k e
dadila	d a d i l a
dadila	d a d i ʎ a
dadin	d a d i n
dagi	d a ɡ i
dagigu	d a ɡ i ɡ u
dagik	d a ɡ i k
dagin	d a ɡ i n
dagit	d a ɡ i t
dagite	d a ɡ i t e
dagitza	d a ɡ i t͡s̻ a
dagitzagu	d a ɡ i t͡s̻ a ɡ u
dagitzak	d a ɡ i t͡s̻ a k
dagitzan	d a ɡ i t͡s̻ a n
dagitzat	d a ɡ i t͡s̻ a t
dagitzate	d a ɡ i t͡s̻ a t e
dagitzazu	d a ɡ i t͡s̻ a s̻ u
dagitzazue	d a ɡ i t͡s̻ a s̻ u e
dagizu	d a ɡ i s̻ u
dagizue	d a ɡ i s̻ u e
dago	d a ɡ o
dagoela	d a ɡ o e l a
dagoen	d a ɡ o e n
dagoke	d a ɡ o k e
dagonil	d a ɡ o n i l
daiteke	d a i̯ t e k e
daitezela	d a i̯ t e s̻ e l a
daitezen	d a i̯ t e s̻ e n
daitezke	d a i̯ t e s̻ k e
daki	d a k i
dakigu	d a k i ɡ u
dakik	d a k i k
dakin	d a k i n
dakit	d a k i t
dakite	d a k i t e
dakizki	d a k i s̻ k i
dakizkigu	d a k i s̻ k i ɡ u
dakizkik	d a k i s̻ k i k
dakizkin	d a k i s̻ k i n
dakizkit	d a k i s̻ k i t
dakizkite	d a k i s̻ k i t e
dakizkizu	d a k i s̻ k i s̻ u
dakizkizue	d a k i s̻ k i s̻ u e
dakizu	d a k i s̻ u
dakizue	d a k i s̻ u e
dakusa	d a k u s̺ a
dakusagu	d a k u s̺ a ɡ u
dakusak	d a k u s̺ a k
dakusan	d a k u s̺ a n
dakusat	d a k u s̺ a t
dakusate	d a k u s̺ a t e
dakusazu	d a k u s̺ a s̻ u
dakusazue	d a k u s̺ a s̻ u e
dakuski	d a k u s̺ k i
dakuskigu	d a k u s̺ k i ɡ u
dakuskik	d a k u s̺ k i k
dakuskin	d a k u s̺ k i n
dakuskit	d a k u s̺ k i t
dakuskite	d a k u s̺ k i t e
dakuskizu	d a k u s̺ k i s̻ u
dakuskizue	d a k u s̺ k i s̻ u e
daniera	d a n i e ɾ a
danimarka	d a n i m a r k a
dantzu	d a n t͡s̻ u
dantzugu	d a n t͡s̻ u ɡ u
dantzuk	d a n t͡s̻ u k
dantzun	d a n t͡s̻ u n
dantzut	d a n t͡s̻ u t
dantzute	d a n t͡s̻ u t e
dantzuzki	d a n t͡s̻ u s̻ k i
dantzuzkigu	d a n t͡s̻ u s̻ k i ɡ u
dantzuzkik	d a n t͡s̻ u s̻ k i k
dantzuzkin	d a n t͡s̻ u s̻ k i n
dantzuzkit	d a n t͡s̻ u s̻ k i t
dantzuzkite	d a n t͡s̻ u s̻ k i t e
dantzuzkizu	d a n t͡s̻ u s̻ k i s̻ u
dantzuzkizue	d a n t͡s̻ u s̻ k i s̻ u e
dantzuzu	d a n t͡s̻ u s̻ u
dantzuzue	d a n t͡s̻ u s̻ u e
darakuski	d a ɾ a k u s̺ k i
darakuskigu	d a ɾ a k u s̺ k i ɡ u
darakuskik	d a ɾ a k u s̺ k i k
darakuskin	d a ɾ a k u s̺ k i n
darakuskit	d a ɾ a k u s̺ k i t
darakuskite	d a ɾ a k u s̺ k i t e
darakuskizu	d a ɾ a k u s̺ k i s̻ u
darakuskizue	d a ɾ a k u s̺ k i s̻ u e
darakutsa	d a ɾ a k u t͡s̺ a
darakutsagu	d a ɾ a k u t͡s̺ a ɡ u
darakutsak	d a ɾ a k u t͡s̺ a k
darakutsan	d a ɾ a k u t͡s̺ a n
darakutsat	d a ɾ a k u t͡s̺ a t
darakutsate	d a ɾ a k u t͡s̺ a t e
darakutsazu	d a ɾ a k u t͡s̺ a s̻ u
darakutsazue	d a ɾ a k u t͡s̺ a s̻ u e
darama	d a ɾ a m a
daratulu	d a ɾ a t u l u
darik	d a ɾ i k
darin	d a ɾ i n
daroa	d a ɾ o a
daroagu	d a ɾ o a ɡ u
daroak	d a ɾ o a k
daroan	d a ɾ o a n
daroat	d a ɾ o a t
daroate	d a ɾ o a t e
daroatza	d a ɾ o a t͡s̻ a
daroatzagu	d a ɾ o a t͡s̻ a ɡ u
daroatzak	d a ɾ o a t͡s̻ a k
daroatzan	d a ɾ o a t͡s̻ a n
daroatzat	d a ɾ o a t͡s̻ a t
daroatzate	d a ɾ o a t͡s̻ a t e
daroatzazu	d a ɾ o a t͡s̻ a s̻ u
daroatzazue	d a ɾ o a t͡s̻ a s̻ u e
daroazu	d a ɾ o a s̻ u
daroazue	d a ɾ o a s̻ u e
dateke	d a t e k e
dator	d a t o r
datorke	d a t o r k e
datorrela	d a t o r e l a
datorren	d a t o r e n
datoz	d a t o s̻
datozela	d a t o s̻ e l a
datozen	d a t o s̻ e n
datozke	d a t o s̻ k e
datxekie	d a t͡ʃ e k i e
datxekigu	d a t͡ʃ e k i ɡ u
datxekik	d a t͡ʃ e k i k
datxekin	d a t͡ʃ e k i n
datxekio	d a t͡ʃ e k i o
datxekit	d a t͡ʃ e k i t
datxekizu	d a t͡ʃ e k i s̻ u
datxekizue	d a t͡ʃ e k i s̻ u e
datxezkie	d a t͡ʃ e s̻ k i e
datxezkigu	d a t͡ʃ e s̻ k i ɡ u
datxezkik	d a t͡ʃ e s̻ k i k
datxezkin	d a t͡ʃ e s̻ k i n
datxezkio	d a t͡ʃ e s̻ k i o
datxezkit	d a t͡ʃ e s̻ k i t
datxezkizu	d a t͡ʃ e s̻ k i s̻ u
datxezkizue	d a t͡ʃ e s̻ k i s̻ u e
datza	d a t͡s̻ a
daude	d a u̯ d e
daudeke	d a u̯ d e k e
daudela	d a u̯ d e l a
dauden	d a u̯ d e n
dautza	d a u̯ t͡s̻ a
de	d e
deabru	d e a b r u
dei	d e i̯
deia	d e i̯ a
deien	d e i̯ e n
deira	d e i̯ ɾ a
deiri	d e i̯ ɾ i
deitara	d e i̯ t a ɾ a
deitura	d e i̯ t u ɾ a
deiz	d e i̯ s̻
desberdin	d e s̺ b e r d i n
desberdintasun	d e s̺ b e r d i n t a s̺ u n
dihardu	d i a r d u
dihardu	d i h a r d u
dihardugu	d i a r d u ɡ u
dihardugu	d i h a r d u ɡ u
diharduk	d i a r d u k
diharduk	d i h a r d u k
diharduka	d i a r d u k a
diharduka	d i h a r d u k a
dihardukagu	d i a r d u k a ɡ u
dihardukagu	d i h a r d u k a ɡ u
dihardukak	d i a r d u k a k
dihardukak	d i h a r d u k a k
dihardukan	d i a r d u k a n
dihardukan	d i h a r d u k a n
dihardukat	d i a r d u k a t
dihardukat	d i h a r d u k a t
dihardukate	d i a r d u k a t e
dihardukate	d i h a r d u k a t e
dihardukazu	d i a r d u k a s̻ u
dihardukazu	d i h a r d u k a s̻ u
dihardukazue	d i a r d u k a s̻ u e
dihardukazue	d i h a r d u k a s̻ u e
dihardun	d i a r d u n
dihardun	d i h a r d u n
dihardut	d i a r d u t
dihardut	d i h a r d u t
dihardute	d i a r d u t e
dihardute	d i h a r d u t e
diharduzu	d i a r d u s̻ u
diharduzu	d i h a r d u s̻ u
diharduzue	d i a r d u s̻ u e
diharduzue	d i h a r d u s̻ u e
dira	d i ɾ a
dirateke	d i ɾ a t e k e
dirau	d i ɾ a u̯
diraugu	d i ɾ a u̯ ɡ u
dirauk	d i ɾ a u̯ k
diraun	d i ɾ a u̯ n
diraut	d i ɾ a u̯ t
diraute	d i ɾ a u̯ t e
dirauzu	d i ɾ a u̯ s̻ u
dirauzue	d i ɾ a u̯ s̻ u e
dirudi	d i ɾ u d i
dirudigu	d i ɾ u d i ɡ u
dirudik	d i ɾ u d i k
dirudin	d i ɾ u d i n
dirudit	d i ɾ u d i t
dirudite	d i ɾ u d i t e
dirudizu	d i ɾ u d i s̻ u
dirudizue	d i ɾ u d i s̻ u e
diskoetxe	d i s̺ k o e t͡ʃ e
doa	d o a
doake	d o a k e
doan	d o a n
doaz	d o a s̻
doazen	d o a s̻ e n
doazke	d o a s̻ k e
domeka	d o m e k a
donostia	d o n o s̺ t j a
dortoka	d o r t o k a
dromedario	d r o m e d a ɾ i o
e	e
ebiakoitz	e b i a k o i̯ t͡s̻
edan	e d a n
edari	e d a ɾ i
eder	e d e r
edertasun	e d e r t a s̺ u n
edin	e d i n
edonor	e d o n o r
edozer	e d o s̻ e r
eduki	e d u k i
edukiko	e d u k i k o
edukitze	e d u k i t͡s̻ e
edukitzen	e d u k i t͡s̻ e n
edun	e d u n
efe	e f e
egia	e ɡ i a
egiaz	e ɡ i a s̻
egiazko	e ɡ i a s̻ k o
egiaztatu	e ɡ i a s̻ t a t u
egik	e ɡ i k
egin	e ɡ i n
egingo	e ɡ i n ɡ o
egitasmo	e ɡ i t a s̺ m o
egite	e ɡ i t e
egiten	e ɡ i t e n
egitzak	e ɡ i t͡s̻ a k
egitzan	e ɡ i t͡s̻ a n
egitzazu	e ɡ i t͡s̻ a s̻ u
egitzazue	e ɡ i t͡s̻ a s̻ u e
egizu	e ɡ i s̻ u
egizue	e ɡ i s̻ u e
egon	e ɡ o n
egongo	e ɡ o n ɡ o
egote	e ɡ o t e
egoten	e ɡ o t e n
eguazten	e ɡ u a s̻ t e n
egubakoitz	e ɡ u b a k o i̯ t͡s̻
eguberri	e ɡ u b e r i
eguen	e ɡ u e n
egun	e ɡ u n
egur	e ɡ u r
eguzkitsu	e ɡ u s̻ k i t͡s̺ u
ehe	e h e
ehe	e h̃ e
ehiza	e h i s̻ a
ehiza	e i s̻ a
ehun	e h u n
ehun	e u n
ekain	e k a i̯ n
ekaiztsu	e k a i̯ s̻ t͡s̺ u
ekark	e k a r k
ekarna	e k a r n a
ekarri	e k a r i
ekialde	e k i a l d e
ele	e l e
elefante	e l e f a n t e
eliza	e l i s̻ a
elkar	e l k a r
elkarlan	e l k a r l a n
elkarrekin	e l k a r e k i n
elkarren	e l k a r e n
elkarrengan	e l k a r e n ɡ a n
elkarrengana	e l k a r e n ɡ a n a
elkarrenganaino	e l k a r e n ɡ a n a i̯ n o
elkarrenganaino	e l k a r e n ɡ a n a ɲ o
elkarrenganako	e l k a r e n ɡ a n a k o
elkarrenganantz	e l k a r e n ɡ a n a n t͡s̻
elkarrengandik	e l k a r e n ɡ a n d i k
elkarrengatik	e l k a r e n ɡ a t i k
elkarrentzat	e l k a r e n t͡s̻ a t
elkarrez	e l k a r e s̻
elkarri	e l k a r i
eltxo	e l t͡ʃ o
emagaldu	e m a ɡ a l d u
emakume	e m a k u m e
eman	e m a n
eme	e m e
enara	e n a ɾ a
ene	e n e
enegan	e n e ɡ a n
enigmatiko	e n i ɡ m a t i k o
entzuk	e n t͡s̻ u k
entzun	e n t͡s̻ u n
entzuzu	e n t͡s̻ u s̻ u
entzuzue	e n t͡s̻ u s̻ u e
epail	e p a i̯ l
eper	e p e r
erabili	e ɾ a b i l i
erabili	e ɾ a b i ʎ i
erakutsak	e ɾ a k u t͡s̺ a k
erakutsan	e ɾ a k u t͡s̺ a n
erakutsazu	e ɾ a k u t͡s̺ a s̻ u
erakutsazue	e ɾ a k u t͡s̺ a s̻ u e
erakutsi	e ɾ a k u t͡s̺ i
eraman	e ɾ a m a n
erbi	e r b i
erdara	e r d a ɾ a
erdi	e r d i
ereiaro	e ɾ e i̯ a ɾ o
eri	e ɾ i
erion	e ɾ i o n
erlategi	e r l a t e ɡ i
erlauntza	e r l a u̯ n t͡s̻ a
ermita	e r m i t a
erne	e r n e
eroak	e ɾ o a k
eroan	e ɾ o a n
eroango	e ɾ o a n ɡ o
eroate	e ɾ o a t e
eroaten	e ɾ o a t e n
eroazu	e ɾ o a s̻ u
eroazue	e ɾ o a s̻ u e
erori	e ɾ o ɾ i
eros	e ɾ o s̺
erosak	e ɾ o s̺ a k
erosan	e ɾ o s̺ a n
erosazu	e ɾ o s̺ a s̻ u
erosazue	e ɾ o s̺ a s̻ u e
erosi	e ɾ o s̺ i
erosiek	e ɾ o s̺ i e k
erosien	e ɾ o s̺ i e n
erosiok	e ɾ o s̺ i o k
erosion	e ɾ o s̺ i o n
erostak	e ɾ o s̺ t a k
erostan	e ɾ o s̺ t a n
errain	e r a i̯ n
erraldoi	e r a l d o i̯
erran	e r a n
errauts	e r a u̯ t͡s̺
erraz	e r a s̻
erre	e r e
erreferentzia	e r e f e ɾ e n t͡s̻ i a
erregina	e r e ɡ i n a
erregina	e r e ɡ i ɲ a
erreka	e r e k a
errepide	e r e p i d e
errepika	e r e p i k a
erresuma	e r e s̺ u m a
errez	e r e s̻
errota	e r o t a
erru	e r u
errumania	e r u m a n i a
errumaniar	e r u m a n i a r
errumaniera	e r u m a n i e ɾ a
errusia	e r u s̺ i a
errusiar	e r u s̺ i a r
errusiera	e r u s̺ i e ɾ a
ertz	e r t͡s̻
ertzain	e r t͡s̻ a i̯ n
esan	e s̺ a n
ese	e s̺ e
esker	e s̺ k e r
eskozia	e s̺ k o s̻ i a
eskribitu	e s̺ k r i b i t u
esku	e s̺ k u
eskubila	e s̺ k u b i l a
eskubila	e s̺ k u b i ʎ a
eslovakia	e s̺ l o b a k i a
eslovakiar	e s̺ l o b a k i a r
eslovakiera	e s̺ l o b a k i e ɾ a
eslovenia	e s̺ l o b e n i a
esloveniar	e s̺ l o b e n i a r
esloveniera	e s̺ l o b e n i e ɾ a
esne	e s̺ n e
espainia	e s̺ p a i̯ n i a
espainia	e s̺ p a ɲ i a
espainiar	e s̺ p a i̯ n i a r
espainiar	e s̺ p a ɲ i a r
esperanto	e s̺ p e ɾ a n t o
espresuki	e s̺ p r e s̺ u k i
estatu	e s̺ t a t u
estatua	e s̺ t a t u a
estatua	e s̺ t a t w a
estonia	e s̺ t o n i a
estoniako	e s̺ t o n i a k o
estonian	e s̺ t o n i a n
estoniar	e s̺ t o n i a r
estoniera	e s̺ t o n i e ɾ a
estralurtar	e s̺ t r a l u r t a r
eta	e t a
eten	e t e n
etete	e t e t e
etor	e t o r
etorri	e t o r i
etorriko	e t o r i k o
etortze	e t o r t͡s̻ e
etortzen	e t o r t͡s̻ e n
etsai	e t͡s̺ a i̯
etxe	e t͡ʃ e
etzan	e t͡s̻ a n
etzango	e t͡s̻ a n ɡ o
etzate	e t͡s̻ a t e
etzaten	e t͡s̻ a t e n
etzi	e t͡s̻ i
euli	e u̯ l i
eurak	e u̯ ɾ a k
euri	e u̯ ɾ i
eurok	e u̯ ɾ o k
euskadi	e u̯ s̺ k a d i
euskal	e u̯ s̺ k a l
euskaldun	e u̯ s̺ k a l d u n
euskaltegi	e u̯ s̺ k a l t e ɡ i
euskara	e u̯ s̺ k a ɾ a
euskera	e u̯ s̺ k e ɾ a
euzkadi	e u̯ s̻ k a d i
ez	e s̻
ezagut	e s̻ a ɡ u t
ezagutu	e s̻ a ɡ u t u
ezagutuko	e s̻ a ɡ u t u k o
ezagutze	e s̻ a ɡ u t͡s̻ e
ezagutzen	e s̻ a ɡ u t͡s̻ e n
ezberdin	e s̻ b e r d i n
ezberdintasun	e s̻ b e r d i n t a s̺ u n
ezer	e s̻ e r
ezeri	e s̻ e ɾ i
ezezagun	e s̻ e s̻ a ɡ u n
ezker	e s̻ k e r
ezkerra	e s̻ k e r a
ezko	e s̻ k o
ezkondu	e s̻ k o n d u
ezkongabe	e s̻ k o n ɡ a b e
ezkontza	e s̻ k o n t͡s̻ a
ezkutatu	e s̻ k u t a t u
ezpel	e s̻ p e l
eztarri	e s̻ t a r i
ezti	e s̻ t i
eñe	e ɲ e
f	e f e
fanfarroi	f a n f a r o i̯
fetitxe	f e t i t͡ʃ e
fetitxismo	f e t i t͡ʃ i s̺ m o
finlandia	f i n l a n d i a
finlandiar	f i n l a n d i a r
finlandiera	f i n l a n d i e ɾ a
flatulentzia	f l a t u l e n t͡s̻ i a
fluor	f l u o r
frantses	f r a n t͡s̺ e s̺
frantzia	f r a n t͡s̻ i a
frantziar	f r a n t͡s̻ i a r
fruta	f r u t a
g	ɡ e
gabarra	ɡ a b a r a
gabiltza	ɡ a b i l t͡s̻ a
gabiltzan	ɡ a b i l t͡s̻ a n
gabilzke	ɡ a b i l s̻ k e
gai	ɡ a i̯
gailu	ɡ a i̯ l u
gailu	ɡ a ʎ u
gailur	ɡ a i̯ l u r
gailur	ɡ a ʎ u r
gaitezen	ɡ a i̯ t e s̻ e n
gaitezke	ɡ a i̯ t e s̻ k e
gaizki	ɡ a i̯ s̻ k i
gaizto	ɡ a i̯ s̻ t o
galdu	ɡ a l d u
galeper	ɡ a l e p e r
gales	ɡ a l e s̺
galesera	ɡ a l e s̺ e ɾ a
galiziar	ɡ a l i s̻ i a r
galtzak	ɡ a l t͡s̻ a k
galtzarbe	ɡ a l t͡s̻ a r b e
galtzari	ɡ a l t͡s̻ a ɾ i
galtzerdi	ɡ a l t͡s̻ e r d i
galtzetin	ɡ a l t͡s̻ e t i n
gamelu	ɡ a m e l u
gara	ɡ a ɾ a
garabi	ɡ a ɾ a b i
garagar	ɡ a ɾ a ɡ a r
garagardo	ɡ a ɾ a ɡ a r d o
garagarril	ɡ a ɾ a ɡ a r i l
garai	ɡ a ɾ a i̯
garateke	ɡ a ɾ a t e k e
garbantzu	ɡ a r b a n t͡s̻ u
garesti	ɡ a ɾ e s̺ t i
gari	ɡ a ɾ i
garil	ɡ a ɾ i l
garizuma	ɡ a ɾ i s̻ u m a
gasteiz	ɡ a s̺ t e i̯ s̻
gatazka	ɡ a t a s̻ k a
gatoz	ɡ a t o s̻
gatozen	ɡ a t o s̻ e n
gatozke	ɡ a t o s̻ k e
gatxezkie	ɡ a t͡ʃ e s̻ k i e
gatxezkik	ɡ a t͡ʃ e s̻ k i k
gatxezkin	ɡ a t͡ʃ e s̻ k i n
gatxezkio	ɡ a t͡ʃ e s̻ k i o
gatxezkizu	ɡ a t͡ʃ e s̻ k i s̻ u
gatxezkizue	ɡ a t͡ʃ e s̻ k i s̻ u e
gatz	ɡ a t͡s̻
gau	ɡ a u̯
gaude	ɡ a u̯ d e
gaudeke	ɡ a u̯ d e k e
gauden	ɡ a u̯ d e n
gauenara	ɡ a u̯ e n a ɾ a
gaupasa	ɡ a u̯ p a s̺ a
gaur	ɡ a u̯ r
gautza	ɡ a u̯ t͡s̻ a
gauza	ɡ a u̯ s̻ a
gazi	ɡ a s̻ i
gaztaina	ɡ a s̻ t a i̯ n a
gaztaina	ɡ a s̻ t a ɲ a
gazte	ɡ a s̻ t e
gaztela	ɡ a s̻ t e l a
gaztelania	ɡ a s̻ t e l a n i a
gaztelera	ɡ a s̻ t e l e ɾ a
ge	ɡ e
gela	ɡ e l a
genbiltzan	ɡ e m b i l t͡s̻ a n
genbilzke	ɡ e m b i l s̻ k e
genbilzkeen	ɡ e m b i l s̻ k e e n
genegien	ɡ e n e ɡ i e n
genegike	ɡ e n e ɡ i k e
genegitzake	ɡ e n e ɡ i t͡s̻ a k e
genegitzan	ɡ e n e ɡ i t͡s̻ a n
genekien	ɡ e n e k i e n
genekike	ɡ e n e k i k e
genekizke	ɡ e n e k i s̻ k e
genekizkien	ɡ e n e k i s̻ k i e n
genekusan	ɡ e n e k u s̺ a n
genekusazke	ɡ e n e k u s̺ a s̻ k e
genekuske	ɡ e n e k u s̺ k e
genekuskien	ɡ e n e k u s̺ k i e n
genentzuen	ɡ e n e n t͡s̻ u e n
genentzuke	ɡ e n e n t͡s̻ u k e
genentzuzke	ɡ e n e n t͡s̻ u s̻ k e
genentzuzkien	ɡ e n e n t͡s̻ u s̻ k i e n
generakuske	ɡ e n e ɾ a k u s̺ k e
generakuskien	ɡ e n e ɾ a k u s̺ k i e n
generakutsan	ɡ e n e ɾ a k u t͡s̺ a n
generakutsazke	ɡ e n e ɾ a k u t͡s̺ a s̻ k e
generoake	ɡ e n e ɾ o a k e
generoan	ɡ e n e ɾ o a n
generoatzan	ɡ e n e ɾ o a t͡s̻ a n
generoazke	ɡ e n e ɾ o a s̻ k e
geniharduen	ɡ e n i a r d u e n
geniharduen	ɡ e n i h a r d u e n
genihardukake	ɡ e n i a r d u k a k e
genihardukake	ɡ e n i h a r d u k a k e
genihardukan	ɡ e n i a r d u k a n
genihardukan	ɡ e n i h a r d u k a n
geniharduke	ɡ e n i a r d u k e
geniharduke	ɡ e n i h a r d u k e
genirauen	ɡ e n i ɾ a u̯ e n
genirauke	ɡ e n i ɾ a u̯ k e
genirudien	ɡ e n i ɾ u d i e n
genirudike	ɡ e n i ɾ u d i k e
genkizkien	ɡ e n k i s̻ k i e n
genkizkion	ɡ e n k i s̻ k i o n
gentozen	ɡ e n t o s̻ e n
gentozke	ɡ e n t o s̻ k e
gentozkeen	ɡ e n t o s̻ k e e n
gentxezkiake	ɡ e n t͡ʃ e s̻ k i a k e
gentxezkian	ɡ e n t͡ʃ e s̻ k i a n
gentxezkieke	ɡ e n t͡ʃ e s̻ k i e k e
gentxezkien	ɡ e n t͡ʃ e s̻ k i e n
gentxezkinake	ɡ e n t͡ʃ e s̻ k i n a k e
gentxezkinake	ɡ e n t͡ʃ e s̻ k i ɲ a k e
gentxezkinan	ɡ e n t͡ʃ e s̻ k i n a n
gentxezkinan	ɡ e n t͡ʃ e s̻ k i ɲ a n
gentxezkioke	ɡ e n t͡ʃ e s̻ k i o k e
gentxezkion	ɡ e n t͡ʃ e s̻ k i o n
gentxezkizueke	ɡ e n t͡ʃ e s̻ k i s̻ u e k e
gentxezkizuen	ɡ e n t͡ʃ e s̻ k i s̻ u e n
gentxezkizuke	ɡ e n t͡ʃ e s̻ k i s̻ u k e
gentxezkizun	ɡ e n t͡ʃ e s̻ k i s̻ u n
georgia	ɡ e o r ɡ i a
georgiar	ɡ e o r ɡ i a r
georgiera	ɡ e o r ɡ i e ɾ a
gerezi	ɡ e ɾ e s̻ i
gero	ɡ e ɾ o
gerra	ɡ e r a
gerri	ɡ e r i
gerriko	ɡ e r i k o
geu	ɡ e u̯
geundeke	ɡ e u̯ n d e k e
geundekeen	ɡ e u̯ n d e k e e n
geunden	ɡ e u̯ n d e n
geuntzake	ɡ e u̯ n t͡s̻ a k e
geuntzan	ɡ e u̯ n t͡s̻ a n
geure	ɡ e u̯ ɾ e
gezi	ɡ e s̻ i
ghana	ɡ a n a
ghanan	ɡ a n a n
gibel	ɡ i b e l
giltza	ɡ i l t͡s̻ a
giltzurrun	ɡ i l t͡s̻ u r u n
ginarreba	ɡ i n a r e b a
ginarreba	ɡ i ɲ a r e b a
ginateke	ɡ i n a t e k e
ginateke	ɡ i ɲ a t e k e
ginatekeen	ɡ i n a t e k e e n
ginatekeen	ɡ i ɲ a t e k e e n
gindoazen	ɡ i n d o a s̻ e n
gindoazke	ɡ i n d o a s̻ k e
gindoazkeen	ɡ i n d o a s̻ k e e n
ginen	ɡ i n e n
ginen	ɡ i ɲ e n
gintezen	ɡ i n t e s̻ e n
gintezke	ɡ i n t e s̻ k e
gintezkeen	ɡ i n t e s̻ k e e n
gipuzkoa	ɡ i p u s̻ k o a
gipuzkoan	ɡ i p u s̻ k o a n
gizon	ɡ i s̻ o n
goaz	ɡ o a s̻
goazen	ɡ o a s̻ e n
goazke	ɡ o a s̻ k e
gogo	ɡ o ɡ o
goilara	ɡ o i̯ l a ɾ a
goilara	ɡ o ʎ a ɾ a
goiz	ɡ o i̯ s̻
gontz	ɡ o n t͡s̻
gora	ɡ o ɾ a
gorosti	ɡ o ɾ o s̺ t i
gorotzil	ɡ o ɾ o t͡s̻ i l
gorri	ɡ o r i
gorrimin	ɡ o r i m i n
gorrimotel	ɡ o r i m o t e l
gorringo	ɡ o r i n ɡ o
gosaldu	ɡ o s̺ a l d u
gotzon	ɡ o t͡s̻ o n
gozo	ɡ o s̻ o
grezia	ɡ r e s̻ i a
gris	ɡ r i s̺
gu	ɡ u
guda	ɡ u d a
guk	ɡ u k
gune	ɡ u n e
guneka	ɡ u n e k a
gurdi	ɡ u r d i
gure	ɡ u ɾ e
guri	ɡ u ɾ i
gurpil	ɡ u r p i l
h	a t͡ʃ e
h	h a t͡ʃ e
habe	a b e
habe	h a b e
habil	a b i l
habil	h a b i l
habilen	a b i ʎ e n
habilen	h a b i l e n
habilke	a b i l k e
habilke	h a b i l k e
hadi	a d i
hadi	h a d i
hadin	a d i n
hadin	h a d i n
hagin	a ɡ i n
hagin	h a ɡ i n
hago	a ɡ o
hago	h a ɡ o
hagoen	a ɡ o e n
hagoen	h a ɡ o e n
hagoke	a ɡ o k e
hagoke	h a ɡ o k e
haiei	a i̯ e i̯
haiei	h a i̯ e i̯
haiek	a i̯ e k
haiek	h a i̯ e k
haien	a i̯ e n
haien	h a i̯ e n
haiteke	a i̯ t e k e
haiteke	h a i̯ t e k e
haitz	a i̯ t͡s̻
haitz	h a i̯ t͡s̻
haiz	a i̯ s̻
haiz	h a i̯ s̻
haizateke	a i̯ s̻ a t e k e
haizateke	h a i̯ s̻ a t e k e
haize	a i̯ s̻ e
haize	h a i̯ s̻ e
haizetsu	a i̯ s̻ e t͡s̺ u
haizetsu	h a i̯ s̻ e t͡s̺ u
hakar	a k a r
hakar	h a k a r
hakien	a k i e n
hakien	h a k i e n
hala	a l a
hala	h a l a
haltz	a l t͡s̻
haltz	h a l t͡s̻
hamabi	a m a b i
hamabi	h a m a b i
hamabost	a m a b o s̺ t
hamabost	h a m a b o s̺ t
hamaika	a m a i̯ k a
hamaika	h a m a i̯ k a
hamairu	a m a i̯ ɾ u
hamairu	h a m a i̯ ɾ u
hamalau	a m a l a u̯
hamalau	h a m a l a u̯
hamar	a m a r
hamar	h a m a r
han	a n
han	h a n
haragi	a ɾ a ɡ i
haragi	h a ɾ a ɡ i
haran	a ɾ a n
haran	h a ɾ a n
haren	a ɾ e n
haren	h a ɾ e n
hari	a ɾ i
hari	h a ɾ i
haritz	a ɾ i t͡s̻
haritz	h a ɾ i t͡s̻
haritzezko	a ɾ i t͡s̻ e s̻ k o
haritzezko	h a ɾ i t͡s̻ e s̻ k o
harizki	a ɾ i s̻ k i
harizki	h a ɾ i s̻ k i
hark	a r k
hark	h a r k
harri	a r i
harri	h a r i
hartan	a r t a n
hartan	h a r t a n
hartara	a r t a ɾ a
hartara	h a r t a ɾ a
hartarat	a r t a ɾ a t
hartarat	h a r t a ɾ a t
hartz	a r t͡s̻
hartz	h a r t͡s̻
hasi	a s̺ i
hasi	h a s̺ i
haste	a s̺ t e
haste	h a s̺ t e
hasten	a s̺ t e n
hasten	h a s̺ t e n
hator	a t o r
hator	h a t o r
hatorke	a t o r k e
hatorke	h a t o r k e
hatorren	a t o r e n
hatorren	h a t o r e n
hatxe	a t͡ʃ e
hatxe	h a t͡ʃ e
hatxekie	a t͡ʃ e k i e
hatxekie	h a t͡ʃ e k i e
hatxekigu	a t͡ʃ e k i ɡ u
hatxekigu	h a t͡ʃ e k i ɡ u
hatxekio	a t͡ʃ e k i o
hatxekio	h a t͡ʃ e k i o
hatxekit	a t͡ʃ e k i t
hatxekit	h a t͡ʃ e k i t
hatza	a t͡s̻ a
hatza	h a t͡s̻ a
hau	a u̯
hau	h a u̯
hauei	a u̯ e i̯
hauei	h a u̯ e i̯
hauek	a u̯ e k
hauek	h a u̯ e k
hauen	a u̯ e n
hauen	h a u̯ e n
hauka	a u̯ k a
hauka	h a u̯ k a
haukat	a u̯ k a t
haukat	h a u̯ k a t
hazil	a s̻ i l
hazil	h a s̻ i l
hebreera	e b r e e ɾ a
hebreera	h e b r e e ɾ a
hega	e ɡ a
hega	h e ɡ a
hegal	e ɡ a l
hegal	h e ɡ a l
hegalari	e ɡ a l a ɾ i
hegalari	h e ɡ a l a ɾ i
hegien	e ɡ i e n
hegien	h e ɡ i e n
hegike	e ɡ i k e
hegike	h e ɡ i k e
hegitzake	e ɡ i t͡s̻ a k e
hegitzake	h e ɡ i t͡s̻ a k e
hegitzan	e ɡ i t͡s̻ a n
hegitzan	h e ɡ i t͡s̻ a n
hego	e ɡ o
hego	h e ɡ o
hekien	e k i e n
hekien	h e k i e n
hekike	e k i k e
hekike	h e k i k e
hekizke	e k i s̻ k e
hekizke	h e k i s̻ k e
hekizkien	e k i s̻ k i e n
hekizkien	h e k i s̻ k i e n
hekusan	e k u s̺ a n
hekusan	h e k u s̺ a n
hekusazke	e k u s̺ a s̻ k e
hekusazke	h e k u s̺ a s̻ k e
hekuske	e k u s̺ k e
hekuske	h e k u s̺ k e
hekuskien	e k u s̺ k i e n
hekuskien	h e k u s̺ k i e n
helburu	e l b u ɾ u
helburu	h e l b u ɾ u
helio	e l i o
helio	h e l i o
hemen	e m e n
hemen	h e m e n
henbilen	e m b i ʎ e n
henbilen	h e m b i l e n
henbilke	e m b i l k e
henbilke	h e m b i l k e
henbilkeen	e m b i l k e e n
henbilkeen	h e m b i l k e e n
hendin	e n d i n
hendin	h e n d i n
hengoen	e n ɡ o e n
hengoen	h e n ɡ o e n
hengoke	e n ɡ o k e
hengoke	h e n ɡ o k e
hengokeen	e n ɡ o k e e n
hengokeen	h e n ɡ o k e e n
henkien	e n k i e n
henkien	h e n k i e n
henkion	e n k i o n
henkion	h e n k i o n
hentorke	e n t o r k e
hentorke	h e n t o r k e
hentorkeen	e n t o r k e e n
hentorkeen	h e n t o r k e e n
hentorren	e n t o r e n
hentorren	h e n t o r e n
hentxekidake	e n t͡ʃ e k i d a k e
hentxekidake	h e n t͡ʃ e k i d a k e
hentxekidan	e n t͡ʃ e k i d a n
hentxekidan	h e n t͡ʃ e k i d a n
hentxekieke	e n t͡ʃ e k i e k e
hentxekieke	h e n t͡ʃ e k i e k e
hentxekien	e n t͡ʃ e k i e n
hentxekien	h e n t͡ʃ e k i e n
hentxekiguke	e n t͡ʃ e k i ɡ u k e
hentxekiguke	h e n t͡ʃ e k i ɡ u k e
hentxekigun	e n t͡ʃ e k i ɡ u n
hentxekigun	h e n t͡ʃ e k i ɡ u n
hentxekioke	e n t͡ʃ e k i o k e
hentxekioke	h e n t͡ʃ e k i o k e
hentxekion	e n t͡ʃ e k i o n
hentxekion	h e n t͡ʃ e k i o n
hentzake	e n t͡s̻ a k e
hentzake	h e n t͡s̻ a k e
hentzan	e n t͡s̻ a n
hentzan	h e n t͡s̻ a n
hentzuen	e n t͡s̻ u e n
hentzuen	h e n t͡s̻ u e n
hentzuke	e n t͡s̻ u k e
hentzuke	h e n t͡s̻ u k e
hentzuzke	e n t͡s̻ u s̻ k e
hentzuzke	h e n t͡s̻ u s̻ k e
hentzuzkien	e n t͡s̻ u s̻ k i e n
hentzuzkien	h e n t͡s̻ u s̻ k i e n
herakuske	e ɾ a k u s̺ k e
herakuske	h e ɾ a k u s̺ k e
herakuskien	e ɾ a k u s̺ k i e n
herakuskien	h e ɾ a k u s̺ k i e n
herakutsan	e ɾ a k u t͡s̺ a n
herakutsan	h e ɾ a k u t͡s̺ a n
herakutsazke	e ɾ a k u t͡s̺ a s̻ k e
herakutsazke	h e ɾ a k u t͡s̺ a s̻ k e
heren	e ɾ e n
heren	h e ɾ e n
herenegun	e ɾ e n e ɡ u n
herenegun	h e ɾ e n e ɡ u n
heroake	e ɾ o a k e
heroake	h e ɾ o a k e
heroan	e ɾ o a n
heroan	h e ɾ o a n
heroatzan	e ɾ o a t͡s̻ a n
heroatzan	h e ɾ o a t͡s̻ a n
heroazke	e ɾ o a s̻ k e
heroazke	h e ɾ o a s̻ k e
herri	e r i
herri	h e r i
heu	e u̯
heu	h e u̯
heuk	e u̯ k
heuk	h e u̯ k
heure	e u̯ ɾ e
heure	h e u̯ ɾ e
hezur	e s̻ u r
hezur	h e s̻ u r
hezurdura	e s̻ u r d u ɾ a
hezurdura	h e s̻ u r d u ɾ a
hezurtegi	e s̻ u r t e ɡ i
hezurtegi	h e s̻ u r t e ɡ i
hi	h i
hi	i
hidrogeno	h i d r o ɡ e n o
hidrogeno	i d r o ɡ e n o
hiena	h i e n a
hiena	i e n a
higan	h i ɡ a n
higan	i ɡ a n
hiharduen	h i h a r d u e n
hiharduen	i a r d u e n
hihardukake	h i h a r d u k a k e
hihardukake	i a r d u k a k e
hihardukan	h i h a r d u k a n
hihardukan	i a r d u k a n
hiharduke	h i h a r d u k e
hiharduke	i a r d u k e
hik	h i k
hik	i k
hil	h i l
hil	i l
hindoake	h i n d o a k e
hindoake	i n d o a k e
hindoakeen	h i n d o a k e e n
hindoakeen	i n d o a k e e n
hindoan	h i n d o a n
hindoan	i n d o a n
hinteke	h i n t e k e
hinteke	i n t e k e
hintekeen	h i n t e k e e n
hintekeen	i n t e k e e n
hintzateke	h i n t͡s̻ a t e k e
hintzateke	i n t͡s̻ a t e k e
hintzatekeen	h i n t͡s̻ a t e k e e n
hintzatekeen	i n t͡s̻ a t e k e e n
hintzen	h i n t͡s̻ e n
hintzen	i n t͡s̻ e n
hirauen	h i ɾ a u̯ e n
hirauen	i ɾ a u̯ e n
hirauke	h i ɾ a u̯ k e
hirauke	i ɾ a u̯ k e
hire	h i ɾ e
hire	i ɾ e
hiregan	h i ɾ e ɡ a n
hiregan	i ɾ e ɡ a n
hiri	h i ɾ i
hiri	i ɾ i
hirigintza	h i ɾ i ɡ i n t͡s̻ a
hirigintza	i ɾ i ɡ i n t͡s̻ a
hiru	h i ɾ u
hiru	i ɾ u
hirudien	h i ɾ u d i e n
hirudien	i ɾ u d i e n
hirudike	h i ɾ u d i k e
hirudike	i ɾ u d i k e
hirugarren	h i ɾ u ɡ a r e n
hirugarren	i ɾ u ɡ a r e n
hiruhortz	h i ɾ u h o r t͡s̻
hiruhortz	i ɾ u o r t͡s̻
hirukoitz	h i ɾ u k o i̯ t͡s̻
hirukoitz	i ɾ u k o i̯ t͡s̻
hitan	h i t a n
hitan	i t a n
hiztegi	h i s̻ t e ɡ i
hiztegi	i s̻ t e ɡ i
hoa	h o a
hoa	o a
hoake	h o a k e
hoake	o a k e
hoan	h o a n
hoan	o a n
hodei	h o d e i̯
hodei	o d e i̯
hogei	h o ɡ e i̯
hogei	o ɡ e i̯
honek	h o n e k
honek	o n e k
honen	h o n e n
honen	o n e n
honi	h o n i
honi	o n i
hor	h o r
hor	o r
hori	h o ɾ i
hori	o ɾ i
horrek	h o r e k
horrek	o r e k
horren	h o r e n
horren	o r e n
horri	h o r i
horri	o r i
hostaro	h o s̺ t a ɾ o
hostaro	o s̺ t a ɾ o
hots	h o t͡s̺
hots	o t͡s̺
hotz	h o t͡s̻
hotz	o t͡s̻
hozkailu	h o s̻ k a i̯ l u
hozkailu	o s̻ k a ʎ u
hungaria	h u n ɡ a ɾ i a
hungaria	u n ɡ a ɾ i a
hungariako	h u n ɡ a ɾ i a k o
hungariako	u n ɡ a ɾ i a k o
hungarian	h u n ɡ a ɾ i a n
hungarian	u n ɡ a ɾ i a n
hungariar	h u n ɡ a ɾ i a r
hungariar	u n ɡ a ɾ i a r
hungariera	h u n ɡ a ɾ i e ɾ a
hungariera	u n ɡ a ɾ i e ɾ a
hur	h u r
hur	u r
hura	h u ɾ a
hura	u ɾ a
huts	h u t͡s̺
huts	u t͡s̺
hutsik	h u t͡s̺ i k
hutsik	u t͡s̺ i k
huñ	ɦ u ɲ
i	i
ia	i a
iaz	i a s̻
ibai	i b a i̯
ibaiadar	i b a i̯ a d a r
ibaibarren	i b a i̯ b a r e n
ibaiburu	i b a i̯ b u ɾ u
ibaiertz	i b a i̯ e r t͡s̻
ibairatu	i b a i̯ ɾ a t u
ibar	i b a r
ibili	i b i l i
ibili	i b i ʎ i
idatzi	i d a t͡s̻ i
idazle	i d a s̻ l e
ido	i d o
igande	i ɡ a n d e
igaz	i ɡ a s̻
igel	i ɡ e l
igo	i ɡ o
igork	i ɡ o r k
igorna	i ɡ o r n a
igorri	i ɡ o r i
igorzu	i ɡ o r s̻ u
igorzue	i ɡ o r s̻ u e
iharduk	i a r d u k
iharduk	i h a r d u k
ihardukak	i a r d u k a k
ihardukak	i h a r d u k a k
ihardukan	i a r d u k a n
ihardukan	i h a r d u k a n
ihardukazu	i a r d u k a s̻ u
ihardukazu	i h a r d u k a s̻ u
ihardukazue	i a r d u k a s̻ u e
ihardukazue	i h a r d u k a s̻ u e
iharduki	i a r d u k i
iharduki	i h a r d u k i
ihardun	i a r d u n
ihardun	i h a r d u n
iharduzu	i a r d u s̻ u
iharduzu	i h a r d u s̻ u
iharduzue	i a r d u s̻ u e
iharduzue	i h a r d u s̻ u e
ihi	i h i
ihi	i i
ikasgai	i k a s̺ ɡ a i̯
ikasi	i k a s̺ i
ikatz	i k a t͡s̻
iker	i k e r
ikertu	i k e r t u
ikus	i k u s̺
ikusak	i k u s̺ a k
ikusan	i k u s̺ a n
ikusazu	i k u s̺ a s̻ u
ikusazue	i k u s̺ a s̻ u e
ikusi	i k u s̺ i
ikusiko	i k u s̺ i k o
ikuste	i k u s̺ t e
ikusten	i k u s̺ t e n
ilargi	i l a r ɡ i
ilargi	i ʎ a r ɡ i
ilargitar	i l a r ɡ i t a r
ilargitar	i ʎ a r ɡ i t a r
ilbeltz	i l b e l t͡s̻
ile	i l e
ile	i ʎ e
ilen	i l e n
ilen	i ʎ e n
ilertz	i l e r t͡s̻
ilertz	i ʎ e r t͡s̻
ilun	i l u n
ilun	i ʎ u n
inbutu	i m b u t u
indaba	i n d a b a
independentzia	i n d e p e n d e n t͡s̻ i a
indonesiera	i n d o n e s̺ i e ɾ a
informazio	i n f o r m a s̻ i o
ingalaterra	i n ɡ a l a t e r a
ingelera	i n ɡ e l e ɾ a
ingeles	i n ɡ e l e s̺
inon	i n o n
inon	i ɲ o n
inor	i n o r
inor	i ɲ o r
inora	i n o ɾ a
inora	i ɲ o ɾ a
inoren	i n o ɾ e n
inoren	i ɲ o ɾ e n
inori	i n o ɾ i
inori	i ɲ o ɾ i
internazional	i n t e r n a s̻ i o n a l
intsektu	i n t͡s̺ e k t u
intxaur	i n t͡ʃ a u̯ r
inurri	i n u r i
inurri	i ɲ u r i
inurritegi	i n u r i t e ɡ i
inurritegi	i ɲ u r i t e ɡ i
ipar	i p a r
ipotx	i p o t͡ʃ
ipurdi	i p u r d i
ipurtzulo	i p u r t͡s̻ u l o
irail	i ɾ a i̯ l
irakasle	i ɾ a k a s̺ l e
irakatsak	i ɾ a k a t͡s̺ a k
irakatsan	i ɾ a k a t͡s̺ a n
irakatsazu	i ɾ a k a t͡s̺ a s̻ u
irakatsazue	i ɾ a k a t͡s̺ a s̻ u e
irakatsi	i ɾ a k a t͡s̺ i
irakin	i ɾ a k i n
irakurle	i ɾ a k u r l e
irakurri	i ɾ a k u r i
irauk	i ɾ a u̯ k
iraun	i ɾ a u̯ n
irauzu	i ɾ a u̯ s̻ u
irauzue	i ɾ a u̯ s̻ u e
iritzi	i ɾ i t͡s̻ i
irla	i r l a
irlanda	i r l a n d a
irten	i r t e n
irudi	i ɾ u d i
irudik	i ɾ u d i k
irudiko	i ɾ u d i k o
irudin	i ɾ u d i n
irudizu	i ɾ u d i s̻ u
irudizue	i ɾ u d i s̻ u e
iruña	i ɾ u ɲ a
iruñea	i ɾ u ɲ e a
islandia	i s̺ l a n d i a
islandiar	i s̺ l a n d i a r
islandiera	i s̺ l a n d i e ɾ a
ispilu	i s̺ p i l u
ispilu	i s̺ p i ʎ u
italia	i t a l i a
italian	i t a l i a n
italiar	i t a l i a r
italiera	i t a l i e ɾ a
ito	i t o
itsasalde	i t͡s̺ a s̺ a l d e
itsasoratu	i t͡s̺ a s̺ o ɾ a t u
itsu	i t͡s̺ u
itsusi	i t͡s̺ u s̺ i
iturri	i t u r i
itzal	i t͡s̻ a l
itzuli	i t͡s̻ u l i
itzultzaile	i t͡s̻ u l t͡s̻ a i̯ l e
itzultzaile	i t͡s̻ u l t͡s̻ a ʎ e
ixa	i ʃ a
izan	i s̻ a n
izango	i s̻ a n ɡ o
izar	i s̻ a r
izate	i s̻ a t e
izaten	i s̻ a t e n
izeba	i s̻ e b a
izeko	i s̻ e k o
izen	i s̻ e n
izenlagun	i s̻ e n l a ɡ u n
izerdi	i s̻ e r d i
izokin	i s̻ o k i n
izotz	i s̻ o t͡s̻
izotzil	i s̻ o t͡s̻ i l
izter	i s̻ t e r
izurde	i s̻ u r d e
j	j o t a
j	x o t a
jaio	j a i̯ o
jaio	x a i̯ o
jaka	j a k a
jaka	x a k a
jakadun	j a k a d u n
jakadun	x a k a d u n
jakik	j a k i k
jakik	x a k i k
jakin	j a k i n
jakin	x a k i n
jakitzak	j a k i t͡s̻ a k
jakitzak	x a k i t͡s̻ a k
jakitzan	j a k i t͡s̻ a n
jakitzan	x a k i t͡s̻ a n
jakitzazu	j a k i t͡s̻ a s̻ u
jakitzazu	x a k i t͡s̻ a s̻ u
jakitzazue	j a k i t͡s̻ a s̻ u e
jakitzazue	x a k i t͡s̻ a s̻ u e
jakizu	j a k i s̻ u
jakizu	x a k i s̻ u
jakizue	j a k i s̻ u e
jakizue	x a k i s̻ u e
jan	j a n
jan	x a n
janari	j a n a ɾ i
janari	x a n a ɾ i
japonia	j a p o n i a
japonia	x a p o n i a
japoniera	j a p o n i e ɾ a
japoniera	x a p o n i e ɾ a
jardun	j a r d u n
jardun	x a r d u n
jarraiki	j a r a i̯ k i
jarraiki	x a r a i̯ k i
jeltzale	j e l t͡s̻ a l e
jeltzale	x e l t͡s̻ a l e
jengibre	x e n x i b r e
joan	j o a n
joan	x o a n
jokatu	j o k a t u
jokatu	x o k a t u
jorrail	j o r a i̯ l
jorrail	x o r a i̯ l
jota	j o t a
jota	x o t a
jugoslavia	j u ɡ o s̺ l a b i a
jugoslavian	j u ɡ o s̺ l a b i a n
k	k a
ka	k a
kaixo	k a i̯ ʃ o
kako	k a k o
kale	k a l e
kaltzita	k a l t͡s̻ i t a
kamerun	k a m e ɾ u n
kameu	k a m e u̯
kanpai	k a m p a i̯
karbono	k a r b o n o
karlistada	k a r l i s̺ t a d a
karlistaldi	k a r l i s̺ t a l d i
karmele	k a r m e l e
karramarro	k a r a m a r o
katagorri	k a t a ɡ o r i
kate	k a t e
katu	k a t u
kazakhera	k a s̻ a x e ɾ a
kazakhstan	k a s̻ a x s̺ t a n
ke	k e
kemen	k e m e n
ketsu	k e t͡s̺ u
kilate	k i l a t e
kirol	k i ɾ o l
kirolari	k i ɾ o l a ɾ i
kiroldegi	k i ɾ o l d e ɡ i
koaderno	k o a d e r n o
kobre	k o b r e
koilara	k o i̯ l a ɾ a
koilara	k o ʎ a ɾ a
koinata	k o i̯ n a t a
koinata	k o ɲ a t a
koinatu	k o i̯ n a t u
koinatu	k o ɲ a t u
kokots	k o k o t͡s̺
kokotx	k o k o t͡ʃ
koronabirus	k o ɾ o n a b i ɾ u s̺
korsikera	k o r s̺ i k e ɾ a
koru	k o ɾ u
kroazia	k r o a s̻ i a
kroaziar	k r o a s̻ i a r
kroaziera	k r o a s̻ i e ɾ a
ku	k u
kuku	k u k u
kukutxeztul	k u k u t͡ʃ e s̻ t u l
kulero	k u l e ɾ o
kume	k u m e
l	e l e
labar	l a b a r
labe	l a b e
labezomorro	l a b e s̻ o m o r o
labezomorroa	l a b e s̻ o m o r o a
labezomorroak	l a b e s̻ o m o r o a k
labezomorroarenganantz	l a b e s̻ o m o r o a ɾ e n ɡ a n a n t͡s̻
labezomorroek	l a b e s̻ o m o r o e k
labezomorroenganantz	l a b e s̻ o m o r o e n ɡ a n a n t͡s̻
labezomorrok	l a b e s̻ o m o r o k
labezomorrorenganako	l a b e s̻ o m o r o ɾ e n ɡ a n a k o
labezomorrorenganantz	l a b e s̻ o m o r o ɾ e n ɡ a n a n t͡s̻
labezomorrorengandik	l a b e s̻ o m o r o ɾ e n ɡ a n d i k
labezomorrorik	l a b e s̻ o m o r o ɾ i k
labezomorrotzat	l a b e s̻ o m o r o t͡s̻ a t
labur	l a b u r
laga	l a ɡ a
lagun	l a ɡ u n
lagundu	l a ɡ u n d u
lagün	l a ɡ y n
laino	l a i̯ n o
laino	l a ɲ o
lapur	l a p u r
lapurkume	l a p u r k u m e
lapurreria	l a p u r e ɾ i a
lapurreta	l a p u r e t a
lapurtu	l a p u r t u
lapurtxori	l a p u r t͡ʃ o ɾ i
laratro	l a ɾ a t r o
lari	l a ɾ i
larunbat	l a ɾ u m b a t
lastail	l a s̺ t a i̯ l
laster	l a s̺ t e r
lau	l a u̯
lauburu	l a u̯ b u ɾ u
laugarren	l a u̯ ɡ a r e n
lauhortz	l a u̯ h o r t͡s̻
lauhortz	l a u̯ o r t͡s̻
laukoitz	l a u̯ k o i̯ t͡s̻
laurden	l a u̯ r d e n
lebilke	l e b i l k e
lebilzke	l e b i l s̻ k e
legike	l e ɡ i k e
legikete	l e ɡ i k e t e
legitzake	l e ɡ i t͡s̻ a k e
legitzakete	l e ɡ i t͡s̻ a k e t e
legoke	l e ɡ o k e
lehen	l e e n
lehen	l e h e n
lehendabizi	l e e n d a b i s̻ i
lehendabizi	l e h e n d a b i s̻ i
lehendakari	l e e n d a k a ɾ i
lehendakari	l e h e n d a k a ɾ i
lekike	l e k i k e
lekikete	l e k i k e t e
lekizke	l e k i s̻ k e
lekizkete	l e k i s̻ k e t e
lekusazke	l e k u s̺ a s̻ k e
lekusazkete	l e k u s̺ a s̻ k e t e
lekuske	l e k u s̺ k e
lekuskete	l e k u s̺ k e t e
lelo	l e l o
lentzeria	l e n t͡s̻ e ɾ i a
lentzuke	l e n t͡s̻ u k e
lentzukete	l e n t͡s̻ u k e t e
lentzuzke	l e n t͡s̻ u s̻ k e
lentzuzkete	l e n t͡s̻ u s̻ k e t e
lepho	l e pʰ o
lepo	l e p o
lera	l e ɾ a
lerak	l e ɾ a k
lerakuske	l e ɾ a k u s̺ k e
lerakuskete	l e ɾ a k u s̺ k e t e
lerakutsazke	l e ɾ a k u t͡s̺ a s̻ k e
lerakutsazkete	l e ɾ a k u t͡s̺ a s̻ k e t e
leraren	l e ɾ a ɾ e n
lerari	l e ɾ a ɾ i
lerei	l e ɾ e i̯
lerek	l e ɾ e k
leroake	l e ɾ o a k e
leroakete	l e ɾ o a k e t e
leroazke	l e ɾ o a s̻ k e
leroazkete	l e ɾ o a s̻ k e t e
letonia	l e t o n i a
letoniera	l e t o n i e ɾ a
letorke	l e t o r k e
letozke	l e t o s̻ k e
letxekiake	l e t͡ʃ e k i a k e
letxekidake	l e t͡ʃ e k i d a k e
letxekieke	l e t͡ʃ e k i e k e
letxekiguke	l e t͡ʃ e k i ɡ u k e
letxekinake	l e t͡ʃ e k i n a k e
letxekinake	l e t͡ʃ e k i ɲ a k e
letxekioke	l e t͡ʃ e k i o k e
letxekizueke	l e t͡ʃ e k i s̻ u e k e
letxekizuke	l e t͡ʃ e k i s̻ u k e
letxezkiake	l e t͡ʃ e s̻ k i a k e
letxezkidake	l e t͡ʃ e s̻ k i d a k e
letxezkieke	l e t͡ʃ e s̻ k i e k e
letxezkiguke	l e t͡ʃ e s̻ k i ɡ u k e
letxezkinake	l e t͡ʃ e s̻ k i n a k e
letxezkinake	l e t͡ʃ e s̻ k i ɲ a k e
letxezkioke	l e t͡ʃ e s̻ k i o k e
letxezkizueke	l e t͡ʃ e s̻ k i s̻ u e k e
letxezkizuke	l e t͡ʃ e s̻ k i s̻ u k e
letzake	l e t͡s̻ a k e
leudeke	l e u̯ d e k e
leun	l e u̯ n
leutzake	l e u̯ t͡s̻ a k e
lihardukake	l i a r d u k a k e
lihardukake	l i h a r d u k a k e
lihardukakete	l i a r d u k a k e t e
lihardukakete	l i h a r d u k a k e t e
liharduke	l i a r d u k e
liharduke	l i h a r d u k e
lihardukete	l i a r d u k e t e
lihardukete	l i h a r d u k e t e
lihoake	l i h o a k e
lihoake	l i o a k e
lihoazke	l i h o a s̻ k e
lihoazke	l i o a s̻ k e
lino	l i n o
lino	l i ɲ o
lipschitzar	l i p ʃ i t͡s̻ a r
lirateke	l i ɾ a t e k e
lirauke	l i ɾ a u̯ k e
liraukete	l i ɾ a u̯ k e t e
lirudike	l i ɾ u d i k e
lirudikete	l i ɾ u d i k e t e
liteke	l i t e k e
litezke	l i t e s̻ k e
litio	l i t i o
lituania	l i t u a n i a
lituaniera	l i t u a n i e ɾ a
litzateke	l i t͡s̻ a t e k e
lizar	l i s̻ a r
lizarki	l i s̻ a r k i
lorail	l o ɾ a i̯ l
lotazil	l o t a s̻ i l
lotsa	l o t͡s̺ a
lotu	l o t u
lur	l u r
lurra	l u r a
luze	l u s̻ e
luzetasun	l u s̻ e t a s̺ u n
m	e m e
madari	m a d a ɾ i
madril	m a d r i l
mahai	m a a i̯
mahai	m a h a i̯
mahats	m a a t͡s̺
mahats	m a h a t͡s̺
mahuka	m a h u k a
mahuka	m a u k a
maiatz	m a i̯ a t͡s̻
maitatu	m a i̯ t a t u
maitemin	m a i̯ t e m i n
makaronesia	m a k a ɾ o n e s̺ i a
maketo	m a k e t o
makito	m a k i t o
malin	m a l i n
malta	m a l t a
maltera	m a l t e ɾ a
mapa	m a p a
marasma	m a ɾ a s̺ m a
maroko	m a ɾ o k o
marroi	m a r o i̯
marti	m a r t i
martitzen	m a r t i t͡s̻ e n
martxo	m a r t͡ʃ o
mazedoniera	m a s̻ e d o n i e ɾ a
mea	m e a
meatze	m e a t͡s̻ e
mehe	m e e
mehe	m e h e
mendate	m e n d a t e
mendebal	m e n d e b a l
mendi	m e n d i
merkatu	m e r k a t u
merkatü	m e r k a t y
merkhatü	m e r kʰ a t y
mesede	m e s̺ e d e
mesedez	m e s̺ e d e s̻
meza	m e s̻ a
mezu	m e s̻ u
mezulari	m e s̻ u l a ɾ i
mezularitza	m e s̻ u l a ɾ i t͡s̻ a
milesker	m i l e s̺ k e r
milesker	m i ʎ e s̺ k e r
min	m i n
mina	m i n a
mina	m i ɲ a
minatu	m i n a t u
mintzatu	m i n t͡s̻ a t u
misantropo	m i s̺ a n t r o p o
moldavia	m o l d a b i a
moldavian	m o l d a b i a n
mongoliera	m o n ɡ o l i e ɾ a
motz	m o t͡s̻
muga	m u ɡ a
mutil	m u t i l
n	e n e
nabil	n a b i l
nabilen	n a b i l e n
nabilen	n a b i ʎ e n
nabilke	n a b i l k e
nadin	n a d i n
nago	n a ɡ o
nagoen	n a ɡ o e n
nagoke	n a ɡ o k e
naiteke	n a i̯ t e k e
naiz	n a i̯ s̻
naizateke	n a i̯ s̻ a t e k e
nakar	n a k a r
nakie	n a k i e
nano	n a n o
naski	n a s̺ k i
nator	n a t o r
natorke	n a t o r k e
natorkio	n a t o r k i o
natorkioke	n a t o r k i o k e
natorkion	n a t o r k i o n
natorren	n a t o r e n
natxekie	n a t͡ʃ e k i e
natxekik	n a t͡ʃ e k i k
natxekin	n a t͡ʃ e k i n
natxekio	n a t͡ʃ e k i o
natxekizu	n a t͡ʃ e k i s̻ u
natxekizue	n a t͡ʃ e k i s̻ u e
natza	n a t͡s̻ a
nauka	n a u̯ k a
nazioarteko	n a s̻ i o a r t e k o
neba	n e b a
nederlandera	n e d e r l a n d e ɾ a
negien	n e ɡ i e n
negike	n e ɡ i k e
negitzake	n e ɡ i t͡s̻ a k e
negitzan	n e ɡ i t͡s̻ a n
neguil	n e ɡ u i̯ l
nekatu	n e k a t u
nekien	n e k i e n
nekike	n e k i k e
nekizke	n e k i s̻ k e
nekizkien	n e k i s̻ k i e n
nekusan	n e k u s̺ a n
nekusazke	n e k u s̺ a s̻ k e
nekuske	n e k u s̺ k e
nekuskien	n e k u s̺ k i e n
nenbilen	n e m b i l e n
nenbilen	n e m b i ʎ e n
nenbilke	n e m b i l k e
nenbilkeen	n e m b i l k e e n
nendin	n e n d i n
nengoen	n e n ɡ o e n
nengoke	n e n ɡ o k e
nengokeen	n e n ɡ o k e e n
nenkien	n e n k i e n
nenkion	n e n k i o n
nentorke	n e n t o r k e
nentorkeen	n e n t o r k e e n
nentorkioke	n e n t o r k i o k e
nentorkiokeen	n e n t o r k i o k e e n
nentorkion	n e n t o r k i o n
nentorren	n e n t o r e n
nentxekiake	n e n t͡ʃ e k i a k e
nentxekian	n e n t͡ʃ e k i a n
nentxekieke	n e n t͡ʃ e k i e k e
nentxekien	n e n t͡ʃ e k i e n
nentxekinake	n e n t͡ʃ e k i n a k e
nentxekinake	n e n t͡ʃ e k i ɲ a k e
nentxekinan	n e n t͡ʃ e k i n a n
nentxekinan	n e n t͡ʃ e k i ɲ a n
nentxekioke	n e n t͡ʃ e k i o k e
nentxekion	n e n t͡ʃ e k i o n
nentxekizueke	n e n t͡ʃ e k i s̻ u e k e
nentxekizuen	n e n t͡ʃ e k i s̻ u e n
nentxekizuke	n e n t͡ʃ e k i s̻ u k e
nentxekizun	n e n t͡ʃ e k i s̻ u n
nentzake	n e n t͡s̻ a k e
nentzan	n e n t͡s̻ a n
nentzuen	n e n t͡s̻ u e n
nentzuke	n e n t͡s̻ u k e
nentzuzke	n e n t͡s̻ u s̻ k e
nentzuzkien	n e n t͡s̻ u s̻ k i e n
neon	n e o n
nerakuske	n e ɾ a k u s̺ k e
nerakuskien	n e ɾ a k u s̺ k i e n
nerakutsan	n e ɾ a k u t͡s̺ a n
nerakutsazke	n e ɾ a k u t͡s̺ a s̻ k e
neroake	n e ɾ o a k e
neroan	n e ɾ o a n
neroatzan	n e ɾ o a t͡s̻ a n
neroazke	n e ɾ o a s̻ k e
neska	n e s̺ k a
neskenegun	n e s̺ k e n e ɡ u n
neu	n e u̯
neuk	n e u̯ k
neure	n e u̯ ɾ e
neurekin	n e u̯ ɾ e k i n
neuri	n e u̯ ɾ i
neurri	n e u̯ r i
ni	n i
nigan	n i ɡ a n
niharduen	n i a r d u e n
niharduen	n i h a r d u e n
nihardukake	n i a r d u k a k e
nihardukake	n i h a r d u k a k e
nihardukan	n i a r d u k a n
nihardukan	n i h a r d u k a n
niharduke	n i a r d u k e
niharduke	n i h a r d u k e
nik	n i k
nindoake	n i n d o a k e
nindoakeen	n i n d o a k e e n
nindoan	n i n d o a n
ninteke	n i n t e k e
nintekeen	n i n t e k e e n
nintzateke	n i n t͡s̻ a t e k e
nintzatekeen	n i n t͡s̻ a t e k e e n
nintzen	n i n t͡s̻ e n
nirauen	n i ɾ a u̯ e n
nirauke	n i ɾ a u̯ k e
nire	n i ɾ e
niregan	n i ɾ e ɡ a n
nirudien	n i ɾ u d i e n
nirudike	n i ɾ u d i k e
nitan	n i t a n
nitrogeno	n i t r o x e n o
noa	n o a
noake	n o a k e
noan	n o a n
nola	n o l a
non	n o n
nor	n o r
nora	n o ɾ a
norbait	n o r b a i̯ t
nori	n o ɾ i
nork	n o r k
nortzuk	n o r t͡s̻ u k
norvegia	n o r b e ɡ i a
norvegiera	n o r b e ɡ i e ɾ a
o	o
objektu	o b j e k t u
odol	o d o l
ogi	o ɡ i
ohe	o e
ohe	o h e
oheratu	o e ɾ a t u
oheratu	o h e ɾ a t u
ohoin	o h o i̯ n
ohoin	o o i̯ n
oilaur	o i̯ l a u̯ r
oilaur	o ʎ a u̯ r
oin	o i̯ n
oinarri	o i̯ n a r i
oinarri	o ɲ a r i
oka	o k a
okela	o k e l a
okin	o k i n
okzitaniera	o k s̻ i t a n i e ɾ a
olerkari	o l e r k a ɾ i
olerkaritza	o l e r k a ɾ i t͡s̻ a
olerki	o l e r k i
olibondo	o l i b o n d o
olo	o l o
omonier	o m o n i e r
on	o n
onddo	o n ɟ o
ondo	o n d o
ongi	o n ɡ i
onil	o n i l
ontzi	o n t͡s̻ i
or	o r
ordenagailu	o r d e n a ɡ a i̯ l u
ordenagailu	o r d e n a ɡ a ʎ u
ordenatu	o r d e n a t u
ordots	o r d o t͡s̺
orein	o ɾ e i̯ n
oreka	o ɾ e k a
orratz	o r a t͡s̻
orri	o r i
orril	o r i l
ortzegun	o r t͡s̻ e ɡ u n
ortzi	o r t͡s̻ i
ortzirale	o r t͡s̻ i ɾ a l e
osaba	o s̺ a b a
oso	o s̺ o
ospe	o s̺ p e
oste	o s̺ t e
ostean	o s̺ t e a n
ostegun	o s̺ t e ɡ u n
ostiral	o s̺ t i ɾ a l
otsail	o t͡s̺ a i̯ l
otso	o t͡s̺ o
oxigeno	o k s̺ i x e n o
ozpin	o s̻ p i n
oztin	o s̻ t i n
oñati	o ɲ a t i
p	p e
pago	p a ɡ o
pandemia	p a n d e m i a
pandora	p a n d o ɾ a
panparroi	p a m p a r o i̯
patata	p a t a t a
patxaran	p a t͡ʃ a ɾ a n
pauso	p a u̯ s̺ o
pe	p e
penintsula	p e n i n t͡s̺ u l a
pintxo	p i n t͡ʃ o
pinu	p i n u
pinu	p i ɲ u
piraña	p i ɾ a ɲ a
pirinioak	p i ɾ i n i o a k
piztu	p i s̻ t u
plangintza	p l a n ɡ i n t͡s̻ a
plantain	p l a n t a i̯ n
poeta	p o e t a
polen	p o l e n
polit	p o l i t
politikari	p o l i t i k a ɾ i
polje	p o l ʎ e
polonia	p o l o n i a
polonian	p o l o n i a n
poloniera	p o l o n i e ɾ a
porru	p o r u
porrusalda	p o r u s̺ a l d a
portugaldar	p o r t u ɡ a l d a r
portugalera	p o r t u ɡ a l e ɾ a
portuges	p o r t u ɡ e s̺
potasio	p o t a s̺ i o
pozoi	p o s̻ o i̯
pozoidun	p o s̻ o i̯ d u n
pozoidura	p o s̻ o i̯ d u ɾ a
pozoitasun	p o s̻ o i̯ t a s̺ u n
pozoitsu	p o s̻ o i̯ t͡s̺ u
pozoitu	p o s̻ o i̯ t u
putakume	p u t a k u m e
q	k u
r	e r e
rabbi	r a b i
robot	r o b o t
s	e s̺ e
sagar	s̺ a ɡ a r
sagardo	s̺ a ɡ a r d o
sagarrondo	s̺ a ɡ a r o n d o
sagu	s̺ a ɡ u
saguzar	s̺ a ɡ u s̻ a r
saldu	s̺ a l d u
salmenta	s̺ a l m e n t a
sardexka	s̺ a r d e ʃ k a
sartalde	s̺ a r t a l d e
sartu	s̺ a r t u
satan	s̺ a t a n
sator	s̺ a t o r
sei	s̺ e i̯
seigarren	s̺ e i̯ ɡ a r e n
seikoitz	s̺ e i̯ k o i̯ t͡s̻
seiren	s̺ e i̯ ɾ e n
sekretu	s̺ e k r e t u
seme	s̺ e m e
senide	s̺ e n i d e
serbia	s̺ e r b i a
serbiera	s̺ e r b i e ɾ a
serbokroaziera	s̺ e r b o k r o a s̻ i e ɾ a
setemere	s̺ e t e m e ɾ e
sits	s̺ i t͡s̺
siziliera	s̺ i s̻ i l i e ɾ a
sofokles	s̺ o f o k l e s̺
soil	s̺ o i̯ l
soilik	s̺ o i̯ l i k
soilik	s̺ o ʎ i k
soin	s̺ o i̯ n
somaliera	s̺ o m a l i e ɾ a
sorbalda	s̺ o r b a l d a
sorgin	s̺ o r ɡ i n
sortalde	s̺ o r t a l d e
sortu	s̺ o r t u
su	s̺ u
sudur	s̺ u d u r
suedia	s̺ u e d i a
suediera	s̺ u e d i e ɾ a
sufre	s̺ u f r e
suge	s̺ u ɡ e
suhi	s̺ u h i
suhi	s̺ u i
suitza	s̺ u i̯ t͡s̻ a
sumendi	s̺ u m e n d i
sur	s̺ u r
sü	s̺ y
t	t e
taberna	t a b e r n a
tailandiera	t a i̯ l a n d i e ɾ a
talo	t a l o
taratulu	t a ɾ a t u l u
tarte	t a r t e
tarteka	t a r t e k a
tatami	t a t a m i
tauromakia	t a u̯ ɾ o m a k i a
taxilari	t a k s̺ i l a ɾ i
te	t e
telezabor	t e l e s̻ a b o r
tigre	t i ɡ r e
tigrea	t i ɡ r e a
tigreari	t i ɡ r e a ɾ i
tigrez	t i ɡ r e s̻
tipula	t i p u l a
titulu	t i t u l u
tobera	t o b e ɾ a
toki	t o k i
topa	t o p a
tunisia	t u n i s̺ i a
tunisian	t u n i s̺ i a n
turkia	t u r k i a
turkiera	t u r k i e ɾ a
txahal	t͡ʃ a a l
txahal	t͡ʃ a h a l
txakaviera	t͡ʃ a k a b i e ɾ a
txakhür	t͡ʃ a kʰ y r
txakolin	t͡ʃ a k o l i n
txakur	t͡ʃ a k u r
txakurkume	t͡ʃ a k u r k u m e
txantxangorri	t͡ʃ a n t͡ʃ a n ɡ o r i
txapel	t͡ʃ a p e l
txapeldun	t͡ʃ a p e l d u n
txar	t͡ʃ a r
txatxar	t͡ʃ a t͡ʃ a r
txatxarkeria	t͡ʃ a t͡ʃ a r k e ɾ i a
txekiera	t͡ʃ e k i e ɾ a
txerri	t͡ʃ e r i
txerrikume	t͡ʃ e r i k u m e
txerto	t͡ʃ e r t o
txetnik	t͡ʃ e t n i k
tximino	t͡ʃ i m i n o
tximino	t͡ʃ i m i ɲ o
txina	t͡ʃ i n a
txinera	t͡ʃ i n e ɾ a
txingurri	t͡ʃ i n ɡ u r i
txirrin	t͡ʃ i r i n
txirrindu	t͡ʃ i r i n d u
txirrindulari	t͡ʃ i r i n d u l a ɾ i
txirrindularitza	t͡ʃ i r i n d u l a ɾ i t͡s̻ a
txokolate	t͡ʃ o k o l a t e
txori	t͡ʃ o ɾ i
u	u
uda	u d a
udaberri	u d a b e r i
udal	u d a l
udaletxe	u d a l e t͡ʃ e
udazken	u d a s̻ k e n
ugatz	u ɡ a t͡s̻
ugaztun	u ɡ a s̻ t u n
uhandre	u a n d r e
uhandre	u h a n d r e
uharte	u a r t e
uharte	u h a r t e
uhartedi	u a r t e d i
uhartedi	u h a r t e d i
uhartegi	u a r t e ɡ i
uhartegi	u h a r t e ɡ i
ukondo	u k o n d o
ukondu	u k o n d u
ukraina	u k r a i̯ n a
ukrainan	u k r a i̯ n a n
ukrainera	u k r a i̯ n e ɾ a
ulertu	u l e r t u
ume	u m e
umedun	u m e d u n
unai	u n a i̯
untxi	u n t͡ʃ i
ur	u r
urde	u r d e
urdin	u r d i n
urizaharra	u ɾ i s̻ a a r a
urizaharra	u ɾ i s̻ a h a r a
urre	u r e
urri	u r i
urrieta	u r i e t a
urril	u r i l
urtaro	u r t a ɾ o
urtarril	u r t a r i l
urte	u r t e
urthe	u r tʰ e
urtxintxa	u r t͡ʃ i n t͡ʃ a
usategi	u s̺ a t e ɡ i
uso	u s̺ o
usteldu	u s̺ t e l d u
utz	u t͡s̻
utzak	u t͡s̻ a k
utzan	u t͡s̻ a n
utzazu	u t͡s̻ a s̻ u
utzazue	u t͡s̻ a s̻ u e
utzi	u t͡s̻ i
uve	u b e
uzbekera	u s̻ b e k e ɾ a
uzta	u s̻ t a
uztail	u s̻ t a i̯ l
uñhu	u ɲ ɦ ũ
v	u b e
vietnamera	b i e t n a m e ɾ a
x	i ʃ a
xabier	ʃ a b j e r
xaboi	ʃ a b o i̯
xake	ʃ a k e
xakelari	ʃ a k e l a ɾ i
xanpu	ʃ a m p u
xurgagailu	ʃ u r ɡ a ɡ a i̯ l u
xurgagailu	ʃ u r ɡ a ɡ a ʎ u
yarda	j a r d a
z	s̻ e t a
zabiltza	s̻ a b i l t͡s̻ a
zabiltzan	s̻ a b i l t͡s̻ a n
zabiltzate	s̻ a b i l t͡s̻ a t e
zabiltzaten	s̻ a b i l t͡s̻ a t e n
zabilzke	s̻ a b i l s̻ k e
zabilzkete	s̻ a b i l s̻ k e t e
zahar	s̻ a a r
zahar	s̻ a h a r
zahi	s̻ a h i
zahi	s̻ a i
zain	s̻ a i̯ n
zainbelar	s̻ a i̯ m b e l a r
zaingorri	s̻ a i̯ n ɡ o r i
zaintxuri	s̻ a i̯ n t͡ʃ u ɾ i
zaintzuri	s̻ a i̯ n t͡s̻ u ɾ i
zainurdin	s̻ a i̯ n u r d i n
zainurdin	s̻ a ɲ u r d i n
zainzuri	s̻ a i̯ n s̻ u ɾ i
zaitez	s̻ a i̯ t e s̻
zaitezen	s̻ a i̯ t e s̻ e n
zaitezke	s̻ a i̯ t e s̻ k e
zaitezkete	s̻ a i̯ t e s̻ k e t e
zaitezte	s̻ a i̯ t e s̻ t e
zaitezten	s̻ a i̯ t e s̻ t e n
zakhur	z a kʰ u r
zakil	s̻ a k i l
zakur	s̻ a k u r
zaldi	s̻ a l d i
zaldun	s̻ a l d u n
zama	s̻ a m a
zamari	s̻ a m a ɾ i
zapaburu	s̻ a p a b u ɾ u
zapaldu	s̻ a p a l d u
zapalkeria	s̻ a p a l k e ɾ i a
zapalketa	s̻ a p a l k e t a
zapalkuntza	s̻ a p a l k u n t͡s̻ a
zapatu	s̻ a p a t u
zara	s̻ a ɾ a
zarateke	s̻ a ɾ a t e k e
zaratekete	s̻ a ɾ a t e k e t e
zarautz	s̻ a ɾ a u̯ t͡s̻
zarete	s̻ a ɾ e t e
zaroatzan	s̻ a ɾ o a t͡s̻ a n
zatekeen	s̻ a t e k e e n
zatoz	s̻ a t o s̻
zatozen	s̻ a t o s̻ e n
zatozke	s̻ a t o s̻ k e
zatozkete	s̻ a t o s̻ k e t e
zatozte	s̻ a t o s̻ t e
zatozten	s̻ a t o s̻ t e n
zatxezkidate	s̻ a t͡ʃ e s̻ k i d a t e
zatxezkie	s̻ a t͡ʃ e s̻ k i e
zatxezkiete	s̻ a t͡ʃ e s̻ k i e t e
zatxezkigu	s̻ a t͡ʃ e s̻ k i ɡ u
zatxezkigute	s̻ a t͡ʃ e s̻ k i ɡ u t e
zatxezkio	s̻ a t͡ʃ e s̻ k i o
zatxezkiote	s̻ a t͡ʃ e s̻ k i o t e
zatxezkit	s̻ a t͡ʃ e s̻ k i t
zaude	s̻ a u̯ d e
zaudeke	s̻ a u̯ d e k e
zaudekete	s̻ a u̯ d e k e t e
zauden	s̻ a u̯ d e n
zaudete	s̻ a u̯ d e t e
zaudeten	s̻ a u̯ d e t e n
zauri	s̻ a u̯ ɾ i
zautza	s̻ a u̯ t͡s̻ a
zautzate	s̻ a u̯ t͡s̻ a t e
zazpi	s̻ a s̻ p i
zazpigarren	s̻ a s̻ p i ɡ a r e n
zazpikoitz	s̻ a s̻ p i k o i̯ t͡s̻
zazpiren	s̻ a s̻ p i ɾ e n
ze	s̻ e
zebilen	s̻ e b i l e n
zebilen	s̻ e b i ʎ e n
zebilkeen	s̻ e b i l k e e n
zebiltzan	s̻ e b i l t͡s̻ a n
zebilzkeen	s̻ e b i l s̻ k e e n
zedin	s̻ e d i n
zegien	s̻ e ɡ i e n
zegiten	s̻ e ɡ i t e n
zegitzan	s̻ e ɡ i t͡s̻ a n
zegitzaten	s̻ e ɡ i t͡s̻ a t e n
zegoen	s̻ e ɡ o e n
zegokeen	s̻ e ɡ o k e e n
zein	s̻ e i̯ n
zekien	s̻ e k i e n
zekion	s̻ e k i o n
zekiten	s̻ e k i t e n
zekizkien	s̻ e k i s̻ k i e n
zekizkion	s̻ e k i s̻ k i o n
zekizkiten	s̻ e k i s̻ k i t e n
zekusan	s̻ e k u s̺ a n
zekusaten	s̻ e k u s̺ a t e n
zekuskien	s̻ e k u s̺ k i e n
zekuskiten	s̻ e k u s̺ k i t e n
zemendi	s̻ e m e n d i
zen	s̻ e n
zenbaki	s̻ e m b a k i
zenbiltzan	s̻ e m b i l t͡s̻ a n
zenbiltzaten	s̻ e m b i l t͡s̻ a t e n
zenbilzke	s̻ e m b i l s̻ k e
zenbilzkeen	s̻ e m b i l s̻ k e e n
zenbilzkete	s̻ e m b i l s̻ k e t e
zenbilzketen	s̻ e m b i l s̻ k e t e n
zenegien	s̻ e n e ɡ i e n
zenegike	s̻ e n e ɡ i k e
zenegikete	s̻ e n e ɡ i k e t e
zenegiten	s̻ e n e ɡ i t e n
zenegitzake	s̻ e n e ɡ i t͡s̻ a k e
zenegitzakete	s̻ e n e ɡ i t͡s̻ a k e t e
zenegitzan	s̻ e n e ɡ i t͡s̻ a n
zenegitzaten	s̻ e n e ɡ i t͡s̻ a t e n
zenekien	s̻ e n e k i e n
zenekike	s̻ e n e k i k e
zenekikete	s̻ e n e k i k e t e
zenekiten	s̻ e n e k i t e n
zenekizke	s̻ e n e k i s̻ k e
zenekizkete	s̻ e n e k i s̻ k e t e
zenekizkien	s̻ e n e k i s̻ k i e n
zenekizkiten	s̻ e n e k i s̻ k i t e n
zenekusan	s̻ e n e k u s̺ a n
zenekusaten	s̻ e n e k u s̺ a t e n
zenekusazke	s̻ e n e k u s̺ a s̻ k e
zenekusazkete	s̻ e n e k u s̺ a s̻ k e t e
zenekuske	s̻ e n e k u s̺ k e
zenekuskete	s̻ e n e k u s̺ k e t e
zenekuskien	s̻ e n e k u s̺ k i e n
zenekuskiten	s̻ e n e k u s̺ k i t e n
zenentzuen	s̻ e n e n t͡s̻ u e n
zenentzuke	s̻ e n e n t͡s̻ u k e
zenentzukete	s̻ e n e n t͡s̻ u k e t e
zenentzuten	s̻ e n e n t͡s̻ u t e n
zenentzuzke	s̻ e n e n t͡s̻ u s̻ k e
zenentzuzkete	s̻ e n e n t͡s̻ u s̻ k e t e
zenentzuzkien	s̻ e n e n t͡s̻ u s̻ k i e n
zenentzuzkiten	s̻ e n e n t͡s̻ u s̻ k i t e n
zenerakuske	s̻ e n e ɾ a k u s̺ k e
zenerakuskete	s̻ e n e ɾ a k u s̺ k e t e
zenerakuskien	s̻ e n e ɾ a k u s̺ k i e n
zenerakuskiten	s̻ e n e ɾ a k u s̺ k i t e n
zenerakutsan	s̻ e n e ɾ a k u t͡s̺ a n
zenerakutsaten	s̻ e n e ɾ a k u t͡s̺ a t e n
zenerakutsazke	s̻ e n e ɾ a k u t͡s̺ a s̻ k e
zenerakutsazkete	s̻ e n e ɾ a k u t͡s̺ a s̻ k e t e
zeneroake	s̻ e n e ɾ o a k e
zeneroakete	s̻ e n e ɾ o a k e t e
zeneroan	s̻ e n e ɾ o a n
zeneroaten	s̻ e n e ɾ o a t e n
zeneroatzan	s̻ e n e ɾ o a t͡s̻ a n
zeneroatzaten	s̻ e n e ɾ o a t͡s̻ a t e n
zeneroazke	s̻ e n e ɾ o a s̻ k e
zeneroazkete	s̻ e n e ɾ o a s̻ k e t e
zeniharduen	s̻ e n i a r d u e n
zeniharduen	s̻ e n i h a r d u e n
zenihardukake	s̻ e n i a r d u k a k e
zenihardukake	s̻ e n i h a r d u k a k e
zenihardukakete	s̻ e n i a r d u k a k e t e
zenihardukakete	s̻ e n i h a r d u k a k e t e
zenihardukan	s̻ e n i a r d u k a n
zenihardukan	s̻ e n i h a r d u k a n
zenihardukaten	s̻ e n i a r d u k a t e n
zenihardukaten	s̻ e n i h a r d u k a t e n
zeniharduke	s̻ e n i a r d u k e
zeniharduke	s̻ e n i h a r d u k e
zenihardukete	s̻ e n i a r d u k e t e
zenihardukete	s̻ e n i h a r d u k e t e
zeniharduten	s̻ e n i a r d u t e n
zeniharduten	s̻ e n i h a r d u t e n
zenirauen	s̻ e n i ɾ a u̯ e n
zenirauke	s̻ e n i ɾ a u̯ k e
zeniraukete	s̻ e n i ɾ a u̯ k e t e
zenirauten	s̻ e n i ɾ a u̯ t e n
zenirudien	s̻ e n i ɾ u d i e n
zenirudike	s̻ e n i ɾ u d i k e
zenirudikete	s̻ e n i ɾ u d i k e t e
zeniruditen	s̻ e n i ɾ u d i t e n
zenkizkien	s̻ e n k i s̻ k i e n
zenkizkieten	s̻ e n k i s̻ k i e t e n
zenkizkion	s̻ e n k i s̻ k i o n
zenkizkioten	s̻ e n k i s̻ k i o t e n
zentozen	s̻ e n t o s̻ e n
zentozke	s̻ e n t o s̻ k e
zentozkeen	s̻ e n t o s̻ k e e n
zentozkete	s̻ e n t o s̻ k e t e
zentozketen	s̻ e n t o s̻ k e t e n
zentozten	s̻ e n t o s̻ t e n
zentxezkidake	s̻ e n t͡ʃ e s̻ k i d a k e
zentxezkidakete	s̻ e n t͡ʃ e s̻ k i d a k e t e
zentxezkidan	s̻ e n t͡ʃ e s̻ k i d a n
zentxezkidaten	s̻ e n t͡ʃ e s̻ k i d a t e n
zentxezkieke	s̻ e n t͡ʃ e s̻ k i e k e
zentxezkiekete	s̻ e n t͡ʃ e s̻ k i e k e t e
zentxezkien	s̻ e n t͡ʃ e s̻ k i e n
zentxezkieten	s̻ e n t͡ʃ e s̻ k i e t e n
zentxezkiguke	s̻ e n t͡ʃ e s̻ k i ɡ u k e
zentxezkigukete	s̻ e n t͡ʃ e s̻ k i ɡ u k e t e
zentxezkigun	s̻ e n t͡ʃ e s̻ k i ɡ u n
zentxezkiguten	s̻ e n t͡ʃ e s̻ k i ɡ u t e n
zentxezkioke	s̻ e n t͡ʃ e s̻ k i o k e
zentxezkiokete	s̻ e n t͡ʃ e s̻ k i o k e t e
zentxezkion	s̻ e n t͡ʃ e s̻ k i o n
zentxezkioten	s̻ e n t͡ʃ e s̻ k i o t e n
zentzuen	s̻ e n t͡s̻ u e n
zentzuten	s̻ e n t͡s̻ u t e n
zentzuzkien	s̻ e n t͡s̻ u s̻ k i e n
zentzuzkiten	s̻ e n t͡s̻ u s̻ k i t e n
zer	s̻ e r
zerakuskien	s̻ e ɾ a k u s̺ k i e n
zerakuskiten	s̻ e ɾ a k u s̺ k i t e n
zerakutsan	s̻ e ɾ a k u t͡s̺ a n
zerakutsaten	s̻ e ɾ a k u t͡s̺ a t e n
zerbait	s̻ e r b a i̯ t
zerbitzu	s̻ e r b i t͡s̻ u
zerbitzugune	s̻ e r b i t͡s̻ u ɡ u n e
zerbütxü	s̻ e r b y t͡ʃ y
zerbütxügüne	s̻ e r b y t͡ʃ y ɡ y n e
zerekin	s̻ e ɾ e k i n
zeren	s̻ e ɾ e n
zerentzat	s̻ e ɾ e n t͡s̻ a t
zerez	s̻ e ɾ e s̻
zergatik	s̻ e r ɡ a t i k
zeri	s̻ e ɾ i
zerk	s̻ e r k
zero	s̻ e ɾ o
zeroan	s̻ e ɾ o a n
zeroaten	s̻ e ɾ o a t e n
zeroatzaten	s̻ e ɾ o a t͡s̻ a t e n
zerogarren	s̻ e ɾ o ɡ a r e n
zerri	s̻ e r i
zertaz	s̻ e r t a s̻
zeru	s̻ e ɾ u
zeta	s̻ e t a
zetorkeen	s̻ e t o r k e e n
zetorren	s̻ e t o r e n
zetozen	s̻ e t o s̻ e n
zetozkeen	s̻ e t o s̻ k e e n
zetxekian	s̻ e t͡ʃ e k i a n
zetxekidan	s̻ e t͡ʃ e k i d a n
zetxekien	s̻ e t͡ʃ e k i e n
zetxekigun	s̻ e t͡ʃ e k i ɡ u n
zetxekinan	s̻ e t͡ʃ e k i n a n
zetxekinan	s̻ e t͡ʃ e k i ɲ a n
zetxekion	s̻ e t͡ʃ e k i o n
zetxekizuen	s̻ e t͡ʃ e k i s̻ u e n
zetxekizun	s̻ e t͡ʃ e k i s̻ u n
zetxezkian	s̻ e t͡ʃ e s̻ k i a n
zetxezkidan	s̻ e t͡ʃ e s̻ k i d a n
zetxezkien	s̻ e t͡ʃ e s̻ k i e n
zetxezkigun	s̻ e t͡ʃ e s̻ k i ɡ u n
zetxezkinan	s̻ e t͡ʃ e s̻ k i n a n
zetxezkinan	s̻ e t͡ʃ e s̻ k i ɲ a n
zetxezkion	s̻ e t͡ʃ e s̻ k i o n
zetxezkizuen	s̻ e t͡ʃ e s̻ k i s̻ u e n
zetxezkizun	s̻ e t͡ʃ e s̻ k i s̻ u n
zetzan	s̻ e t͡s̻ a n
zeu	s̻ e u̯
zeudekeen	s̻ e u̯ d e k e e n
zeuden	s̻ e u̯ d e n
zeundeke	s̻ e u̯ n d e k e
zeundekeen	s̻ e u̯ n d e k e e n
zeundekete	s̻ e u̯ n d e k e t e
zeundeketen	s̻ e u̯ n d e k e t e n
zeunden	s̻ e u̯ n d e n
zeundeten	s̻ e u̯ n d e t e n
zeuntzake	s̻ e u̯ n t͡s̻ a k e
zeuntzakete	s̻ e u̯ n t͡s̻ a k e t e
zeuntzan	s̻ e u̯ n t͡s̻ a n
zeuntzaten	s̻ e u̯ n t͡s̻ a t e n
zeure	s̻ e u̯ ɾ e
zeutzan	s̻ e u̯ t͡s̻ a n
zezeil	s̻ e s̻ e i̯ l
zezen	s̻ e s̻ e n
zezenkari	s̻ e s̻ e n k a ɾ i
zi	s̻ i
zigilu	s̻ i ɡ i l u
zigilu	s̻ i ɡ i ʎ u
ziharduen	s̻ i a r d u e n
ziharduen	s̻ i h a r d u e n
zihardukan	s̻ i a r d u k a n
zihardukan	s̻ i h a r d u k a n
zihardukaten	s̻ i a r d u k a t e n
zihardukaten	s̻ i h a r d u k a t e n
ziharduten	s̻ i a r d u t e n
ziharduten	s̻ i h a r d u t e n
zihoakeen	s̻ i h o a k e e n
zihoakeen	s̻ i o a k e e n
zihoan	s̻ i h o a n
zihoan	s̻ i o a n
zihoazen	s̻ i h o a s̻ e n
zihoazen	s̻ i o a s̻ e n
zihoazkeen	s̻ i h o a s̻ k e e n
zihoazkeen	s̻ i o a s̻ k e e n
zikoina	s̻ i k o i̯ n a
zikoina	s̻ i k o ɲ a
zilar	s̻ i l a r
zilar	s̻ i ʎ a r
zinateke	s̻ i n a t e k e
zinateke	s̻ i ɲ a t e k e
zinatekeen	s̻ i n a t e k e e n
zinatekeen	s̻ i ɲ a t e k e e n
zinatekete	s̻ i n a t e k e t e
zinatekete	s̻ i ɲ a t e k e t e
zinateketen	s̻ i n a t e k e t e n
zinateketen	s̻ i ɲ a t e k e t e n
zindoazen	s̻ i n d o a s̻ e n
zindoazke	s̻ i n d o a s̻ k e
zindoazkeen	s̻ i n d o a s̻ k e e n
zindoazkete	s̻ i n d o a s̻ k e t e
zindoazketen	s̻ i n d o a s̻ k e t e n
zindoazten	s̻ i n d o a s̻ t e n
zinen	s̻ i n e n
zinen	s̻ i ɲ e n
zineten	s̻ i n e t e n
zineten	s̻ i ɲ e t e n
zintezen	s̻ i n t e s̻ e n
zintezke	s̻ i n t e s̻ k e
zintezkeen	s̻ i n t e s̻ k e e n
zintezkete	s̻ i n t e s̻ k e t e
zintezketen	s̻ i n t e s̻ k e t e n
zintezten	s̻ i n t e s̻ t e n
zintzur	s̻ i n t͡s̻ u r
zipre	s̻ i p r e
ziratekeen	s̻ i ɾ a t e k e e n
zirauen	s̻ i ɾ a u̯ e n
zirauten	s̻ i ɾ a u̯ t e n
ziren	s̻ i ɾ e n
zirkonio	s̻ i r k o n i o
zirudien	s̻ i ɾ u d i e n
ziruditen	s̻ i ɾ u d i t e n
zitekeen	s̻ i t e k e e n
zitezen	s̻ i t e s̻ e n
zitezkeen	s̻ i t e s̻ k e e n
ziztatu	s̻ i s̻ t a t u
zoaz	s̻ o a s̻
zoazen	s̻ o a s̻ e n
zoazke	s̻ o a s̻ k e
zoazkete	s̻ o a s̻ k e t e
zoazte	s̻ o a s̻ t e
zoazten	s̻ o a s̻ t e n
zolda	s̻ o l d a
zori	s̻ o ɾ i
zorion	s̻ o ɾ i o n
zorionak	s̻ o ɾ i o n a k
zorri	s̻ o r i
zortzi	s̻ o r t͡s̻ i
zortzigarren	s̻ o r t͡s̻ i ɡ a r e n
zortzikoitz	s̻ o r t͡s̻ i k o i̯ t͡s̻
zortziren	s̻ o r t͡s̻ i ɾ e n
zozo	s̻ o s̻ o
zu	s̻ u
zubi	s̻ u b i
zuek	s̻ u e k
zuhaitz	s̻ u a i̯ t͡s̻
zuhaitz	s̻ u h a i̯ t͡s̻
zuhaixka	s̻ u a i̯ ʃ k a
zuhaixka	s̻ u h a i̯ ʃ k a
zuhamu	s̻ u a m u
zuhamu	s̻ u h a m u
zuhamuxka	s̻ u a m u ʃ k a
zuhamuxka	s̻ u h a m u ʃ k a
zuhur	s̻ u h u r
zuhur	s̻ u u r
zuk	s̻ u k
zulagailu	s̻ u l a ɡ a i̯ l u
zulagailu	s̻ u l a ɡ a ʎ u
zulatu	s̻ u l a t u
zulo	s̻ u l o
zulogune	s̻ u l o ɡ u n e
zumake	s̻ u m a k e
zumarraga	s̻ u m a r a ɡ a
zur	s̻ u r
zurgin	s̻ u r ɡ i n
zurgina	s̻ u r ɡ i n a
zurgina	s̻ u r ɡ i ɲ a
zurginak	s̻ u r ɡ i n a k
zurginak	s̻ u r ɡ i ɲ a k
zurginarekin	s̻ u r ɡ i n a ɾ e k i n
zurginarekin	s̻ u r ɡ i ɲ a ɾ e k i n
zurginaren	s̻ u r ɡ i n a ɾ e n
zurginaren	s̻ u r ɡ i ɲ a ɾ e n
zurginarengan	s̻ u r ɡ i n a ɾ e n ɡ a n
zurginarengan	s̻ u r ɡ i ɲ a ɾ e n ɡ a n
zurginarengana	s̻ u r ɡ i n a ɾ e n ɡ a n a
zurginarengana	s̻ u r ɡ i ɲ a ɾ e n ɡ a n a
zurginarenganaino	s̻ u r ɡ i n a ɾ e n ɡ a n a i̯ n o
zurginarenganaino	s̻ u r ɡ i ɲ a ɾ e n ɡ a n a ɲ o
zurginarenganako	s̻ u r ɡ i n a ɾ e n ɡ a n a k o
zurginarenganako	s̻ u r ɡ i ɲ a ɾ e n ɡ a n a k o
zurginarenganantz	s̻ u r ɡ i n a ɾ e n ɡ a n a n t͡s̻
zurginarenganantz	s̻ u r ɡ i ɲ a ɾ e n ɡ a n a n t͡s̻
zurginarengandik	s̻ u r ɡ i n a ɾ e n ɡ a n d i k
zurginarengandik	s̻ u r ɡ i ɲ a ɾ e n ɡ a n d i k
zurginarengatik	s̻ u r ɡ i n a ɾ e n ɡ a t i k
zurginarengatik	s̻ u r ɡ i ɲ a ɾ e n ɡ a t i k
zurginarentzat	s̻ u r ɡ i n a ɾ e n t͡s̻ a t
zurginarentzat	s̻ u r ɡ i ɲ a ɾ e n t͡s̻ a t
zurginari	s̻ u r ɡ i n a ɾ i
zurginari	s̻ u r ɡ i ɲ a ɾ i
zurginaz	s̻ u r ɡ i n a s̻
zurginaz	s̻ u r ɡ i ɲ a s̻
zurgindegi	s̻ u r ɡ i n d e ɡ i
zurginei	s̻ u r ɡ i n e i̯
zurginei	s̻ u r ɡ i ɲ e i̯
zurginek	s̻ u r ɡ i n e k
zurginek	s̻ u r ɡ i ɲ e k
zurginekin	s̻ u r ɡ i n e k i n
zurginekin	s̻ u r ɡ i ɲ e k i n
zurginen	s̻ u r ɡ i n e n
zurginen	s̻ u r ɡ i ɲ e n
zurginengan	s̻ u r ɡ i n e n ɡ a n
zurginengan	s̻ u r ɡ i ɲ e n ɡ a n
zurginengana	s̻ u r ɡ i n e n ɡ a n a
zurginengana	s̻ u r ɡ i ɲ e n ɡ a n a
zurginenganaino	s̻ u r ɡ i n e n ɡ a n a i̯ n o
zurginenganaino	s̻ u r ɡ i ɲ e n ɡ a n a ɲ o
zurginenganako	s̻ u r ɡ i n e n ɡ a n a k o
zurginenganako	s̻ u r ɡ i ɲ e n ɡ a n a k o
zurginenganantz	s̻ u r ɡ i n e n ɡ a n a n t͡s̻
zurginenganantz	s̻ u r ɡ i ɲ e n ɡ a n a n t͡s̻
zurginengandik	s̻ u r ɡ i n e n ɡ a n d i k
zurginengandik	s̻ u r ɡ i ɲ e n ɡ a n d i k
zurginengatik	s̻ u r ɡ i n e n ɡ a t i k
zurginengatik	s̻ u r ɡ i ɲ e n ɡ a t i k
zurginentzat	s̻ u r ɡ i n e n t͡s̻ a t
zurginentzat	s̻ u r ɡ i ɲ e n t͡s̻ a t
zurginez	s̻ u r ɡ i n e s̻
zurginez	s̻ u r ɡ i ɲ e s̻
zurgini	s̻ u r ɡ i n i
zurgini	s̻ u r ɡ i ɲ i
zurginik	s̻ u r ɡ i n i k
zurginik	s̻ u r ɡ i ɲ i k
zurgintza	s̻ u r ɡ i n t͡s̻ a
zurgintzat	s̻ u r ɡ i n t͡s̻ a t
zuri	s̻ u ɾ i
zuzen	s̻ u s̻ e n
zuzenbide	s̻ u s̻ e m b i d e
zuzenbidezko	s̻ u s̻ e m b i d e s̻ k o
zuzendu	s̻ u s̻ e n d u
zuzentasun	s̻ u s̻ e n t a s̺ u n
zuzentzaile	s̻ u s̻ e n t͡s̻ a i̯ l e
zuzentzaile	s̻ u s̻ e n t͡s̻ a ʎ e
zuñiga	s̻ u ɲ i ɡ a
züntzür	s̻ y n t͡s̻ y r
ñ	e ɲ e
ü	y
üthürri	y tʰ y r i
ĺ	ʎ
ŕ	r
