અં	ə̃ː
અંક	ə ŋ k ə
અંકગણિત	ə ŋ k ə ɡ ə ɳ ɪ t̪
અંકલ	ə ŋ k ə l
અંકુર	ə ŋ k u ɾ
અંગ	ə ŋ ɡ
અંગરખો	ə ŋ ɡ ə ɾ kʰ ɔ
અંગસંગ	ə ŋ ɡ s ə ŋ ɡ
અંગારકામ્લ	ə ŋ ɡ ɑ ɾ k ɑ m l ə
અંગૂઠો	ə ŋ ɡ u ʈʰ ɔ
અંગૂર	ə ŋ ɡ u ɾ
અંગ્રેજ	ə ŋ ɡ ɾ eː d͡ʒ
અંઘોળ	ə ŋ ɡʱ o ɭ
અંચલ	ə ɲ t͡ʃ ə l
અંજલિ	ə ɲ d͡ʒ ə l ɪ
અંજીર	ə ɲ d͡ʒ i ɾ
અંત્યેષ્ટિ	ə n t̪ j eː ʂ ʈ ɪ
અંદાજ	ə n d̪ ɑ d͡ʒ
અંધારું	ə n d̪ʱ ɑ ɾ ũ
અંબર	ə m b ə ɾ
અંશુ	ã ʃ u
અઃ	ə ɨ
અકાદમી	ə k ɑ d̪ ə m ɪ
અકીક	ə k i k
અક્ષર	ə k ʃ ə ɾ
અખાડો	ɑ kʰ ɑ ɽ ɔ
અગનગોળો	ə ɡ ə n ɡ o ɭ o
અગરબત્તી	ə ɡ ə ɾ b ə t̪ t̪ i
અગિયાર	ə ɡ i j ɑ ɾ
અગિયારી	ə ɡ ɪ j ɑ ɾ i
અગ્રમસ્તિષ્ક	ə ɡ ɾ ə m ə s t̪ ɪ ʃ k
અછબડા	ə t͡ʃʰ ə b ɖ ɑ
અજમ	ə d͡ʒ ə m
અજવાળું	ə d͡ʒ ʋ ɑ ɭ ũ
અજાન	ə d͡ʒ ɑ n
અજાન	ə z ɑ n
અઝાન	ə d͡ʒʱ ɑ n
અઝાન	ə z ɑ n
અટકળ	ə ʈ k ə ɭ
અટકવું	ə ʈ ə k ʋ ũ
અટારી	ə ʈ ɑ ɾ i
અઠવાડિયું	ə ʈʰ ʋ ɑ ɖ ɪ j ũ
અડવું	ə ɽ ʋ ũ
અઢળક	ə ɖʱ ə ɭ k ə
અઢાર	ə ɖʱ ɑ ɾ
અણગમતું	ə ɳ ə ɡ ə m t̪ ũ
અણસણ	ə ɳ ə s ə ɳ
અતંત્રતા	ə t̪ ə n t̪ ɾ ə t̪ ɑ
અતિથિ	ə t̪ ɪ t̪ʰ ɪ
અતિશય	ə t̪ ɪ ʃ ə j
અત્તર	ə t̪ t̪ ə ɾ
અત્યંત	ə t̪ j ə n t̪
અત્યારે	ə t̪ j ɑ ɾ eː
અથવા	ə t̪ʰ ə ʋ ɑ
અથાણું	ə t̪ʰ ɑ ɳ ũ
અથાહ	ə t̪ʰ ɑʱ
અદરક	ə d̪ ə ɾ ə k
અદાલત	ə d̪ ɑ l ə t̪
અધમૂઉં	ə d̪ʱ ə m u ũ
અધિકાર	ə d̪ʱ ɪ k ɑ ɾ
અધુના	ə d̪ʱ u n ɑ
અધૂરું	ə d̪ʱ u ɾ ũ
અનનાસ	ə n ə n ɑ s
અનલ	ə n ə l
અનાજ	ə n ɑ d͡ʒ
અનારકળી	ə n ɑ ɾ k ə ɭ i
અનિદ્રા	ə n ɪ d̪ ɾ ɑ
અનુભવ	ə n u bʱ ə ʋ
અનુમધ્યમસ્તિષ્ક	ə n u m ə d̪ʱ j ə m ə s t̪ ɪ ʃ k
અનુરાગ	ə n u ɾ ɑ ɡ
અનુવાદ	ə n u ʋ ɑ d̪
અને	ə n ɛ
અન્ય	ə n j ə
અપભ્રંશ	ə p ə bʱ ɾ ã ʃ
અફગાનિસ્તાન	ə pʰ ɡ ɑ n ɪ s t̪ ɑ n
અફઘાન	ə pʰ ɡʱ ɑ n
અફરાસિયાબ	ə pʰ ɾ ɑ s ɪ j ɑ b
અફલાતૂન	ə pʰ l ɑ t̪ u n
અફસાના	ə pʰ ə s ɑ n ɑ
અફીણ	ə pʰ i ɳ
અબલખ	ə b ə l ə kʰ
અબાબીલ	ə b ɑ b i l
અબ્દુલ્લા	ə b d̪ u l l ɑ
અભિનેતા	ə bʱ ɪ n eː t̪ ɑ
અભિમાન	ə bʱ ɪ m ɑ n
અમદાવાદ	ə m d̪ ɑ ʋ ɑ d̪
અમારું	ə m ɑ ɾ ũ
અમાવસ	ə m ɑ ʋ ə s
અમી	ə m i
અમીર	ə m i ɾ
અમુક	ə m u k
અમૂર્ત	ə m u ɾ t̪
અમૃતસર	ə m ɾ u t̪ s ə ɾ
અમૃતા	ə m ɾ ʊ t̪ ɑ
અમે	ə m eː
અયાદત	ə j ɑ d̪ ə t̪
અયોધ્યા	ə j o d̪ʱ j ɑ
અરજદાર	ə ɾ ə d͡ʒ d̪ ɑ ɾ
અરડૂસી	ə ɾ ə ɖ u s i
અરધું	ə ɾ d̪ʱ ũ
અરબસ્તાન	ə ɾ ə b ə s t̪ ɑ n
અરમાન	ə ɾ ə m ɑ n
અરસલાન	ə ɾ s l ɑ n
અરસલાન	ə ɾ s ə l ɑ n
અરિ	ə ɾ ɪ
અરીસો	ə ɾ i s ɔ
અરૂસ	ə ɾ u s
અર્થ	ə ɾ t̪ʰ
અર્દિબેહશ્ત	ə ɾ d̪ ɪ b eː ɦ ə ʃ t̪
અર્ધવર્તુળાકાર	ə ɾ d̪ʱ ə ʋ ə ɾ t̪ u ɭ ɑ k ɑ ɾ
અર્મનિસ્તાન	ə ɾ m ə n ɪ s t̪ ɑ n
અલખ	ə l ə kʰ
અલાઉદ્દીન	ə l ɑ u d̪ d̪ i n
અલાવો	ə l ɑ ʋ ɔ
અલિફ	ə l ɪ f
અલિફ	ə l ɪ pʰ
અલી	ə l i
અલીકુલી	ə l i k u l i
અલ્પાકા	ə l p ɑ k ɑ
અલ્લાહ	ə l l ɑʱ
અલ્હમ્દુલિલાહ	ə l ɦ ə m d̪ u l ɪ l ɑʱ
અળતો	ə ɭ t̪ ɔ
અવધ	ə ʋ ə d̪ʱ
અવયવીકરણ	ə ʋ ə j ə ʋ i k ɾ ə ɳ
અવસ્તા	ə ʋ ə s t̪ ɑ
અવાક	ə ʋ ɑ k
અવાજ	ə ʋ ɑ d͡ʒ
અવિદ્યા	ə ʋ ɪ d̪ j ɑ
અવેસ્તા	ə ʋ eː s t̪ ɑ
અશોક	ə ʃ o k
અશ્રુ	ə ʃ ɾ u
અશ્વત્થ	ə ʃ ʋ ə t̪ t̪ʰ ə
અષાઢ	ə ʃ ɑ ɖʱ
અસબાબ	ə s ə b ɑ b
અસર	ə s ə ɾ
અસાડ	ə s ɑ ɽ
અસુર	ə s u ɾ
અસ્તબલ	ə s t̪ ə b ə l
અસ્પૃશ્યતાનિવારણ	ə s p ɾ ʊ ʃ j ə t̪ ɑ n ɪ ʋ ɑ ɾ ə ɳ
અહલેકિતાબ	əʱ l eː k ɪ t̪ ɑ b
અહીં	ə ɦ ĩ
અહીંતહીં	ə ɦ ĩ t̪ ə ɦ ĩ
અહીંતહીં	ə̤ ĩ t̪ ə̤ ĩ
આ	ɑ̈
આંખ	ɑ̃ kʰ
આંગણ	ɑ ŋ ɡ ə ɳ
આંગણું	ə ŋ ɡ ə ɳ ũ
આંતરજાળ	ɑ n t̪ ə ɾ d͡ʒ ɑ ɭ
આંતરરાષ્ટ્રીય	ɑ n t̪ ə ɾ ɾ ɑ ʂ ʈ ɾ i j ə
આંબ	ɑ̃ b ə
આંબો	ɑ̃ b o
આંસ	ɑ̃ s
આંસુ	ɑ̃ s u
આઈ	ɑ i
આકાશ	ɑ k ɑ ʃ
આકાશગંગા	ɑ k ɑ ʃ ɡ ə ŋ ɡ ɑ
આખું	ɑ kʰ ũ
આગ	ɑ ɡ
આગગાડી	ɑ ɡ ə ɡ ɑ ɖ i
આગાર	ɑ ɡ ɑ ɾ
આગ્રા	ɑ ɡ ɾ ɑ
આચરણ	ɑ t͡ʃ ə ɾ ə ɳ
આજ	ɑ d͡ʒ
આજો	ɑ d͡ʒ ɔ
આઝાદ	ɑ d͡ʒʱ ɑ d̪
આઝાદ	ɑ z ɑ d̪
આઝાર	ɑ d͡ʒʱ ɑ ɾ
આટો	ɑ ʈ ɔ
આઠ	ɑ ʈʰ
આડું	ɑ ɖ ũ
આતશ	ɑ t̪ ə ʃ
આતશકદેહ	ɑ t̪ ə ʃ ə k d̪ eːʱ
આત્મા	ɑ t̪ m ɑ
આદમ	ɑ d̪ ə m
આદિત્યવાર	ɑ d̪ ɪ t̪ j ə ʋ ɑ ɾ
આદુ	ɑ d̪ u
આનંદ	ɑ n ə n d̪
આપણું	ɑ p ɳ ũ
આપો	ɑ p o
આફતાબ	ɑ pʰ t̪ ɑ b
આફૂસ	ɑ pʰ u s
આબ	ɑ b
આભ	ɑ bʱ ə
આભલું	ɑ bʱ l ũ
આભાર	ɑ bʱ ɑ ɾ
આમલી	ɑ m ə l i
આમળું	ɑ m ɭ ũ
આમીન	ɑ m i n
આમુદરિયા	ɑ m u d̪ ə ɾ ɪ j ɑ
આયખું	ɑ j ə kʰ ũ
આયા	ɑ j ɑ
આયાત	ɑ j ɑ t̪
આયુર્વેદ	ɑ j u ɾ ʋ eː d̪
આયુષ	ɑ j u ʂ
આરસી	ɑ ɾ s i
આર્ય	ɑ ɾ j ə
આલમારી	ə l m ɑ ɾ i
આલીશાન	ɑ l i ʃ ɑ n
આલ્કોહોલ	ɑ l k o ɦ o l
આલ્બેનિયા	ɑ l b eː n ɪ j ɑ
આળસ	ɑ ɭ ə s
આળસુ	ɑ ɭ s u
આવડવું	ɑ ʋ ə ɽ ʋ ũ
આવવું	ɑ ʋ ʋ ũ
આવારા	ɑ ʋ ɑ ɾ ɑ
આશક	ɑ ʃ ə k
આશા	ɑ ʃ ɑ
આશીર્વાદ	ɑ ʃ i ɾ ʋ ɑ d̪
આશ્રમ	ɑ ʃ ɾ ə m
આસમાન	ɑ s ə m ɑ n
આસમાની	ɑ s ə m ɑ n i
આસામ	ɑ s ɑ m
આસો	ɑ s o
ઇ	ɪ
ઇંજીલ	ɪ ɲ d͡ʒ i l
ઇઝરાયલ	ɪ d͡ʒʱ ə ɾ ɑ j ə l
ઇટાલી	ɪ ʈ ɑ l i
ઇન્ડિયા	ɪ n ɖ ɪ j ɑ
ઇન્શાઅલ્લાહ	ɪ n ʃ ɑ ə l l ɑʱ
ઇફતાર	ɪ f t̪ ɑ ɾ
ઇફતાર	ɪ pʰ t̪ ɑ ɾ
ઇબલીસ	ɪ b ə l i s
ઇબાદત	ɪ b ɑ d̪ ə t̪
ઇબ્રાહીમ	ɪ b ɾ ɑ ɦ i m
ઇમારત	ɪ m ɑ ɾ ə t̪
ઇમ્ફાલ	ɪ m pʰ ɑ l
ઇયરફોન	ɪ j ə ɾ pʰ o n
ઇયળ	ɪ j ə ɭ
ઇરજ	ɪ ɾ ə d͡ʒ
ઇરાક	ɪ ɾ ɑ k
ઇલીષ	ɪ l i ʂ
ઇશા	ɪ ʃ ɑ
ઇસપંજ	ɪ s p ə ɲ d͡ʒ
ઇસ્કંદરિયા	ɪ s k ə n d̪ ɾ ɪ j ɑ
ઇસ્તંબૂલ	ɪ s t̪ ə m b u l
ઇસ્ત્રી	ɪ s t̪ ɾ i
ઇસ્પિતાલ	ɪ s p ɪ t̪ ɑ l
ઇસ્માઇલ	ɪ s m ɑ ɪ l
ઇસ્માઇલી	ɪ s m ɑ ɪ l i
ઇસ્લામ	ɪ s l ɑ m
ઇસ્લામાબાદ	ɪ s l ɑ m ɑ b ɑ d̪
ઈ	iː
ઈંટ	ĩ ʈ
ઈંડું	ɪ ɳ ɖ ũ
ઈડલી	i ɖ ə l i
ઈદ	i d̪
ઈરાન	i ɾ ɑ n
ઈશ્વર	i ʃ ʋ ə ɾ
ઈસ્ટર	i s ʈ ə ɾ
ઉ	u
ઉંદર	u n d̪ ə ɾ
ઉંમર	u m m ə ɾ
ઉઘાડવું	u ɡʱ ɑ ɖ ʋ ũ
ઉચ્ચાર	u t͡ʃ t͡ʃ ɑ ɾ
ઉઝબક	u d͡ʒʱ b ə k
ઉઝબેકિસ્તાન	u d͡ʒʱ b eː k ɪ s t̪ ɑ n
ઉઠમણું	u ʈʰ ə m ɳ ũ
ઉડિસા	u ɖ ɪ s ɑ
ઉતાવળ	u t̪ ɑ ʋ ə ɭ
ઉત્તર	u t̪ t̪ ə ɾ
ઉદજન	u d̪ ə d͡ʒ ə n
ઉદયપુર	u d̪ ə j p u ɾ
ઉદાસ	u d̪ ɑ s
ઉદ્યાન	u d̪ j ɑ n
ઉનાળો	u n ɑ ɭ ɔ
ઉપઉષ્ણકટિબંધીય	u p ə u ʃ ɳ ə k ʈ ɪ b ə n d̪ʱ i j ə
ઉપનયન	u p ə n j ə n
ઉપનામ	u p ə n ɑ m
ઉપનિષદ	u p ə n ɪ ʃ ə d̪
ઉપરવાળો	u p ə ɾ ʋ ɑ ɭ o
ઉપવાસ	u p ʋ ɑ s
ઉપાધ્યાય	u p ɑ d̪ʱ j ɑ j
ઉમંગ	u m ə ŋ ɡ
ઉમર	u m ə ɾ
ઉમેદવાર	u m eː d̪ ʋ ɑ ɾ
ઉર્દુન	u ɾ d̪ u n
ઉર્દૂ	u ɾ d̪ u
ઉર્સ	u ɾ s
ઉષા	u ʃ ɑ
ઉષ્ટ્રપક્ષી	u ʂ ʈ ɾ ə p ə k ʃ i
ઉષ્ણકટિબંધીય	u ʃ ɳ ə k ʈ ɪ b ə n d̪ʱ i j ə
ઉસ્માન	u s m ɑ n
ઉસ્માની	u s m ɑ n i
ઊ	uː
ઊંઘ	u ŋ ɡ
ઊંઘ	ũ ɡʱ
ઊંઘવું	u ŋ ɡʱ ʋ ũ
ઊંઘવું	ũ ɡʱ ʋ ũ
ઊંચું	ũ t͡ʃ ũ
ઊંટ	ũ ʈ
ઊંધું	u n d̪ʱ ũ
ઊકળવું	u k ə ɭ ʋ ũ
ઊગવું	u ɡ ə ʋ ũ
ઊજળું	u d͡ʒ ə ɭ ũ
ઊડવું	u ɖ ʋ ũ
ઊધઈ	u d̪ʱ ə i
ઊન	u n
ઊનું	u n ũ
ઊપજવું	u p ə d͡ʒ ʋ ũ
ઊપર	u p ə ɾ
ઊભું	u bʱ ũ
ઊલિયું	u l ɪ j ũ
ઊષર	u ʃ ə ɾ
ઋ	ɾ u
ઋતુ	ɾ ʊ t̪ u
ઋષિ	ɾ ʊ ʃ ɪ
એ	eː
એ	æ
એ	ɛ
એક	e k
એકલડું	eː k ə l ɖ ũ
એકલું	eː k ə l ũ
એકવીસ	eː k ʋ i s
એડી	eː ɖ i
એન્જિનિયર	eː n d͡ʒ ɪ n ɪ j ə ɾ
એન્થોની	æ n t̪ʰ o n ɪ
એપ્રિલ	eː p ɾ ɪ l
એરંગ	eː ɾ ə ŋ ɡ
એરણ	ɛ ɾ ə ɳ
એલચી	eː l ə t͡ʃ i
એહસાન	eː ɦ ə s ɑ n
ઐ	ə j
ઐતિહાસિક	ə ɪ t̪ ɪ ɦ ɑ s ɪ k
ઑક્ટોબર	ɔ k ʈ o b ə ɾ
ઑફિસ	ɔ pʰ ɪ s
ઑફિસર	ɔ pʰ ɪ s ə ɾ
ઓ	o
ઓકવું	ɔ k ʋ ũ
ઓક્ટોપસ	o k ʈ o p ə s
ઓક્ટોબર	o k ʈ o b ə ɾ
ઓગણીસ	o ɡ ə ɳ i s
ઓગસ્ટ	o ɡ ə s ʈ
ઓઝો	o d͡ʒʱ ɔ
ઓઠ	o ʈʰ
ઓઢવું	o ɖʱ ə ʋ ũ
ઓણ	o ɳ ə
ઓણમ	o ɳ ə m
ઓથાર	o t̪ʰ ɑ ɾ
ઓમલેટ	o m l eː t̪
ઓરત	o ɾ ə t̪
ઓલાદ	ɔ l ɑ d̪
ઓળગ	o ɭ ɡ ə
ઓળો	ɔ ɭ o
ઓસ	o s
ઓસડ	o s ə ɽ
ઔ	ə ʋ
ઔરંગઝેબ	ə u ɾ ə ŋ ɡ d͡ʒʱ eː b
ક	k ə
કંગ	k ə ŋ ɡ
કંદહાર	k ə n d̪ʱ ɑ ɾ
કચરો	k ə t͡ʃ ɾ o
કચ્છ	k ə t͡ʃ t͡ʃʰ
કડછો	k ə ɽ t͡ʃʰ ɔ
કડવું	k ə ɖ ʋ ũ
કઢાઈ	k ə ɖʱ ɑ i
કઢી	k ə ɖʱ i
કપડું	k ɑ p ɽ ũ
કપાળ	k ə p ɑ ɭ
કપાસ	k ə p ɑ s
કપોત	k ə p o t̪
કફન	k ə f ə n
કફન	k ə pʰ ə n
કફસ	k ə pʰ ə s
કબર	k ə b ə ɾ
કબાટ	k ə b ɑ ʈ
કબાબ	k ə b ɑ b
કબૂતર	k ə b u t̪ ə ɾ
કમલ	k ə m ə l
કમળ	k ə m ə ɭ
કમાલ	k ə m ɑ l
કયામત	k ə j ɑ m ə t̪
કરચલો	k ə ɾ ə t͡ʃ l o
કરચોરી	k ə ɾ t͡ʃ o ɾ i
કરવું	k ə ɾ ʋ ũ
કરાચી	k ə ɾ ɑ t͡ʃ i
કરેણ	k ə ɾ eː ɳ
કરોડ	k ə ɾ o ɖ
કર્ણાટક	k ə ɾ ɳ ɑ ʈ ə k
કર્ણાવતી	k ə ɾ ɳ ɑ ʋ ə t̪ i
કર્મ	k ə ɾ m ə
કલમ	k ə l ə m
કલા	k ə l ɑ
કલાકાર	k ə l ɑ k ɑ ɾ
કલિંગર	k ə l ɪ ŋ ɡ ə ɾ
કલીસા	k ə l i s ɑ
કલ્પના	k ə l p ə n ɑ
કલ્બ	k ə l b
કળશ	k ə ɭ ə ʃ
કવિ	k ə ʋ ɪ
કવ્વાલી	k ə ʋ ʋ ɑ l i
કશ્તી	k ə ʃ t̪ i
કસાઈ	k ə s ɑ i
કસુંબો	k ə s u m b ɔ
કસ્તૂરી	k ə s t̪ u ɾ i
કહવા	k əʱ ʋ ɑ
કહાણી	k ə ɦ ɑ ɳ i
કહેવત	k ə ɦ eː ʋ ə t̪
કહેવત	k ɛ̤ ʋ ə t̪
કહેવું	k ə ɦ eː ʋ ũ
કાંટો	k ɑ̃ ʈ o
કાંઠો	k ɑ̃ ʈʰ o
કાંસાં	k ɑ̃ s ɑ̃
કાંસું	k ɑ̃ s ũ
કાકડી	k ɑ k ɽ ɪ
કાકણક	k ɑ k ɳ ə k
કાકા	k ɑ k ɑ
કાકી	k ɑ k i
કાગડો	k ɑ ɡ ɖ ɔ
કાગળ	k ɑ ɡ ə ɭ
કાગળકામ	k ɑ ɡ ə ɭ k ɑ m
કાચ	k ɑ t͡ʃ
કાચંડો	k ɑ t͡ʃ ə ɳ ɖ o
કાચબો	k ɑ t͡ʃ b ô
કાછ	k ɑ t͡ʃʰ
કાજ	k ɑ d͡ʒ
કાજળ	k ɑ d͡ʒ ə ɭ
કાજી	k ɑ d͡ʒ i
કાજુ	k ɑ d͡ʒ u
કાઠિયાવાડ	k ɑ ʈʰ ɪ j ɑ ʋ ɑ ɖ
કાઠિયાવાડી	k ɑ ʈʰ ɪ j ɑ ʋ ɑ ɖ i
કાતર	k ɑ t̪ ə ɾ
કાનપુર	k ɑ n p u ɾ
કાનો	k ɑ n o
કાપવું	k ɑ p ʋ ũ
કાબા	k ɑ b ɑ
કાબુલ	k ɑ b u l
કામ	k ɑ m
કાયમ	k ɑ j ə m
કાયર	k ɑ j ə ɾ
કારખાનું	k ɑ ɾ kʰ ɑ n ũ
કારતૂસ	k ɑ ɾ t̪ u s
કારવાં	k ɑ ɾ ʋ ɑ̃
કારાકોરમ	k ɑ ɾ ɑ k o ɾ ə m
કારેલું	k ɑ ɾ eː l ũ
કાર્ય	k ɑ ɾ j ə
કાળજું	k ɑ ɭ d͡ʒ ũ
કાળિયાર	k ɑ ɭ ɪ j ɑ ɾ
કાળું	k ɑ ɭ ũ
કાશ્મીર	k ɑ ʃ m i ɾ
કિંગાશ	k ɪ ŋ ɡ ɑ ʃ
કિંમત	k ɪ m m ə t̪
કિબ્લા	k ɪ b l ɑ
કિરણ	k ɪ ɾ ə ɳ
કિરતાસ	k ɪ ɾ t̪ ɑ s
કિલા	k ɪ l ɑ
કિશોરી	k ɪ ʃ o ɾ i
કિસમિસ	k ɪ s m ɪ s
કિસ્મત	k ɪ s m ə t̪
કીટલી	k i ʈ l i
કીડો	k i ɖ ɔ
કીર	k i ɾ
કુંજડો	k ũ d͡ʒ ɽ ɔ
કુંડ	k u ɳ ɖ
કુંડળ	k u ɳ ɖ ə ɭ
કુંભકાર	k u m bʱ k ɑ ɾ
કુંભાર	k u m bʱ ɑ ɾ
કુટુંબ	k u ʈ u m b
કુદરત	k u d̪ ɾ ə t̪
કુફરિસ્તાન	k u pʰ ɾ ɪ s t̪ ɑ n
કુમાર	k u m ɑ ɾ
કુમારી	k u m ɑ ɾ i
કુમુદિની	k u m u d̪ ɪ n i
કુરકુરિયું	k u ɾ k u ɾ ɪ j ũ
કુરાન	k u ɾ ɑ n
કુરૂષ	k u ɾ u ʃ
કુર્દિસ્તાન	k u ɾ d̪ ɪ s t̪ ɑ n
કુલી	k u l i
કુલ્ફી	k u l pʰ i
કુસુમ	k u s u m
કુસ્તી	k u s t̪ i
કુસ્તુંતનિયા	k u s t̪ u n t̪ n ɪ j ɑ
કુહાડો	k u ɦ ɑ ɽ ɔ
કૂકડી	k u k ɽ i
કૂકડો	k u k ɽ ɔ
કૂખ	k u kʰ
કૂતરું	k u t̪ ɾ ũ
કૂદવું	k u d̪ ʋ ũ
કૂલો	k u l ɔ
કૂવો	k u ʋ o
કૂશ	k u ʃ
કૃષ્ણ	k ɾ ʊ ʃ ɳ ə
કૃષ્ણસાર	k ɾ ʊ ʃ ɳ ə s ɑ ɾ
કેંચી	k eː ɲ t͡ʃ i
કેક	k eː k
કેથલિક	k eː t̪ʰ l ɪ k
કેનેડા	k eː n eː ɖ ɑ
કેન્યા	k eː n j ɑ
કેર	k eː ɾ
કેરળ	k eː ɾ ə ɭ
કેરી	k eː ɾ i
કેલ્ટિક	k eː l ʈ ɪ k
કેળું	k eː ɭ ũ
કૉફી	k ɔ pʰ i
કોંકણ	k ɔ̃ k ə ɳ
કોંગ્રેસ	k o ŋ ɡ ɾ eː s
કોઈ	k o i
કોઈપણ	k o i p ə ɳ
કોટ	k o ʈ
કોઠી	k o ʈʰ i
કોઠી	k ɔ ʈʰ i
કોણ	k ɔ ɳ
કોન્ટ્રાક્ટર	k o n ʈ ɾ ɑ k ʈ ə ɾ
કોન્લી	k o n l i
કોફી	k o f i
કોફી	k o pʰ ɪ
કોફી	k ɔ f ɪ
કોફી	k ɔ pʰ ɪ
કોબી	k o b i
કોયલ	k ɔ j ə l
કોયલો	k ɔ j ə l ɔ
કોરું	k o ɾ ũ
કોળિયો	k o ɭ ɪ j ɔ
કોળી	k o ɭ i
કોળું	k o ɭ ũ
કોશિશ	k o ʃ ɪ ʃ
કોહિનૂર	k o ɦ ɪ n u ɾ
ક્યાં	k j ɑ̃
ક્યારે	k j ɑ ɾ eː
ક્રિયાવિશેષણઅવ્યય	k ɾ ɪ j ɑ ʋ ɪ ʃ eː ʃ ɳ ə ə ʋ j ə j ə
ક્રિશ્ચિયન	k ɾ ɪ ʃ t͡ʃ ɪ j ə n
ક્રીડા	k ɾ i ɖ ɑ
ક્રૂસ	k ɾ u s
ક્રૂસારોહણ	k ɾ u s ɑ ɾ o ɦ ə ɳ
ક્ષ	k ʃ ə
ક્ષત્રિય	k ʃ ə t̪ ɾ ɪ j ə
ક્ષેત્ર	k ʃ eː t̪ ɾ ə
ખ	kʰ ə
ખંડ	kʰ ə ɳ ɖ
ખંભાત	kʰ ə m bʱ ɑ t̪
ખચ્ચર	kʰ ə t͡ʃ t͡ʃ ə ɾ
ખજૂર	kʰ ə d͡ʒ u ɾ
ખડગ	kʰ ə ɖ ə ɡ
ખબર	kʰ ə b ə ɾ
ખમીર	kʰ ə m i ɾ
ખમીસ	kʰ ə m i s
ખયારસંબર	kʰ ə j ɑ ɾ s ə m b ə ɾ
ખરગોશ	kʰ ə ɾ ɡ o ʃ
ખરજવું	kʰ ə ɾ ə d͡ʒ ʋ ũ
ખરીદવું	kʰ ə ɾ i d̪ ʋ ũ
ખરીદી	kʰ ə ɾ i d̪ i
ખરું	kʰ ə ɾ ũ
ખલબત્તો	kʰ ə l b ə t̪ t̪ ɔ
ખલીલ	kʰ ə l i l
ખાંડ	kʰ ɑ ɳ ɖ
ખાંડણિયો	kʰ ɑ̃ ɖ ɳ ɪ j ɔ
ખાકાન	kʰ ɑ k ɑ n
ખાખરા	kʰ ɑ kʰ ɾ ɑ
ખાટલી	kʰ ɑ ʈ l i
ખાટલો	kʰ ɑ ʈ l ɔ
ખાટું	kʰ ɑ ʈ ũ
ખાડો	kʰ ɑ ɖ o
ખાન	kʰ ɑ n
ખાનદાન	kʰ ɑ n d̪ ɑ n
ખાનું	kʰ ɑ n ũ
ખાર	kʰ ɑ ɾ
ખાલા	kʰ ɑ l ɑ
ખાલિક	kʰ ɑ l ɪ k
ખાલિસ્તાન	kʰ ɑ l ɪ s t̪ ɑ n
ખાવંદ	kʰ ɑ ʋ ə n d̪
ખાવસા	kʰ ɑ ʋ s ɑ
ખાવું	kʰ ɑ ʋ ũ
ખિડકી	kʰ ɪ ɖ k i
ખિસકોલી	kʰ ɪ s k o l i
ખિસ્સું	kʰ ɪ s s ũ
ખીચડી	kʰ ɪ t͡ʃ ɽ i
ખીજડો	kʰ i d͡ʒ ɖ ɔ
ખીજવું	kʰ i d͡ʒ ʋ ũ
ખીમો	kʰ i m ɔ
ખીર	kʰ i ɾ
ખુતબો	kʰ u t̪ b ɔ
ખુદ	kʰ u d̪
ખુદા	kʰ u d̪ ɑ
ખુરશી	kʰ u ɾ ʃ i
ખુશ	kʰ u ʃ
ખુશી	kʰ u ʃ i
ખૂન	kʰ u n
ખેંચવું	kʰ eː ɲ t͡ʃ ʋ ũ
ખેત	kʰ eː t̪
ખેતર	kʰ eː t̪ ə ɾ
ખોખું	kʰ o kʰ ũ
ખોજા	kʰ o d͡ʒ ɑ
ખોરદાદ	kʰ o ɾ d̪ ɑ d̪
ખોળો	kʰ o ɭ ɔ
ગ	ɡ ə
ગંગા	ɡ ə ŋ ɡ ɑ
ગગન	ɡ ə ɡ ə n
ગચ્છ	ɡ ə t͡ʃ t͡ʃʰ
ગજ	ɡ ə d͡ʒ
ગજલ	ɡ ə d͡ʒ ə l
ગણપતિ	ɡ ə ɳ ə p ə t̪ ɪ
ગણવું	ɡ ə ɳ ʋ ũ
ગણિત	ɡ ə ɳ ɪ t̪
ગયંદ	ɡ ə j ə n d̪
ગરબા	ɡ ə ɾ b ɑ
ગરમ	ɡ ə ɾ ə m
ગરમી	ɡ ə ɾ m i
ગરીબ	ɡ ə ɾ i b
ગરુડ	ɡ ə ɾ u ɖ
ગલગોટો	ɡ ə l ɡ o ʈ ɔ
ગળું	ɡ ə ɭ ũ
ગાંગેય	ɡ ə ŋ ɡ eː j
ગાંધી	ɡ ɑ n d̪ʱ i
ગાંધીગીરી	ɡ ɑ n d̪ʱ i ɡ i ɾ i
ગાંધીનગર	ɡ ɑ n d̪ʱ ɪ n ə ɡ ə ɾ
ગાછ	ɡ ɑ t͡ʃʰ
ગાજર	ɡ ɑ d͡ʒ ə ɾ
ગાઝા	ɡ ɑ d͡ʒʱ ɑ
ગાઝા	ɡ ɑ z ɑ
ગાડવો	ɡʱ ə ɖ ʋ ɔ
ગાડી	ɡ ɑ ɽ i
ગાણું	ɡ ɑ ɳ ũ
ગાથા	ɡ ɑ t̪ʰ ɑ
ગાભ	ɡ ɑ bʱ
ગામ	ɡ ɑ m
ગાય	ɡ ɑ j
ગાલ	ɡ ɑ l
ગાલિબ	ɡ ɑ l ɪ b
ગાવું	ɡ ɑ ʋ ũ
ગિરજા	ɡ ɪ ɾ d͡ʒ ɑ
ગીધ	ɡ i d̪ʱ
ગુજરાત	ɡ ʊ d͡ʒ ə ɾ ɑ t̪
ગુજરાતી	ɡ u d ʒ ə ɾ ɑ t̪ i
ગુજરાનવાલા	ɡ u d͡ʒ ɾ ɑ n ʋ ɑ l ɑ
ગુજારિશ	ɡ u d͡ʒ ɑ ɾ ɪ ʃ
ગુજારિશ	ɡ u z ɑ ɾ ɪ ʃ
ગુરુ	ɡ u ɾ u
ગુરુદ્વારા	ɡ u ɾ u d̪ ʋ ɑ ɾ ɑ
ગુરુવાર	ɡ u ɾ u ʋ ɑ ɾ
ગુર્જિસ્તાન	ɡ u ɾ d͡ʒ ɪ s t̪ ɑ n
ગુલ	ɡ u l
ગુલશન	ɡ u l ʃ ə n
ગુલાબ	ɡ u l ɑ b
ગુલાબજળ	ɡ u l ɑ b d͡ʒ ə ɭ
ગુલાબી	ɡ u l ɑ b i
ગુશતાસ્પ	ɡ u ʃ t̪ ɑ s p
ગુસલ	ɡ u s ə l
ગેંડો	ɡ eː ɳ ɖ o
ગોકળગાય	ɡ o k ə ɭ ɡ ɑ j
ગોઠો	ɡ o ʈʰ ɔ
ગોતું	ɡ o t̪ ũ
ગોદ	ɡ o d̪
ગોધરા	ɡ o d̪ʱ ɾ ɑ
ગોપાલ	ɡ o p ɑ l
ગોપી	ɡ o p i
ગોમાંસ	ɡ o m ɑ̃ s
ગોર	ɡ o r
ગોર	ɡ ɔ r
ગોરિસ્તાન	ɡ o ɾ ɪ s t̪ ɑ n
ગોવા	ɡ o ʋ ɑ
ગોશ્ત	ɡ o ʃ t̪
ગોષ્ઠ	ɡ o ʂ ʈʰ
ગોસ	ɡ o s
ગોસાંઈ	ɡ o s ɑ̃ i
ગ્રંથ	ɡ ɾ ə n t̪ʰ
ગ્રીષ્મ	ɡ ɾ i ʃ m ə
ગ્રીસ	ɡ ɾ i s
ગ્લાસ	ɡ l ɑ s
ઘ	ɡʱ ə
ઘઉં	ɡʱ ə ũ
ઘટવું	ɡʱ ə ʈ ʋ ũ
ઘડિયાળ	ɡʱ ə ɖ ɪ j ɑ ɭ
ઘડો	ɡʱ ə ɽ ɔ
ઘર	ɡʱ ə ɾ
ઘરો	ɡʱ ə ɾ o
ઘસવું	ɡʱ ə s ʋ ũ
ઘામ	ɡʱ ɑ m
ઘાસ	ɡʱ ɑ s
ઘી	ɡʱ i
ઘુવડ	ɡʱ u ʋ ə ɖ
ઘૂમટો	ɡʱ u m ʈ ɔ
ઘૂસવું	ɡʱ u s ʋ ũ
ઘેટું	ɡʱ eː ʈ ũ
ઘો	ɡʱ o
ઘોડલો	ɡʱ o ɖ l o
ઘોડું	ɡʱ o ɖ ũ
ઘોડો	ɡʱ o ɽ ɔ
ઘોષ	ɡʱ o ʂ
ઙ	ŋ ə
ચ	t͡ʃ ə
ચંદન	t͡ʃ ə n d̪ ə n
ચંદ્ર	t͡ʃ ə n d̪ ɾ ə
ચંદ્રબિંદુ	t͡ʃ ə n d̪ ɾ ə b ɪ n d̪ u
ચંદ્રવાર	t͡ʃ ə n d̪ ɾ ə ʋ ɑ ɾ
ચંપલ	t͡ʃ ə m p ə l
ચંબેલી	t͡ʃ ə m b eː l i
ચકમા	t͡ʃ ə k m ɑ
ચકોર	t͡ʃ ə k o ɾ
ચક્ર	t͡ʃ ə k ɾ ə
ચટગાંવ	t͡ʃ ə ʈ ɡ ɑ̃ ʋ
ચડ્ડી	t͡ʃ ə ɖ ɖ i
ચણો	t͡ʃ ə ɳ o
ચમચી	t͡ʃ ə m t͡ʃ i
ચરો	t͡ʃ ə ɾ ɔ
ચર્મ	t͡ʃ ə ɾ m ə
ચશ્માં	t͡ʃ ə ʃ m ɑ̃
ચા	t͡ʃ ɑ
ચાંચ	t͡ʃ ɑ̃ t͡ʃ
ચાંચિયો	t͡ʃ ɑ̃ t͡ʃ ɪ j o
ચાંદ	t͡ʃ ɑ̃ d̪
ચાંદની	t͡ʃ ɑ̃ d̪ n i
ચાકુ	t͡ʃ ɑ k u
ચાખ	t͡ʃ ɑ kʰ
ચાખવું	t͡ʃ ɑ kʰ ʋ ũ
ચાચો	t͡ʃ ɑ t͡ʃ ɔ
ચામડી	t͡ʃ ɑ m ɖ i
ચાર	t͡ʃ ə ɾ
ચાલવું	t͡ʃ ɑ l ʋ ũ
ચાવવું	t͡ʃ ɑ ʋ ʋ ũ
ચાવી	t͡ʃ ɑ ʋ i
ચિકિત્સક	t͡ʃ ɪ k ɪ t̪ s ə k
ચિઠ્ઠી	t͡ʃ ɪ ʈʰ ʈʰ i
ચિતા	t͡ʃ ɪ t̪ ɑ
ચિત્તો	t͡ʃ ɪ t̪ t̪ o
ચિત્રમય	t͡ʃ ɪ t̪ ɾ ə m j ə
ચિનવત	t͡ʃ ɪ n ə ʋ ə t̪
ચિનાબ	t͡ʃ ɪ n ɑ b
ચિરાગ	t͡ʃ ɪ ɾ ɑ ɡ
ચીકણું	t͡ʃ i k ɳ ũ
ચીકુ	t͡ʃ i k u
ચીજ	t͡ʃ i d͡ʒʱ
ચીજ	t͡ʃ i z
ચીઝ	t͡ʃ i d͡ʒʱ
ચીઝ	t͡ʃ i z
ચીન	t͡ʃ i n
ચીની	t͡ʃ i n i
ચીનો	t͡ʃ i n o
ચીવર	t͡ʃ i ʋ ə ɾ
ચુંબન	t͡ʃ u m b ə n
ચુગતાઈ	t͡ʃ u ɡ t̪ ɑ i
ચૂબાન	t͡ʃ u b ɑ n
ચૂમવું	t͡ʃ u m ʋ ũ
ચૂલો	t͡ʃ u l o
ચેન્નાઈ	t͡ʃ eː n n ɑ i
ચેરી	t͡ʃ eː ɾ i
ચૈત્ર	t͡ʃ ə ɪ t̪ ɾ ə
ચોક	t͡ʃ ɔ k
ચોખા	t͡ʃ o kʰ ɑ
ચોથું	t͡ʃ o t̪ʰ ũ
ચોદવું	t͡ʃ o d̪ ʋ ũ
ચોપડી	t͡ʃ ǒ p ɖ i
ચોપડો	t͡ʃ o p ɖ o
ચોમાસું	t͡ʃ ɔ m ɑ s ũ
ચોર	t͡ʃ o ɾ
ચૌદ	t͡ʃ ə ʋ d
છ	t ʃʰ ə
છત્તીસગઢ	t͡ʃʰ ə t̪ t̪ i s ɡ ə ɖʱ
છત્રી	t͡ʃʰ ə t̪ ɾ i
છરી	t͡ʃʰ ə ɾ i
છાંયડી	t͡ʃʰ ɑ̃ j ə ɖ i
છાપયંત્ર	t͡ʃʰ ɑ p j ə n t̪ ɾ ə
છાશ	t͡ʃʰ ɑ ʃ
છીંક	t͡ʃʰ ĩ k
છૂંદો	t͡ʃʰ u n d̪ ɔ
છોકરમત	t ʃʰ o k ə r m ə t
છોકરી	t ʃʰ o k r i
છોકરું	t ʃʰ o k r ũ
છોકરો	t ʃʰ o k r ɔ
જ	d͡ʒ ə
જંગલ	d͡ʒ ə ŋ ɡ ə l
જકાત	d͡ʒ ə k ɑ t̪
જગ્યા	d͡ʒ ə ɡ j ɑ
જટામાંસી	d͡ʒ ə ʈ ɑ m ɑ̃ s i
જડ	d͡ʒ ə ɖ
જનાજો	d͡ʒ ə n ɑ d͡ʒ o
જન્નત	d͡ʒ ə n n ə t̪
જબાન	d͡ʒ ə b ɑ n
જમ	d͡ʒ ə m
જમવું	d͡ʒ ə m ʋ ũ
જમશીદ	d͡ʒ ə m ʃ i d̪
જમાઈ	d͡ʒ ə m ɑ i
જમાત	d͡ʒ ə m ɑ t̪
જમીન	d͡ʒ ə m i n
જમીલ	d͡ʒ ə m i l
જય	d͡ʒ ə j
જયપુર	d͡ʒ ə j p u ɾ
જરથુષ્ટ્ર	d͡ʒ ə ɾ t̪ʰ u ʃ ʈ ɾ ə
જરથુષ્ટ્ર	z ə ɾ t̪ʰ u ʃ ʈ ɾ ə
જરદાળુ	d͡ʒ ə ɾ d̪ ɑ ɭ u
જર્મની	d͡ʒ ə ɾ m ə n i
જર્રાહ	d͡ʒ ə ɾ ɾ ɑʱ
જળ	d͡ʒ ə ɭ
જળઘોડો	d͡ʒ ə ɭ ɡʱ o ɖ o
જળણ	d͡ʒ ə ɭ ə ɳ
જળો	d͡ʒ ə ɭ o
જવાબ	d͡ʒ ə ʋ ɑ b
જહન્નમ	d͡ʒ ə ɦ ə n n ə m
જા	d͡ʒ ɑ
જાંઘ	d͡ʒ ɑ̃ ɡʱ
જાકીટ	d͡ʒ ɑ k i ʈ
જાત	d͡ʒ ɑ t̪
જાન	d͡ʒ ɑ n
જાનવર	d͡ʒ ɑ n ʋ ə ɾ
જાન્યુઆરી	d͡ʒ ɑ n j u ɑ ɾ i
જાપાન	d͡ʒ ɑ p ɑ n
જામેમસ્જિદ	d͡ʒ ɑ m eː m ə s d͡ʒ ɪ d̪
જાળપૃષ્ઠ	d͡ʒ ɑ ɭ p ɾ ʊ ʂ ʈʰ
જાસૂસ	d͡ʒ ɑ s u s
જિંદગી	d͡ʒ ɪ n d̪ ə ɡ i
જિગર	d͡ʒ ɪ ɡ ə ɾ
જિયારત	d͡ʒ ɪ j ɑ ɾ ə t̪
જિરાફ	d͡ʒ ɪ ɾ ɑ pʰ
જી	d͡ʒ i
જીભ	d͡ʒ i bʱ
જીવ	d͡ʒ i ʋ
જુમા	d͡ʒ u m ɑ
જુમેરાત	d͡ʒ u m eː ɾ ɑ t̪
જુલાઈ	d͡ʒ u l ɑ i
જુવાન	d͡ʒ u ʋ ɑ n
જુવાની	d͡ʒ u ʋ ɑ n i
જુહાર	d͡ʒ u ɦ ɑ ɾ
જૂઈ	d͡ʒ u i
જૂઠું	d͡ʒ u ʈʰ ũ
જૂન	d͡ʒ u n
જૂનાગઢ	d͡ʒ u n ɑ ɡ ə ɖʱ
જેઠ	d͡ʒ eː ʈʰ
જેતૂન	d͡ʒ eː t̪ u n
જેરૂસલેમ	d͡ʒ eː ɾ u s l eː m
જેલમ	d͡ʒ eː l ə m
જૈન	d͡ʒ ə ɪ n
જોકે	d͡ʒ o k eː
જોડ	d͡ʒ o ɖ
જોશી	d͡ʒ o ʃ i
જ્ઞ	ɡ n ə
જ્ઞાન	ɡ j ɑ n
જ્યાં	d͡ʒ j ɑ̃
જ્યોતિષ	d͡ʒ j o t̪ ɪ ʂ
જ્યોર્જિયા	d͡ʒ j ɔ ɾ d͡ʒ ɪ j ɑ
ઝ	d͡ʒʱ ə
ઝરૂખો	d͡ʒʱ ə ɾ u kʰ o
ઝાંટ	d͡ʒʱ ɑ̃ ʈ
ઝાંસી	d͡ʒʱ ɑ̃ s i
ઝાડ	d͡ʒʱ ɑ ɖ
ઝાડુ	d͡ʒʱ ɑ ɖ u
ઝારખંડ	d͡ʒʱ ɑ ɾ kʰ ə ɳ ɖ
ઝીંગા	d͡ʒʱ i ŋ ɡ ɑ
ઝીણા	d͡ʒʱ i ɳ ɑ
ઝુહરા	d͡ʒʱ uʱ ɾ ɑ
ઝૂ	d͡ʒʱ uː
ઝૂ	z uː
ઝૂમખું	d͡ʒʱ u m kʰ ũ
ઝેર	d͡ʒʱ eː ɾ
ઞ	ɲ ə
ટ	ʈ ə
ટમલર	ʈ ə m l ə ɾ
ટાંકી	ʈ ɑ̃ k i
ટાગોર	ʈ ɑ ɡ o ɾ
ટાબર	ʈ ɑ b ə ɾ
ટામેટું	ʈ ɑ m eː ʈ ũ
ટિકિટ	ʈ ɪ k ɪ ʈ
ટિફિન	ʈ ɪ f ɪ n
ટિફિન	ʈ ɪ pʰ ɪ n
ટીપું	ʈ i p ũ
ટેક્સી	ʈ eː k s i
ટેવ	ʈ eː ʋ
ટોપી	ʈ o p i
ટ્રેન	ʈ ɾ eː n
ઠ	ʈʰ ə
ઠંડ	ʈʰ ə ɳ ɖ
ઠંડું	ʈʰ ə ɳ ɖ ũ
ઠઠ્ઠો	ʈʰ ə ʈ ʈʰ ɔ
ઠાણ	ʈʰ ɑ ɳ
ઠેકાણું	ʈʰ eː k ɑ ɳ ũ
ઠોકર	ʈʰ o k ə ɾ
ડ	ɖ ə
ડગલો	ɖ ə ɡ l ɔ
ડરવું	ɖ ə ɾ ʋ ũ
ડસવું	ɖ ə s ʋ ũ
ડાક	ɖ ɑ k
ડાકો	ɖ ɑ k ɔ
ડિસેમ્બર	ɖ ɪ s eː m b ə ɾ
ડીલ	ɖ i l
ડુંગળી	ɖ u ŋ ɡ ə ɭ i
ડૉક્ટર	ɖ ɔ k ʈ ə ɾ
ડોકું	ɖ o k ũ
ઢ	ɖʱ ə
ઢાંકણ	ɖʱ ɑ̃ k ə ɳ
ઢાંકવું	ɖʱ ɑ̃ k ʋ ũ
ઢાકા	ɖʱ ɑ k ɑ
ઢીંગલી	ɖʱ ĩ ɡ l i
ઢેપું	ɖʱ eː p ũ
ઢેલ	ɖʱ eː l
ઢોર	ɖʱ o ɾ
ઢોલ	ɖʱ o l
ઢોસા	ɖʱ o s ɑ
ણ	ɳ ə
ત	t ə
તંદૂર	t̪ ə n d̪ u ɾ
તંબોળી	t̪ ə m b o ɭ i
તડકો	t̪ ə ɖ k o
તબલાં	t̪ ə b l ɑ̃
તબિયત	t̪ ə b ɪ j ə t̪
તમંચો	t̪ ə m ə ɲ t͡ʃ ɔ
તમિળનાડુ	t̪ ə m ɪ ɭ n ɑ ɖ u
તમે	t̪ ə m ɛ
તરંગરૂપ	t̪ ə ɾ ə ŋ ɡ ɾ u p
તરબૂચ	t̪ ə ɾ b u t͡ʃ
તલ	t̪ ə l
તલવાર	t̪ ə l ʋ ɑ ɾ
તલાક	t̪ ə l ɑ k
તલાટી	t̪ ə l ɑ ʈ i
તળવું	t̪ ə ɭ ʋ ũ
તળસી	t̪ ə ɭ s i
તવો	t̪ ə ʋ ɔ
તસવીર	t̪ ə s ʋ i ɾ
તસ્બીહ	t̪ ə s b iʱ
તહજ્જુદ	t̪ ə ɦ ə d͡ʒ d͡ʒ u d̪
તહેવાર	t̪ ə ɦ ɛ ʋ ɑ ɾ
તહેવાર	t̪ ɛ̤ ʋ ɑ ɾ
તાઇવાન	t̪ ɑ ɪ ʋ ɑ n
તાજ	t̪ ɑ d͡ʒ
તાજદાર	t̪ ɑ d͡ʒ d̪ ɑ ɾ
તાતારી	t̪ ɑ t̪ ɑ ɾ i
તાપ	t̪ ɑ p
તામિળ	t̪ ɑ m ɪ ɭ
તારયંત્ર	t̪ ɑ ɾ j ə n t̪ ɾ ə
તારીખ	t̪ ɑ ɾ i kʰ
તારીખિયું	t̪ ɑ ɾ i kʰ ɪ j ũ
તારું	t̪ ɑ ɾ ũ
તારો	t̪ ɑ ɾ ɔ
તાલિબ	t̪ ɑ l ɪ b
તાળું	t̪ ɑ ɭ ũ
તાવ	t̪ ɑ ʋ
તાવીજ	t̪ ɑ ʋ i d͡ʒ
તિપિટક	t̪ ɪ p ɪ ʈ ə k
તિબેટ	t̪ ɪ b eː ʈ
તિમિ	t̪ ɪ m ɪ
તિરાના	t̪ ɪ ɾ ɑ n ɑ
તીખું	t̪ i kʰ ũ
તીતર	t̪ i t̪ ə ɾ
તું	t̪ ũ
તુકમ	t̪ u k ə m
તુફંગ	t̪ u pʰ ə ŋ ɡ
તુર્ક	t̪ u ɾ k
તુર્કસ્તાન	t̪ u ɾ k ə s t̪ ɑ n
તુર્કી	t̪ u ɾ k i
તુલસી	t̪ u l s i
તુલા	t̪ u l ɑ
તૂટવું	t̪ u ʈ ʋ ũ
તેણે	t̪ eː ɳ ɛ
તેર	t e ɾ
તેલ	t̪ eː l
તેલુગુ	t̪ eː l u ɡ u
તૈમુર	t̪ ə ɪ m u ɾ
તોરત	t̪ o ɾ ə t̪
ત્રણ	t̪ ɾ ɔ ɳ
ત્રિશૂળ	t̪ ɾ ɪ ʃ u ɭ
ત્વરિત	t̪ ʋ ə ɾ ɪ t̪
થ	tʰ ə
થડ	t̪ʰ ə ɖ
થળ	t̪ʰ ə ɭ
થાકવું	t̪ʰ ɑ k ʋ ũ
થાળી	t̪ʰ ɑ ɭ i
થી	t̪ʰ i
થેલી	t̪ʰ eː l i
દ	d ə
દક્ષિણ	d̪ ə k ʃ ɪ ɳ
દમ	d̪ ə m
દયા	d̪ ə j ɑ
દરગાહ	d̪ ə ɾ ɡ ɑʱ
દરબાર	d̪ ə ɾ b ɑ ɾ
દરવાજો	d̪ ə ɾ ʋ ɑ d͡ʒ o
દરાખ	d̪ ə ɾ ɑ kʰ
દરિયાલાલ	d̪ ə ɾ ɪ j ɑ l ɑ l
દરિયો	d̪ ə ɾ ɪ j o
દરૂન	d̪ ə ɾ u n
દર્પણ	d̪ ə ɾ p ə ɳ
દલડું	d̪ ə l ɖ ũ
દવે	d̪ ə ʋ eː
દશ	d ə ʃ
દસ	d ə s
દસ્તાર	d̪ ə s t̪ ɑ ɾ
દસ્તૂર	d̪ ə s t̪ u ɾ
દહાડો	d̪ ə ɦ ɑ ɖ o
દહીં	d̪ ə ɦ ĩ
દહીં	d̪ ə̤ ĩ
દહેજ	d̪ ə ɦ eː d͡ʒ
દાઈ	d̪ ɑ i
દાક્તર	d̪ ɑ k t̪ ə ɾ
દાડમ	d̪ ɑ ɽ ə m
દાઢી	d̪ ɑ ɖʱ i
દાદરો	d̪ ɑ d̪ ɾ ɔ
દાદા	d̪ ɑ d̪ ɑ
દાદી	d̪ ɑ d̪ i
દાબિસ્તાન	d̪ ɑ b ɪ s t̪ ɑ n
દાર	d̪ ɑ ɾ
દારાબ	d̪ ɑ ɾ ɑ b
દાર્જીલિંગ	d̪ ɑ ɾ d͡ʒ i l ɪ ŋ ɡ
દાળ	d̪ ɑ ɭ
દાસ	d̪ ɑ s
દિન	d̪ ɪ n
દિયર	d̪ ɪ j ə ɾ
દિલ	d̪ ɪ l
દિલબર	d̪ ɪ l b ə ɾ
દિલરુબા	d̪ ɪ l ɾ u b ɑ
દિલિપ	d̪ ɪ l ɪ p
દિલ્હી	d̪ ɪ l ɦ i
દિવસ	d̪ ɪ ʋ ə s
દિવાળી	d̪ ɪ ʋ ɑ ɭ i
દિવેલ	d̪ ɪ ʋ eː l
દીકરો	d̪ i k ɾ ɔ
દીદી	d̪ i d̪ i
દીપ	d̪ i p
દીપક	d̪ i p ə k
દીપિકા	d̪ i p ɪ k ɑ
દીવાનું	d̪ i ʋ ɑ n ũ
દીવાલ	d̪ i ʋ ɑ l
દીવો	d̪ i ʋ ɔ
દુઃસ્વપ્ન	d̪ uʰ s ʋ ə p n ə
દુઆ	d̪ u ɑ
દુકાન	d̪ u k ɑ n
દુકાનદાર	d̪ u k ɑ n d̪ ɑ ɾ
દુખ્તર	d̪ u kʰ t̪ ə ɾ
દુનિયા	d̪ u n ɪ j ɑ
દુરૂદ	d̪ u ɾ u d̪
દુર્ગા	d̪ u ɾ ɡ ɑ
દુર્રાજ	d̪ u ɾ ɾ ɑ d͡ʒ
દૂધ	d ṳ d
દૂધી	d̪ u d̪ʱ i
દૂર	d̪ u ɾ
દૂરદર્શન	d̪ u ɾ d̪ ə ɾ ʃ ə n
દૂરબીન	d̪ u ɾ b i n
દેખવું	d̪ eː kʰ ʋ ũ
દેડકી	d̪ eː ɖ k i
દેડકું	d̪ eː ɖ k ũ
દેડકો	d̪ eː ɖ k o
દેરું	d̪ eː ɾ ũ
દેલ	d̪ eː l
દેવ	d̪ eː ʋ
દેવનાગરી	d̪ eː ʋ n ɑ ɡ ɾ i
દેવી	d̪ eː ʋ i
દેશ	d̪ eː ʃ
દેસ	d̪ eː s
દેસાઈ	d̪ eː s ɑ i
દેસી	d̪ eː s i
દોખમું	d̪ o kʰ m ũ
દોડવું	d̪ ǒ ɖ ʋ ũ
દોરી	d̪ o ɾ i
દોલત	d̪ o l ə t̪
દ્વારકા	d̪ ʋ ɑ ɾ k ɑ
દ્વીપ	d̪ ʋ i p
ધ	dʱ ə
ધણીધણિયાણી	d̪ʱ ə ɳ i d̪ʱ ɳ ɪ j ɑ ɳ i
ધન્યવાદ	d̪ʱ ə n j ə ʋ ɑ d̪
ધાણા	d̪ʱ ɑ ɳ ɑ
ધાન	d̪ʱ ɑ n
ધીરું	d̪ʱ i ɾ ũ
ધીવર	d̪ʱ i ʋ ə ɾ
ધૂતા	d̪ʱ u t̪ ɑ
ધૂપ	d̪ʱ u p
ધૂમ્રપાન	d̪ʱ u m ɾ ə p ɑ n
ધૂય	d̪ʱ u j ə
ધૂળ	d̪ʱ u ɭ
ધોતી	d̪ʱ o t̪ i
ધોરીમાર્ગ	d̪ʱ o ɾ i m ɑ ɾ ɡ
ધ્વનિ	d̪ʱ ʋ ə n ɪ
ન	n ə
નંબર	n ə m b ə ɾ
નણંદ	n ə ɳ ə n d̪
નથ	n ə t̪ʰ
નદી	n ə d̪ i
નપુંસકલિંગ	n ə p ũ s ə k l ɪ ŋ ɡ
નબી	n ə b i
નમવું	n ə m ʋ ũ
નમસ્કાર	n ə m ə s k ɑ ɾ
નમસ્તે	n ə m ə s t̪ eː
નમાજ	n ə m ɑ d͡ʒ
નરગિસ	n ə ɾ ɡ ɪ s
નરઘું	n ə ɾ ɡʱ ũ
નરમ	n ə ɾ ə m
નરસંહાર	n ə ɾ s ã ɦ ɑ ɾ
નરિમાન	n ə ɾ ɪ m ɑ n
નરેન્દ્ર	n ə ɾ eː n d̪ ɾ ə
નળ	n ə ɭ
નવ	n ə ʋ
નવજોત	n ə ʋ d͡ʒ o t̪
નવરાત્રિ	n ə ʋ ɾ ɑ t̪ ɾ ɪ
નવરોજ	n ə ʋ ɾ o d͡ʒ
નવવર્ષ	n ə ʋ ə ʋ ə ɾ ʂ
નવાપુર	n ə ʋ ɑ p u ɾ
નવાબ	n ə ʋ ɑ b
નવેમ્બર	n ə ʋ eː m b ə ɾ
નસીબ	n ə s i b
નસ્ક	n ə s k
નસ્તાલીક	n ə s t̪ ɑ l i k
નાક	n ɑ k
નાકું	n ɑ k ũ
નાખવું	n ɑ kʰ ʋ ũ
નાગપુર	n ɑ ɡ p u ɾ
નાગું	n ɑ ɡ ũ
નાચવું	n ɑ t͡ʃ ʋ ũ
નાટક	n ɑ ʈ ə k
નાતાલ	n ɑ t̪ ɑ l
નાથ	n ɑ t̪ʰ
નાન	n ɑ n
નાનકપંથી	n ɑ n ə k p ə n t̪ʰ i
નાના	n ɑ n ɑ
નાની	n ɑ n i
નાન્યતર	n ɑ n j ə t̪ ə ɾ
નામ	n ɑ m
નાર	n ɑ ɾ
નારંગી	n ɑ ɾ ə ŋ ɡ i
નારંજ	n ɑ ɾ ə ɲ d͡ʒ
નારી	n ɑ ɾ i
નાવ	n ɑ ʋ
નાશિક	n ɑ ʃ ɪ k
નાસ્તો	n ɑ s t̪ o
નિકાબ	n ɪ k ɑ b
નિકાસ	n ɪ k ɑ s
નિકાહ	n ɪ k ɑʱ
નિબંધ	n ɪ b ə n d̪ʱ
નિબંધકાર	n ɪ b ə n d̪ʱ k ɑ ɾ
નિર્ણય	n ɪ ɾ ɳ ə j ə
નિશાળ	n ɪ ʃ ɑ ɭ
નિહાળવું	n ɪ ɦ ɑ ɭ ʋ ũ
નીંદર	n ĩ d̪ ə ɾ
નીચું	n i t͡ʃ ũ
નીર	n i ɾ
નીલું	n i l ũ
નૂતન	n u t̪ ə n
નૂર	n u ɾ
નૂહ	n uʱ
નૃત્ય	n ɾ ʊ t̪ j ə
ને	n eː
નેપાળ	n eː p ɑ ɭ
નેહ	n eːʱ
નોકર	n o k ə ɾ
નોકરી	n o k ɾ i
નોમ	n ɔ m
નોળિયો	n o ɭ ɪ j o
પ	p ə
પંખી	p ə ŋ kʰ i
પંખીઘર	p ə ŋ kʰ i ɡʱ ə ɾ
પંખેરું	p ə ŋ kʰ eː ɾ ũ
પંખો	p ə ŋ kʰ ɔ
પંજાબ	p ə ɲ d͡ʒ ɑ b
પંડિત	p ə ɳ ɖ ɪ t̪
પંદર	p ə n d ə ɾ
પક્ષી	p ə k ʃ i
પખવાડિયું	p ə kʰ ʋ ɑ ɖ ɪ j ũ
પગલૂછણિયું	p ə ɡ l u t͡ʃʰ ɳ ɪ j ũ
પગોડા	p ə ɡ o ɖ ɑ
પટણા	p ə ʈ ɳ ɑ
પટવારી	p ə ʈ ʋ ɑ ɾ i
પટેલ	p ə ʈ eː l
પઠાણ	p ə ʈʰ ɑ ɳ
પડવું	p ə ɖ ʋ ũ
પડી	p ə ɖ i
પડોશ	p ə ɖ o ʃ
પડોશી	p ə ɖ o ʃ i
પઢવું	p ə ɖʱ ʋ ũ
પણ	p ə ɳ
પતંગ	p ə t̪ ə ŋ ɡ
પતંગિયું	p ə t̪ ə ŋ ɡ ɪ j ũ
પતિ	p ə t̪ ɪ
પત્ની	p ə t̪ n i
પદ્મ	p ə d̪ m ə
પનીર	p ə n i ɾ
પપૈયું	p ə p ə ɪ j ũ
પરદા	p ə ɾ d̪ ɑ
પરદાદા	p ə ɾ d̪ ɑ d̪ ɑ
પરદેશ	p ə ɾ d̪ eː ʃ
પરમદિવસ	p ə ɾ ə m d̪ ɪ ʋ ə s
પરમેશ્વર	p ə ɾ m eː ʃ ʋ ə ɾ
પરવાના	p ə ɾ ʋ ɑ n ɑ
પરવીન	p ə ɾ ʋ i n
પરાઠા	p ə ɾ ɑ ʈʰ ɑ
પરિવાર	p ə ɾ ɪ ʋ ɑ ɾ
પરિસ્તોમ	p ə ɾ ɪ s t̪ o m
પરિસ્થિતિ	p ə ɾ ɪ s t̪ʰ ɪ t̪ ɪ
પરીક્ષા	p ə ɾ i k ʃ ɑ
પરીખ	p ə ɾ i kʰ
પરોઢ	p ə ɾ o ɖʱ
પર્વત	p ə ɾ ʋ ə t̪
પલંગ	p ə l ə ŋ ɡ
પળ	p ə ɭ
પવન	p ə ʋ ə n
પવિત્ર	p ə ʋ ɪ t̪ ɾ ə
પશમીના	p ə ʃ m i n ɑ
પશુધન	p ə ʃ u d̪ʱ ə n
પશ્તો	p ə ʃ t̪ o
પસંદ	p ə s ə n d̪
પસીનો	p ə s i n o
પહાડ	p ə ɦ ɑ ɖ
પહેલું	p ə ɦ eː l ũ
પહોંચવું	p ɔ̤̃ t͡ʃ ʋ ũ
પહોંચવું	p ə ɦ ɔ̃ t͡ʃ ʋ ũ
પાંચ	p ɑ̃ t͡ʃ
પાંસળી	p ɑ̃ s ə ɭ i
પાઉં	p ɑ ũ
પાકિસ્તાન	p ɑ k ɪ s t̪ ɑ n
પાઘડી	p ɑ ɡʱ ɖ i
પાટણ	p ɑ ʈ ə ɳ
પાઠવવું	p ɑ ʈʰ ə ʋ ʋ ũ
પાણી	p ɑ ɳ i
પાણીપુરી	p ɑ ɳ i p u ɾ i
પાદરી	p ɑ d̪ ɾ i
પાનખર	p ɑ n kʰ ə ɾ
પાનું	p ɑ n ũ
પાપડ	p ɑ p ə ɽ
પાયજામો	p ɑ j d͡ʒ ɑ m o
પારકું	p ɑ ɾ k ũ
પારસી	p ɑ ɾ s i
પારેખ	p ɑ ɾ eː kʰ
પારેવું	p ɑ ɾ eː ʋ ũ
પાલક	p ɑ l ə k
પાવની	p ɑ ʋ ə n i
પાસ્ખા	p ɑ s kʰ ɑ
પિતા	p ɪ t̪ ɑ
પિતૃદેશ	p ɪ t̪ ɾ u d̪ eː ʃ
પિત્તળ	p ɪ t̪ t̪ ə ɭ
પિયર	p ɪ j ə ɾ
પિસર	p ɪ s ə ɾ
પિસ્તોલ	p ɪ s t̪ o l
પીંછું	p ĩ t͡ʃʰ ũ
પીછું	p i t͡ʃʰ ũ
પીઠ	p i ʈʰ
પીઠી	p i ʈʰ i
પીઠું	p i ʈʰ ũ
પીપળો	p ɪ p ɭ ɔ
પીર	p i ɾ
પીરોઝ	p i ɾ o d͡ʒʱ
પીવું	p i ʋ ũ
પુંલિંગ	p ũ l ɪ ŋ ɡ
પુત્ર	p u t̪ ɾ ə
પુત્રી	p u t̪ ɾ i
પુર	p u ɾ
પુરી	p u ɾ i
પુલાવ	p u l ɑ ʋ
પુષ્પ	p u ʃ p ə
પુષ્પપાત્ર	p u ʃ p ə p ɑ t̪ ɾ ə
પુસ્તક	p u s t̪ ə k
પુસ્તકાલય	p u s t̪ ə k ɑ l j ə
પૂંજી	p ũ d͡ʒ i
પૂજા	p u d͡ʒ ɑ
પૂત	p u t̪
પૂના	p u n ɑ
પૂરી	p u ɾ i
પૃથ્વી	p ɾ u t̪ʰ ʋ i
પેટ્રોલ	p eː ʈ ɾ o l
પેન	p eː n
પેરુ	p eː ɾ u
પેશવા	p eː ʃ ʋ ɑ
પેશાવર	p eː ʃ ɑ ʋ ə ɾ
પૈસા	p ə ɪ s ɑ
પોપૈયું	p o p ə ɪ j ũ
પોર્ટુગલ	p o ɾ ʈ u ɡ ə l
પોર્ટુગીઝ	p o ɾ ʈ u ɡ i d͡ʒʱ
પોલંડ	p o l ə ɳ ɖ
પોલિશ	p o l ɪ ʃ
પોળ	p o ɭ
પ્યાજ	p j ɑ d͡ʒ
પ્યાર	p j ɑ ɾ
પ્યારું	p j ɑ ɾ ũ
પ્યાલો	p j ɑ l o
પ્રકાર	p ɾ ə k ɑ ɾ
પ્રકાશ	p ɾ ə k ɑ ʃ
પ્રકાશિત	p ɾ ə k ɑ ʃ ɪ t̪
પ્રગટવું	p ɾ ə ɡ ə ʈ ʋ ũ
પ્રજાપતિ	p ɾ ə d͡ʒ ɑ p ə t̪ ɪ
પ્રણામ	p ɾ ə ɳ ɑ m
પ્રથમ	p ɾ ə t̪ʰ ə m
પ્રદૂષણ	p ɾ ə d̪ u ʃ ə ɳ
પ્રધાન	p ɾ ə d̪ʱ ɑ n
પ્રશ્ન	p ɾ ə ʃ n ə
પ્રાંગાર	p ɾ ɑ̃ ɡ ɑ ɾ
પ્રાકૃત	p ɾ ɑ k ɾ ʊ t̪
પ્રાચી	p ɾ ɑ t͡ʃ i
પ્રાચીન	p ɾ ɑ t͡ʃ i n
પ્રાણ	p ɾ ɑ ɳ
પ્રાણી	p ɾ ɑ ɳ i
પ્રાર્થના	p ɾ ɑ ɾ t̪ʰ ə n ɑ
પ્રેમ	p ɾ eː m
પ્રેમિકા	p ɾ eː m ɪ k ɑ
ફ	f
ફ	pʰ ə
ફ	ɸ
ફજર	f ə d͡ʒ ə ɾ
ફજર	pʰ ə d͡ʒ ə ɾ
ફરજ	f ə ɾ d͡ʒ
ફરજ	pʰ ə ɾ d͡ʒ
ફરમાન	pʰ ə ɾ m ɑ n
ફરવર્દીન	pʰ ə ɾ ʋ ə ɾ d̪ i n
ફરહાદ	f ə ɾ ɦ ɑ d̪
ફરહાદ	pʰ ə ɾ ɦ ɑ d̪
ફરાસીસી	pʰ ə ɾ ɑ s i s i
ફળ	pʰ ə ɭ
ફાતિમા	pʰ ɑ t̪ ɪ m ɑ
ફાનસ	f ɑ n ə s
ફાનસ	pʰ ɑ n ə s
ફારૂક	pʰ ɑ ɾ u k
ફાલુદા	pʰ ɑ l u d̪ ɑ
ફિરંગ	pʰ ɪ ɾ ə ŋ ɡ
ફિરદોસ	f ɪ ɾ d̪ o s
ફિરદોસ	pʰ ɪ ɾ d̪ o s
ફિરદોસી	pʰ ɪ ɾ d̪ o s ɪ
ફિરસ્તો	f ɪ ɾ ə s t̪ o
ફિરસ્તો	pʰ ɪ ɾ ə s t̪ o
ફિલસ્તીન	f ɪ l ə s t̪ i n
ફિલસ્તીન	pʰ ɪ l ə s t̪ i n
ફિલ્મ	f ɪ l m
ફિલ્મ	f ɪ l ə m
ફિલ્મ	pʰ ɪ l m
ફિલ્મ	pʰ ɪ l ə m
ફુઆ	pʰ u ɑ
ફુવાદ	f u ʋ ɑ d̪
ફુવાદ	pʰ u ʋ ɑ d̪
ફૂંકવું	pʰ ũ k ʋ ũ
ફૂલ	pʰ u l
ફેઝ	pʰ eː d͡ʒʱ
ફેબ્રુઆરી	pʰ eː b ɾ u ɑ ɾ i
ફોઈ	f o i
ફોઈ	pʰ o i
ફ્રાંસ	pʰ ɾ ɑ̃ s
ફ્રાંસીસી	pʰ ɾ ɑ̃ s i s i
બ	b ə
બંગડી	b ə ŋ ɡ ɖ i
બંગાળ	b ə ŋ ɡ ɑ ɭ
બંદો	b ə n d̪ o
બંબો	b ə m b o
બકરી	b ə k ɾ i
બકરું	b ə k ɾ ũ
બકરો	b ə k ɾ ɔ
બગડવું	b ə ɡ ə ɽ ʋ ũ
બગદાદ	b ə ɡ d̪ ɑ d̪
બગલ	b ə ɡ ə l
બચ્ચી	b ə t͡ʃ t͡ʃ i
બચ્ચું	b ə t͡ʃ t͡ʃ ũ
બચ્ચો	b ə t͡ʃ t͡ʃ o
બજાર	b ə d͡ʒ ɑ ɾ
બજાર	b ə z ɑ ɾ
બટાટા	b ə ʈ ɑ ʈ ɑ
બતક	b ə t̪ ə k
બદર	b ə d̪ ə ɾ
બદામ	b ə d̪ ɑ m
બદ્ર	b ə d̪ ɾ ə
બનફશા	b ə n ə pʰ ʃ ɑ
બમણું	b ə m ɳ ũ
બરણી	b ə ɾ ɳ i
બરાક	b ə ɾ ɑ k
બરામદા	b ə ɾ ɑ m ə d̪ ɑ
બરોડા	b ə ɾ o ɖ ɑ
બલૂચ	b ə l u t͡ʃ
બલૂચિસ્તાન	b ə l u t͡ʃ ɪ s t̪ ɑ n
બલૂત	b ə l u t̪
બળવાન	b ə ɭ ʋ ɑ n
બસ	b ə s
બહાનું	b ə ɦ ɑ n ũ
બહાર	b a̤ r
બહાર	b ə ɦ ɑ ɾ
બહુ	b ə ɦ u
બહુજન	b ə ɦ u d͡ʒ ə n
બહેન	b ə ɦ eː n
બહેન	b ɛ̤ n
બહેરામ	b ə ɦ eː ɾ ɑ m
બહેરું	b ə ɦ eː ɾ ũ
બહેરું	b ɛ̤ ɾ ũ
બા	b ɑ
બાંગ	b ɑ̃ ɡ
બાંગ્લાદેશ	b ɑ ɳ ɡ l ɑ d̪ eː ʃ
બાંડિયો	b ɑ̃ ɖ ɪ j ɔ
બાંધવું	b ɑ̃ d̪ʱ ʋ ũ
બાઇબલ	b ɑ ɪ b ə l
બાઈડી	b ɑ i ɖ i
બાગ	b ɑ ɡ
બાજુ	b ɑ d͡ʒ u
બાટલી	b ɑ ʈ l i
બાદરંગ	b ɑ d̪ ɾ ə ŋ ɡ
બાદશાહ	b ɑ d̪ ʃ ɑʱ
બાપ	b ɑ p
બાપા	b ɑ p ɑ
બાપ્તિસ્મા	b ɑ p t̪ ɪ s m ɑ
બાફવું	b ɑ pʰ ʋ ũ
બાબર	b ɑ b ə ɾ
બાબો	b ɑ b o
બાર	b ɑ ɾ
બારણું	b ɑ ɾ ɳ ũ
બારી	b ɑ ɾ i
બાલદી	b ɑ l d̪ i
બાલ્કન	b ɑ l k ə n
બાળ	b ɑ ɭ
બાળક	b ɑ ɭ ə k
બાળપણ	b ɑ ɭ p ə ɳ
બાવળ	b ɑ ʋ ə ɭ
બિંદાસ	b ɪ n d̪ ɑ s
બિંદી	b ɪ n d̪ i
બિંદુ	b ɪ n d̪ u
બિરયાની	b ɪ ɾ j ɑ n i
બિસ્કિટ	b ɪ s k ɪ ʈ
બિસ્મિલ્લા	b ɪ s m ɪ l l ɑ
બિહાર	b ɪ ɦ ɑ ɾ
બીજ	b i d͡ʒ
બુંદેલખંડ	b u n d̪ eː l kʰ ə ɳ ɖ
બુખારા	b u kʰ ɑ ɾ ɑ
બુત	b u t̪
બુતાન	b u t̪ ɑ n
બુદ્ધ	b u d̪ d̪ʱ
બુદ્ધિ	b u d̪ d̪ʱ ɪ
બુધ	b u d̪ʱ
બુધવાર	b u d̪ʱ ʋ ɑ ɾ
બુરખો	b u ɾ kʰ ɔ
બુલબુલ	b u l b u l
બૂચ	b u t͡ʃ
બૂઝવવું	b u d͡ʒʱ ə ʋ ʋ ũ
બૂડવું	b u ɖ ʋ ũ
બે	b ɛ
બેંગલુરુ	b eː ŋ ɡ l u ɾ u
બેંગલોર	b eː ŋ ɡ l o ɾ
બેગમ	b eː ɡ ə m
બેવકૂફ	b eː ʋ ə k u pʰ
બેસવું	b eː s ʋ ũ
બૈરક	b ə ɪ ɾ ə k
બોબડું	b o b ɖ ũ
બોબા	b o b ɑ
બોસા	b o s ɑ
બ્રહ્મદેશ	b ɾ əʱ m ə d̪ eː ʃ
બ્રહ્મપુત્ર	b ɾ əʱ m ə p u t̪ ɾ ə
બ્રિંજલ	b ɾ ɪ ɲ d͡ʒ ə l
બ્રિટન	b ɾ ɪ ʈ ə n
ભ	bʱ ə
ભગવાન	bʱ ə ɡ ʋ ɑ n
ભજન	bʱ ə d͡ʒ ə n
ભઠ્ઠી	bʱ ə ʈʰ ʈʰ i
ભણવું	bʱ ə ɳ ʋ ũ
ભરવું	bʱ ə ɾ ʋ ũ
ભરૂચ	bʱ ə ɾ u t͡ʃ
ભવાઇ	bʱ ə ʋ ɑ ɪ
ભવું	bʱ ə ʋ ũ
ભસમ	bʱ ə s ə m
ભાંડ	bʱ ɑ̃ ɖ
ભાઈ	bʱ ɑ i
ભાડ	bʱ ɑ ɖ
ભાત	bʱ ɑ t̪
ભાભી	bʱ ɑ bʱ i
ભારત	bʱ ɑ ɾ ə t̪
ભારતીય	bʱ ɑ ɾ t̪ i j ə
ભાર્યા	bʱ ɑ ɾ j ɑ
ભાવનગર	bʱ ɑ ʋ n ə ɡ ə ɾ
ભાષણ	bʱ ɑ ʃ ə ɳ
ભાષા	bʱ ɑ ʃ ɑ
ભિસ્તી	bʱ ɪ s t̪ i
ભીંડો	bʱ i ɳ ɖ ɔ
ભીખ	bʱ i kʰ
ભીલ	bʱ i l
ભુઠ્ઠો	bʱ u ʈ ʈʰ ɔ
ભૂખ	bʱ u kʰ
ભૂખહડતાળ	bʱ u kʰ ɦ ə ɖ t̪ ɑ ɭ
ભૂલવું	bʱ u l ʋ ũ
ભૃગુવાર	bʱ ɾ u ɡ u ʋ ɑ ɾ
ભેંસ	bʱ ɛ̃ s
ભેંસો	bʱ ẽ s o
ભેજવું	bʱ eː d͡ʒ ʋ ũ
ભોં	bʱ õ
ભોજન	bʱ o d͡ʒ ə n
ભોપાળ	bʱ o p ɑ ɭ
ભોર	bʱ o ɾ
મ	m ə
મંગળ	m ə ŋ ɡ ə ɭ
મંગળવાર	m ə ŋ ɡ ə ɭ ʋ ɑ ɾ
મંચુરિયા	m ə ɲ t͡ʃ u ɾ ɪ j ɑ
મંદિર	m ə n d̪ ɪ ɾ
મકદુનિયા	m ə k d̪ u n ɪ j ɑ
મકબરો	m ə k b ə ɾ o
મકાન	m ə k ɑ n
મક્કા	m ə k k ɑ
મગ	m ə ɡ
મગજ	m ə ɡ ə d͡ʒ
મગર	m ə ɡ ə ɾ
મગરિબ	m ə ɡ ɾ ɪ b
મચ્છર	m ə t͡ʃ t͡ʃʰ ə ɾ
મટવું	m ə ʈ ʋ ũ
મણિપુર	m ə ɳ ɪ p u ɾ
મત	m ə t̪
મથુરા	m ə t̪ʰ u ɾ ɑ
મદીના	m ə d̪ i n ɑ
મદ્રાસ	m ə d̪ ɾ ɑ s
મદ્રાસી	m ə d̪ ɾ ɑ s i
મધ	m ə d̪ʱ
મધમાખી	m ə d̪ʱ m ɑ kʰ i
મધુ	m ə d̪ʱ u
મધ્યપ્રદેશ	m ə d̪ʱ j ə p ɾ ə d̪ eː ʃ
મન	m ə n
મનીષા	m ə n i ʃ ɑ
મને	m ə n
મને	m ə n eː
મફત	m ə pʰ ə t̪
મમમમ	m ə m m ə m
મમ્મા	m ə m m ɑ
મમ્મી	m ə m m i
મરણ	m ə ɾ ə ɳ
મરવું	m ə ɾ ʋ ũ
મરિયમ	m ə ɾ ɪ j ə m
મર્ચન્ટ	m ə ɾ t͡ʃ ə n ʈ
મલબાર	m ə l b ɑ ɾ
મલાયા	m ə l ɑ j ɑ
મસીત	m ə s i t̪
મસીદ	m ə s i d̪
મસીહ	m ə s iʱ
મસ્જિદ	m ə s d͡ʒ ɪ d̪
મસ્તિષ્ક	m ə s t̪ ɪ ʃ k
મહત્ત્વ	m ə ɦ ə t̪ t̪ ʋ ə
મહમૂદ	m əʱ m u d̪
મહર	m ə ɦ ə ɾ
મહારાણી	m ə ɦ ɑ ɾ ɑ ɳ i
મહારાષ્ટ્ર	m ə ɦ ɑ ɾ ɑ ʂ ʈ ɾ ə
મહિનો	m ə ɦ ɪ n o
મહિનો	m ə ɪ n o
મહિલા	m ə ɦ ɪ l ɑ
મહેક	m ə ɦ eː k
મહેસાણા	m ə ɦ eː s ɑ ɳ ɑ
મહોબત	m ə ɦ o b ə t̪
માં	m ɑ̃
માંચી	m ɑ̃ t͡ʃ i
માંડો	m ɑ̃ ɖ o
માંસ	m ɑ̃ s
માઓવાદ	m ɑ o ʋ ɑ d̪
માખણ	m ɑ kʰ ə ɳ
માગ	m ɑ ɡ
માછલી	m ɑ t͡ʃʰ l i
માટે	m ɑ ʈ e
માણસ	m ɑ ɳ ə s
માતા	m ɑ t̪ ɑ
માથું	m ɑ t̪ʰ ũ
મામા	m ɑ m ɑ
મામી	m ɑ m i
માયા	m ɑ j ɑ
મારતોલ	m ɑ ɾ t̪ o l
મારવાડ	m ɑ ɾ ʋ ɑ ɖ
મારા	m ɑ ɾ ɑ
મારી	m ɑ ɾ i
માર્ગ	m ɑ ɾ ɡ
માર્ચ	m ɑ ɾ t͡ʃ
માળી	m ɑ ɭ i
માવડી	m ɑ ʋ ɖ i
માશાલ્લાહ	m ɑ ʃ ɑ l l ɑʱ
માસા	m ɑ s ɑ
માસી	m ɑ s i
માહ	m ɑʱ
મિનારો	m ɪ n ɑ ɾ o
મિનિટ	m ɪ n ɪ ʈ
મિયાં	m ɪ j ɑ̃
મિસર	m ɪ s ə ɾ
મિસરી	m ɪ s ɾ i
મિસ્ટર	m ɪ s ʈ ə ɾ
મિહર	m ɪ ɦ ə ɾ
મિહરાબ	m ɪʱ ɾ ɑ b
મીઠાઈ	m i ʈʰ ɑ i
મીરાંબાઈ	m i ɾ ɑ̃ b ɑ i
મુખ	m u kʰ
મુઘલ	m u ɡʱ ə l
મુબારક	m u b ɑ ɾ ə k
મુમતાજ	m u m t̪ ɑ d͡ʒ
મુમતાજ	m u m t̪ ɑ z
મુરબ્બો	m u ɾ ə b b o
મુરાદાબાદ	m u ɾ ɑ d̪ ɑ b ɑ d̪
મુલતાન	m u l t̪ ɑ n
મુસલમાની	m u s ə l m ɑ n i
મુસલ્લો	m u s ə l l ɔ
મુહર્રમ	m u ɦ ə ɾ ɾ ə m
મુહલ્લા	m u ɦ ə l l ɑ
મૂછ	m u t͡ʃʰ
મૂડીવાદ	m u ɖ i ʋ ɑ d̪
મે	m eː
મેંદી	m ɛ n d̪ i
મેકવાન	m eː k ʋ ɑ n
મેક્સિકો	m eː k s ɪ k o
મેઘ	m eː ɡʱ
મેઘધનુષ	m eː ɡʱ ə d̪ʱ ə n u ʂ
મેઘના	m eː ɡʱ n ɑ
મેમ	m eː m
મેમણ	m eː m ə ɳ
મેરઠ	m eː ɾ ə ʈʰ
મેહ	m eːʱ
મૈથુન	m ə ɪ t̪ʰ u n
મોં	m õ
મોકો	m o k ɔ
મોટરસાયકલ	m o ʈ ə ɾ s ɑ j ə k ə l
મોડું	m o ɽ ũ
મોમો	m o m o
મોર	m o ɾ
મોસંબી	m o s ə m b i
મોસ્કો	m o s k o
મોહબત	m oʱ b ə t̪
મોહમ્મદ	m o ɦ ə m m ə d̪
મ્યાઉં	m j ɑ ũ
ય	j ə
યંત્ર	j ə n t̪ ɾ ə
યઝત	j ə d͡ʒʱ ə t̪
યમન	j ə m ə n
યમુના	j ə m u n ɑ
યવન	j ə ʋ ə n
યહૂદી	j ə ɦ u d̪ i
યાત્રા	j ɑ t̪ ɾ ɑ
યાર	j ɑ ɾ
યાસમીન	j ɑ s m i n
યુગોસ્લાવિયા	j u ɡ o s l ɑ ʋ ɪ j ɑ
યૂક્રેઇન	j u k ɾ eː ɪ n
યેન	j eː n
યોગી	j o ɡ i
યોનિ	j o n ɪ
ર	ɾ ə
રંગ	ɾ ə ŋ ɡ
રંગવું	ɾ ə ŋ ɡ ʋ ũ
રક્ત	ɾ ə k t̪
રક્ષા	ɾ ə k ʃ ɑ
રજનીગંધા	ɾ ə d͡ʒ n i ɡ ə n d̪ʱ ɑ
રણ	ɾ ə ɳ
રણવાસ	ɾ ə ɳ ʋ ɑ s
રથ	ɾ ə t̪ʰ
રમકડું	ɾ ə m ə k ɖ ũ
રમજાન	ɾ ə m d͡ʒ ɑ n
રમજાન	ɾ ə m z ɑ n
રમઝાન	ɾ ə m d͡ʒʱ ɑ n
રમત	ɾ ə m ə t̪
રવિ	ɾ ə ʋ ɪ
રવિવાર	ɾ ə ʋ ɪ ʋ ɑ ɾ
રશિયા	ɾ ə ʃ ɪ j ɑ
રસ	ɾ ə s
રસી	ɾ ə s i
રસૂલ	ɾ ə s u l
રસોઈ	ɾ ə s o i
રસોડું	ɾ ə s o ɖ ũ
રસ્તો	ɾ ə s t̪ ɔ
રહેમાન	ɾ ə ɦ eː m ɑ n
રાંધણ	ɾ ɑ̃ d̪ʱ ə ɳ
રાંધવું	ɾ ɑ̃ d̪ʱ ʋ ũ
રાઈતું	ɾ ɑ i t̪ ũ
રાખ	ɾ ɑ kʰ
રાખવું	ɾ ɑ kʰ ʋ ũ
રાખસ	ɾ ɑ kʰ ə s
રાજ	ɾ ɑ d͡ʒ
રાજકોટ	ɾ ɑ d͡ʒ k o ʈ
રાજધાની	ɾ ɑ d͡ʒ d̪ʱ ɑ n i
રાજપૂત	ɾ ɑ d͡ʒ p u t̪
રાજમાર્ગ	ɾ ɑ d͡ʒ m ɑ ɾ ɡ
રાજસ્થાન	ɾ ɑ d͡ʒ ə s t̪ʰ ɑ n
રાજા	ɾ ɑ d͡ʒ ɑ
રાજીવ	ɾ ɑ d͡ʒ i ʋ
રાજ્ય	ɾ ɑ d͡ʒ j ə
રાધેકૃષ્ણ	ɾ ɑ d̪ʱ eː k ɾ u ʃ ɳ
રામાયણ	ɾ ɑ m ɑ j ə ɳ
રાય	ɾ ɑ j ə
રાષ્ટ્રગીત	ɾ ɑ ʂ ʈ ɾ ə ɡ i t̪
રાષ્ટ્રભાષા	ɾ ɑ ʃ ʈ ɾ ə bʱ ɑ ʃ ɑ
રાહુલ	ɾ ɑ ɦ u l
રિક્ષા	ɾ ɪ k ʃ ɑ
રિચાર્ડ	ɾ ɪ t͡ʃ ɑ ɾ ɖ
રિશ્વત	ɾ ɪ ʃ ʋ ə t̪
રીંગણ	ɾ i ŋ ɡ ə ɳ
રીંછ	ɾ ĩ t͡ʃʰ
રૂત	ɾ u t̪
રૂપ	ɾ u p
રૂપિયો	ɾ u p ɪ j ɔ
રૂબલ	ɾ u b ə l
રૂમાલ	ɾ u m ɑ l
રૂસ	ɾ u s
રૂસી	ɾ u s i
રૂસ્તમ	ɾ u s t̪ ə m
રેસ્ટોરાં	ɾ eː s ʈ o ɾ ɑ̃
રેસ્ટોરાં	ɾ eː s ʈ ɔ ɾ ɑ̃
રોજ	ɾ o d͡ʒ
રોજો	ɾ o d͡ʒ o
રોટલી	ɾ o ʈ l i
રોમાનિયા	ɾ o m ɑ n ɪ j ɑ
રોવું	ɾ o ʋ ũ
લ	l ə
લંકા	l ə ŋ k ɑ
લંચ	l ə n t͡ʃ
લખણ	l ə kʰ ə ɳ
લખનૌ	l ə kʰ n ə u
લખવું	l ə kʰ ʋ ũ
લગન	l ə ɡ ə n
લગ્ન	l ə ɡ n ə
લઘુતાદર્શક	l ə ɡʱ u t̪ ɑ d̪ ə ɾ ʃ ə k
લતા	l ə t̪ ɑ
લપસણી	l ə p ə s ɳ i
લયલા	l ə j l ɑ
લસણ	l ə s ə ɳ
લહર	l ə ɦ ə ɾ
લાંબું	l ɑ m b ũ
લાકડું	l ɑ k ɖ ũ
લાગવું	l ɑ ɡ ʋ ũ
લાલ	l ɑ l
લાલો	l ɑ l o
લાવવું	l ɑ ʋ ʋ ũ
લાહોર	l ɑ ɦ o ɾ
લિંગ	l ɪ ŋ ɡ
લિંબુ	l ɪ m b u
લિપિ	l ɪ p ɪ
લિફાફો	l ɪ pʰ ɑ pʰ o
લિલામ	l ɪ l ɑ m
લીખ	l i kʰ
લીચી	l i t͡ʃ i
લુગત	l u ɡ ə t̪
લુપ્ત	l u p t̪
લુહાર	l u ɦ ɑ ɾ
લૂંટવું	l ũ ʈ ʋ ũ
લેખક	l eː kʰ ə k
લેનિન	l eː n ɪ n
લેવું	l eː ʋ ũ
લોક	l o k
લોટ	l o ʈ
લોટો	l o ʈ ɔ
લોપ	l o p
લોહ	l oʱ
લોહી	l o i̤
લોહી	l o ɦ i
ળ	ɭ ə
વ	v ə
વંગ	ʋ ə ŋ ɡ
વકીલ	ʋ ə k i l
વખત	ʋ ə kʰ ə t̪
વગર	ʋ ə ɡ ə ɾ
વચલું	ʋ ə t͡ʃ l ũ
વડ	ʋ ə ɖ
વડવાગળું	ʋ ə ɖ ʋ ɑ ɡ ə ɭ ũ
વડોદરા	ʋ ə ɖ o d̪ ɾ ɑ
વતન	ʋ ə t̪ ə n
વધારે	ʋ ə d̪ʱ ɑ ɾ e
વનશ્રી	ʋ ə n ə ʃ ɾ i
વય	ʋ ə j ə
વર	ʋ ə ɾ
વરસ	ʋ ə ɾ ə s
વરસાદ	ʋ ə ɾ s ɑ d̪
વરાત	ʋ ə ɾ ɑ t̪
વરુ	ʋ ə ɾ u
વર્ણ	ʋ ə ɾ ɳ ə
વર્ણમાળા	ʋ ə ɾ ɳ ə m ɑ ɭ ɑ
વર્ષા	ʋ ə ɾ ʃ ɑ
વલંદો	ʋ ə l ə n d̪ o
વલ્લાહ	ʋ ə l l ɑʱ
વસંત	ʋ ə s ə n t̪
વસ્તુ	ʋ ə s t̪ u
વહાણું	ʋ ə ɦ ɑ ɳ ũ
વહાલ	ʋ ə ɦ ɑ l
વહાલા	ʋ ə ɦ ɑ l ɑ
વહાલું	ʋ a̤ l ũ
વહાલું	ʋ ə ɦ ɑ l ũ
વહિશ્ત	ʋ ə ɦ ɪ ʃ t̪
વહી	ʋ ə ɦ i
વહેલું	ʋ ə ɦ eː l ũ
વહેલું	ʋ ɛ̤ l ũ
વાંદર	ʋ ɑ n d̪ ə ɾ
વાંસ	ʋ ɑ̃ s
વાંસળી	ʋ ɑ̃ s ə ɭ i
વાક	ʋ ɑ k
વાગવું	ʋ ɑ ɡ ʋ ũ
વાઘ	ʋ a̤ ɣ
વાઘ	ʋ ɑ ɡʱ
વાઘણ	ʋ a̤ ɣ ə ɳ
વાઘણ	ʋ ɑ ɡʱ ə ɳ
વાટકું	ʋ ɑ ʈ k ũ
વાટકો	ʋ ɑ ʈ k ɔ
વાડિયા	ʋ ɑ ɖ ɪ j ɑ
વાણિયો	ʋ ɑ ɳ ɪ j ɔ
વાત	ʋ ɑ t̪
વાન	ʋ ɑ n
વાપરવું	ʋ ɑ p ə ɾ ʋ ũ
વાયુ	ʋ ɑ j u
વાર	ʋ ɑ ɾ
વારાણસી	ʋ ɑ ɾ ɑ ɳ ə s i
વાલિદ	ʋ ɑ l ɪ d̪
વાલિદૈન	ʋ ɑ l ɪ d̪ ə ɪ n
વાળ	ʋ ɑ ɭ
વાળુ	ʋ ɑ ɭ u
વાવ	ʋ ɑ ʋ
વાસ	ʋ ɑ s
વાસણ	ʋ ɑ s ə ɳ
વાહિગુરુ	ʋ ɑ ɦ ɪ ɡ u ɾ u
વિક્ષનરી	ʋ i k ʃ ə n ə ɾ i
વિચાર	ʋ ɪ t͡ʃ ɑ ɾ
વિજ્ઞાન	ʋ ɪ ɡ n ɑ n
વિધવા	ʋ ɪ d̪ʱ ʋ ɑ
વિધુર	ʋ ɪ d̪ʱ u ɾ
વિના	ʋ ɪ n ɑ
વિપ્લવ	ʋ ɪ p l ə ʋ
વિલાયતી	ʋ ɪ l ɑ j ə t̪ i
વિલિયમ	ʋ ɪ l ɪ j ə m
વિવાહ	ʋ ɪ ʋ ɑʱ
વિશ્વ	ʋ ɪ ʃ ʋ ə
વિશ્વકોશ	ʋ ɪ ʃ ʋ ə k o ʃ
વિષ	ʋ ɪ ʂ
વિષય	ʋ ɪ ʃ j ə
વિહોણું	ʋ ɪ ɦ o ɳ ũ
વીજળી	ʋ i d͡ʒ ə ɭ i
વીણા	ʋ i ɳ ɑ
વીર	ʋ i ɾ
વીસ	ʋ iː s
વુજૂ	ʋ u d͡ʒ u
વુજૂ	ʋ u z u
વૃષ્ટિ	ʋ ɾ ʊ ʂ ʈ ɪ
વેચવું	ʋ eː t͡ʃ ʋ ũ
વેલણ	ʋ eː l ə ɳ
વેલ્સ	ʋ eː l s
વૈદ્ય	ʋ ə ɪ d̪ j ə
વૈશાખ	ʋ ə ɪ ʃ ɑ kʰ
વૈષ્ણવ	ʋ ə ɪ ʃ ɳ ə ʋ
વોટ્સએપ	ʋ o ʈ s ə eː p
વોડકા	ʋ o ɖ k ɑ
વોલરસ	ʋ o l ɾ ə s
વ્યાકરણ	ʋ j ɑ k ɾ ə ɳ
શ	ʃ ə
શંખ	ʃ ə ŋ kʰ
શકર	ʃ ə k ə ɾ
શક્તિ	ʃ ə k t̪ ɪ
શખ્સ	ʃ ə kʰ s
શતપદ	ʃ ə t̪ p ə d̪
શતાબ્દી	ʃ ə t̪ ɑ b d̪ i
શનિ	ʃ ə n ɪ
શનિવાર	ʃ ə n ɪ ʋ ɑ ɾ
શબિસ્તાન	ʃ ə b ɪ s t̪ ɑ n
શબ્દ	ʃ ə b d̪
શબ્દકોશ	ʃ ə b d̪ ə k o ʃ
શરણાઈ	ʃ ə ɾ ɳ ɑ i
શરદ	ʃ ə ɾ ə d̪
શરબત	ʃ ə ɾ b ə t̪
શરિયત	ʃ ə ɾ ɪ j ə t̪
શરીફ	ʃ ə ɾ i pʰ
શરૂ	ʃ ə ɾ u
શશી	ʃ ə ʃ i
શહેર	ʃ əʱ ɛ ɾ
શહેર	ʃ ɛ̤ ɾ
શાંત	ʃ ɑ n t̪
શાંતિ	ʃ ɑ n t̪ ɪ
શાક	ɦ ɑ k
શાક	ʃ ɑ k
શાકભાજી	ʃ ɑ k bʱ ɑ d͡ʒ i
શાક્યમુનિ	ʃ ɑ k j ə m u n ɪ
શાને	ʃ ɑ n eː
શામ	ʃ ɑ m
શામિયાનો	ʃ ɑ m ɪ j ɑ n o
શાલ	ʃ ɑ l
શાહજાદી	ʃ ɑʱ d͡ʒ ɑ d̪ i
શાહનામું	ʃ ɑʱ n ɑ m ũ
શિક્ષક	ʃ ɪ k ʃ ə k
શિયાળ	ʃ ɪ j ɑ ɭ
શિયાળો	ʃ ɪ j ɑ ɭ ɔ
શિશિર	ʃ ɪ ʃ ɪ ɾ
શિશુ	ʃ ɪ ʃ u
શિશુમાર	ʃ ɪ ʃ u m ɑ ɾ
શિશ્ન	ʃ ɪ ʃ n ə
શીખ	ʃ i kʰ
શીતયુદ્ધ	ʃ i t̪ j u d̪ d̪ʱ
શીતલ	ʃ i t̪ ə l
શીરીન	ʃ i ɾ i n
શુક્ર	ʃ u k ɾ ə
શુક્રવાર	ʃ u k ɾ ə ʋ ɑ ɾ
શુક્રિયા	ʃ u k ɾ ɪ j ɑ
શૂન્ય	ʃ u n j ə
શૂરસેન	ʃ u ɾ s eː n
શેકવું	ʃ eː k ʋ ũ
શેતૂર	ʃ eː t̪ u ɾ
શૈવ	ʃ ə ɪ ʋ
શોધવું	ʃ o d̪ʱ ʋ ũ
શ્યામ	ʃ j ɑ m
શ્રાવણ	ʃ ɾ ɑ ʋ ə ɳ
શ્રી	ʃ ɾ i
શ્રીનગર	ʃ ɾ i n ə ɡ ə ɾ
શ્રીલંકા	ʃ ɾ i l ə ŋ k ɑ
શ્વાસ	ʃ ʋ ɑ s
ષ	ʃ ə
સ	s ə
સંગમ	s ə ŋ ɡ ə m
સંગીત	s ə ŋ ɡ i t̪
સંઘર્ષ	s ə ŋ ɡʱ ə ɾ ʂ
સંજાણ	s ə ɲ d͡ʒ ɑ ɳ
સંતરું	s ə n t̪ ɾ ũ
સંતરું	ɦ ə n t̪ ɾ ũ
સંદેશો	s ə n d̪ eː ʃ o
સંસ્કૃતિ	s ə n s k ɾ u t̪ ɪ
સંસ્મરણ	s ã s m ə ɾ ə ɳ
સગડી	s ə ɡ ɖ i
સડક	s ə ɽ ə k
સત્તર	s ə t t ə r
સત્યાગ્રહ	s ə t̪ j ɑ ɡ ɾ əʱ
સપ્ટેમ્બર	s ə p ʈ eː m b ə ɾ
સપ્તાહ	s ə p t̪ ɑʱ
સફર	s ə pʰ ə ɾ
સફરજન	s ə pʰ ə ɾ d͡ʒ ə n
સબજી	s ə b d͡ʒ i
સમજવું	s ə m ə d͡ʒ ʋ ũ
સમય	s ə m j ə
સમરકંદ	s ə m ə ɾ k ə n d̪
સમાચાર	s ə m ɑ t͡ʃ ɑ ɾ
સમાજ	s ə m ɑ d͡ʒ
સમીર	s ə m i ɾ
સમુદ્ર	s ə m u d̪ ɾ ə
સરકાર	s ə ɾ k ɑ ɾ
સરગ	s ə ɾ ə ɡ
સરગી	s ə ɾ ɡ i
સરતાણ	s ə ɾ t̪ ɑ ɳ
સરસ્વતી	s ə ɾ ə s ʋ ə t̪ i
સરસ્વતીચંદ્ર	s ə ɾ ə s ʋ ə t̪ i t͡ʃ ə n d̪ ɾ ə
સરિતા	s ə ɾ ɪ t̪ ɑ
સરોશ	s ə ɾ o ʃ
સર્વહારા	s ə ɾ ʋ ə ɦ ɑ ɾ ɑ
સર્વોદય	s ə ɾ ʋ o d̪ j ə
સલગમ	s ə l ɡ ə m
સલાત	s ə l ɑ t̪
સલામ	s ə l ɑ m
સલાહ	s ə l ɑʱ
સલાહકાર	s ə l ɑʱ k ɑ ɾ
સલ્તનત	s ə l t̪ ə n ə t̪
સવાર	s ə ʋ ɑ ɾ
સસરો	s ə s ɾ ɔ
સસલું	s ə s l ũ
સસો	s ə s ɔ
સસ્તું	s ə s t̪ ũ
સહર	s ə ɦ ə ɾ
સહરા	s əʱ ɾ ɑ
સહિયર	s ə ɦ ɪ j ə ɾ
સહી	s ə ɦ i
સાંકડું	s ɑ̃ k ɖ ũ
સાંજ	s ɑ ɲ d͡ʒ
સાગર	s ɑ ɡ ə ɾ
સાડા	s ɑ ɽ ɑ
સાડી	s ɑ ɖ i
સાત	s ɑ t
સાત	ɦ ɑ t
સાપ	s ɑ p
સાફ	s ɑ f
સાફ	s ɑ pʰ
સાબુ	s ɑ b u
સામળું	s ɑ m ə ɭ ũ
સામાન	s ɑ m ɑ n
સામેલ	s ɑ m eː l
સામ્યવાદ	s ɑ m j ə ʋ ɑ d̪
સારું	s ɑ ɾ ũ
સારું	ɦ ɑ ɾ ũ
સાળી	s ɑ ɭ i
સાળો	s ɑ ɭ ɔ
સાવધાન	s ɑ ʋ d̪ʱ ɑ n
સાસ	s ɑ s
સાસુ	s ɑ s u
સાહ	s ɑʱ
સાહિત્ય	s ɑ ɦ ɪ t̪ j ə
સાહિલ	s ɑ ɦ ɪ l
સાહેબ	s ɑ ɦ eː b
સિંદૂર	s ɪ n d̪ u ɾ
સિંધ	s ɪ n d̪ʱ
સિંધુ	s ɪ n d̪ʱ u
સિંધુદેશ	s ɪ n d̪ʱ u d̪ eː ʃ
સિંહ	s ĩ ɦ
સિંહ	ʃ ĩ ɦ
સિંહણ	s ĩ ɦ ə ɳ
સિંહલ	s ĩ ɦ ə l
સિગારેટ	s ɪ ɡ ɑ ɾ eː ʈ
સિજદો	s ɪ d͡ʒ d̪ o
સિતારો	s ɪ t̪ ɑ ɾ ɔ
સિયામ	s ɪ j ɑ m
સિરાત	s ɪ ɾ ɑ t̪
સીડી	s i ɖ i
સીતા	s i t̪ ɑ
સીતાફળ	s i t̪ ɑ pʰ ə ɭ
સીદી	s i d̪ i
સીનેગોગ	s i n eː ɡ o ɡ
સીપ	s i p
સીમલા	s i m l ɑ
સુંદરતા	s u n d̪ ə ɾ t̪ ɑ
સુંદરવન	s u n d̪ ə ɾ ʋ ə n
સુકરાત	s u k ɾ ɑ t̪
સુણવું	s u ɳ ʋ ũ
સુન્નત	s u n n ə t̪
સુરત	s u ɾ ə t̪
સુરમ્ય	s u ɾ ə m j ə
સુરીલું	s u ɾ i l ũ
સુરેશ	s u ɾ eː ʃ
સુલતાન	s u l t̪ ɑ n
સૂફી	s u pʰ i
સૂરજ	s u ɾ ə d͡ʒ
સૂરજમુખી	s u ɾ ə d͡ʒ m u kʰ i
સૂર્ય	s u ɾ j ə
સૂવર	s u ʋ ə ɾ
સેંથી	s eː n t̪ʰ i
સેતાન	s eː t̪ ɑ n
સેબ	s eː b
સૈનિક	s ə ɪ n ɪ k
સો	s ɔ
સોણું	s ɔ ɳ ũ
સોનું	s o n ũ
સોપારી	s o p ɑ ɾ i
સોમ	s o m
સોમવાર	s o m ʋ ɑ ɾ
સોળ	s ɔ ɭ
સોવિયેટ	s o ʋ ɪ j eː ʈ
સોહલું	s oʱ l ũ
સ્કૂલ	s k u l
સ્ટાલિન	s ʈ ɑ l ɪ n
સ્તૂપ	s t̪ u p
સ્ત્રી	s t̪ ɾ i
સ્ત્રીલિંગ	s t̪ ɾ i l ɪ ŋ ɡ
સ્થાપત્ય	s t̪ʰ ɑ p ə t̪ j ə
સ્નેહ	s n eː ɦ ə
સ્પેન	s p eː n
સ્મરણ	s m ə ɾ ə ɳ
સ્વપ્ન	s ʋ ə p n ə
સ્વર્ગ	s ʋ ə ɾ ɡ
સ્વસ્તિક	s ʋ ə s t̪ ɪ k
સ્વાગત	s ʋ ɑ ɡ ə t̪
સ્વામી	s ʋ ɑ m i
સ્વાહીલી	s ʋ ɑ ɦ i l i
સ્વેટર	s ʋ eː ʈ ə ɾ
હ	ɦ ə
હંમેશાં	ɦ ə m m eː ʃ ɑ̃
હંસ	ɦ ə n s
હકીમ	ɦ ə k i m
હજ	ɦ ə d͡ʒ
હજી	ɦ ə d͡ʒ i
હદીસ	ɦ ə d̪ i s
હનુમાન	ɦ ə n u m ɑ n
હપતો	ɦ ə p t̪ o
હબશી	ɦ ə b ʃ i
હમામ	ɦ ə m ɑ m
હયા	ɦ ə j ɑ
હયાત	ɦ ə j ɑ t̪
હરણ	ɦ ə ɾ ə ɳ
હરિકેન	ɦ ə ɾ ɪ k eː n
હરિજન	ɦ ə ɾ ɪ d͡ʒ ə n
હલવો	ɦ ə l ʋ o
હલાલ	ɦ ə l ɑ l
હળ	ɦ ə ɭ
હવા	ɦ ə ʋ ɑ
હવેલી	ɦ ə ʋ eː l i
હસવું	ɦ ə s ʋ ũ
હા	ɦ ɑ
હાં	ɦ ɑ̃
હાંડવો	ɦ ɑ̃ ɖ ʋ o
હાઇકુ	ɦ ɑ ɪ k u
હાજરી	ɦ ɑ d͡ʒ ɾ i
હાજી	ɦ ɑ d͡ʒ i
હાટ	ɦ ɑ ʈ
હાથી	ɦ ɑ t̪ʰ i
હાર્ટ	ɦ ɑ ɾ ʈ
હાલવું	ɦ ɑ l ʋ ũ
હિંદી	ɦ ɪ n d̪ i
હિંદુ	ɦ ɪ n d̪ u
હિંદુકુશ	ɦ ɪ n d̪ u k u ʃ
હિંદુત્વ	ɦ ɪ n d̪ u t̪ ʋ ə
હિંદુસ્તાન	ɦ ɪ n d̪ u s t̪ ɑ n
હિમ	ɦ ɪ m
હીજડો	ɦ i d͡ʒ ɽ ɔ
હીરો	ɦ i ɾ ɔ
હું	ɦ ũ
હુકમ	ɦ u k ə m
હુક્કો	ɦ u k k o
હુમત	ɦ u m ə t̪
હૃ	ɦ ɾ ʊ
હૃદય	ɾ ə d̪ ə j
હેમંત	ɦ eː m ə n t̪
હેરાન	ɦ eː ɾ ɑ n
હેલો	ɦ eː l o
હૈદરાબાદ	ɦ ə ɪ d̪ ɾ ɑ b ɑ d̪
હૈયું	ɦ ə ɪ j ũ
હોટેલ	ɦ o ʈ eː l
હોઠ	ɦ o ʈʰ
હોળી	o̤ ɭ i
હોળી	ɦ o ɭ i
હોવું	ɦ o ʋ ũ
હોસ્પિટલ	ɦ o s p ɪ ʈ ə l
