अ	ə
अं	ə m
अंक	ə ŋ k ə
अंकगणित	ə ŋ k ə ɡ ə ɳ i t̪
अंग	ə ŋ ɡ ə
अंगठा	ə ŋ ɡ ʈʰ a
अंगण	ə ŋ ɡ ə ɳ
अंगरखा	ə ŋ ɡ ə ɾ kʰ a
अंडे	ə ɳ ɖ e
अंडे	ə ɳ ɖ ə
अंथरूण	ə n t̪ʰ ɾ u ɳ
अंदाज	ə n d̪ a d͡z
अंदाजे	ə n d̪ a d͡z e
अंबाडा	ə m b a ɖ a
अंबाडे	ə m b a ɖ e
अंबाडे	ə m b a ɖ ə
अंबिग	ə m b i ɡ
अंबी	ə m b i
अंबु	ə m b u
अंबेकरी	ə m b e k ɾ i
अंबोळी	ə m b o ɭ̆ i
अः	ə̤
अकथित	ə k t̪ʰ i t̪
अकरा	ə k ɾ a
अक्कल	ə k k ə l
अक्का	ə k k a
अखबार	ə kʰ b a ɾ
अख्खे	ə k kʰ e
अख्खे	ə k kʰ ə
अगद	ə ɡ ə d̪
अग्नि	ə ɡ n i
अजगर	ə d͡ʑ ɡ ə ɾ
अजिबात	ə d͡ʑ i b a t̪
अजून	ə d͡z u n
अझरबैजान	ə d͡zʱ ə ɾ b ə i d͡ʑ a n
अट	ə ʈ
अटकळ	ə ʈ k ə ɭ̆
अठरा	ə ʈʰ ɾ a
अठ्ठावीस	ə ʈ ʈʰ a ʋ i s
अठ्ठेचाळीस	ə ʈ ʈʰ e t͡ɕ a ɭ̆ i s
अडणे	ə ɖ ɳ e
अडणे	ə ɖ ɳ ə
अडतीस	ə ɖ ə t̪ i s
अडाणी	ə ɖ a ɳ i
अणू	ə ɳ u
अण्णा	ə ɳ ɳ a
अत्तर	ə t̪ t̪ ə ɾ
अधातू	ə d̪ʱ a t̪ u
अधिकृत	ə d̪ʱ i k ɾ u t̪
अननस	ə n & kʰ 2 A ; n ə s
अनादर	ə n a d̪ ə ɾ
अनुभवणे	ə n u bʱ ə ʋ ɳ e
अनुभवणे	ə n u bʱ ə ʋ ɳ ə
अनेक	ə n e k
अपंग	ə p ə ŋ ɡ ə
अपघात	ə p ɡʱ a t̪
अपमान	ə p m a n
अपुन	ə p u n
अफगाणिस्तान	ə pʰ ɡ a ɳ i s t̪ a n
अबीर	ə b i ɾ
अब्ज	ə b d͡ʑ ə
अब्दुल्ला	ə b d̪ u l l a
अभिक्रिया	ə bʱ i k ɾ i j a
अभिनय	ə bʱ i n ə j
अभिनेता	ə bʱ i n e t̪ a
अभिनेत्री	ə bʱ i n e t̪ ɾ i
अभिषेक	ə bʱ i ʂ e k
अभ्यास	ə bʱ j a s
अभ्यासक्रम	ə bʱ j a s ə k ɾ ə m
अमरावती	ə m ɾ a ʋ ə t̪ i
अयना	ə j n a
अरुंद	ə ɾ u n d̪ ə
अर्थ	ə ɾ t̪ʰ ə
अल्लड	ə l l ə ɖ
अवकाश	ə ʋ k a ɕ
अवघड	ə ʋ ɡʱ ə ɖ
अश्रु	ə ɕ ɾ u
असे	ə s e
असे	ə s ə
अहमदनगर	ə ɦ m ə d̪ n ə ɡ ə ɾ
अहमदाबाद	ə ɦ m ə d̪ a b a d̪
आ	a
आंघोळ	a ŋ ɡʱ o ɭ̆
आंधळे	a n d̪ʱ ə ɭ̆ e
आंधळे	a n d̪ʱ ə ɭ̆ ə
आंबट	a m b ə ʈ
आंबा	a m b a
आई	a i
आकडा	a k ɖ a
आकाश	a k a ɕ
आकाशगंगा	a k a ɕ ɡ ə ŋ ɡ a
आकाशी	a k a ɕ i
आकृती	a k ɾ u t̪ i
आक्का	a k k a
आखणे	a kʰ ɳ e
आखणे	a kʰ ɳ ə
आग	a ɡ
आगगाडी	a ɡ ɡ a ɖ i
आगाऊ	a ɡ a u
आग्नेय	a ɡ n e j ə
आग्रा	a ɡ ɾ a
आचार्य	a t͡ɕ a ɾ j ə
आज	a d͡z
आजकाल	a d͡z k a l
आजमावणे	a d͡z m a ʋ ɳ e
आजमावणे	a d͡z m a ʋ ɳ ə
आजार	a d͡z a ɾ
आजारी	a d͡z a ɾ i
आजी	a d͡ʑ i
आजोबा	a d͡z o b a
आठ	a ʈʰ
आठवडा	a ʈʰ ə ʋ ɖ a
आठवण	a ʈʰ ʋ ə ɳ
आठवणे	a ʈʰ ə ʋ ɳ e
आठवणे	a ʈʰ ə ʋ ɳ ə
आठवे	a ʈʰ ʋ e
आठवे	a ʈʰ ʋ ə
आढळणे	a ɖʱ ə ɭ̆ ɳ e
आढळणे	a ɖʱ ə ɭ̆ ɳ ə
आण	a ɳ
आणि	a ɳ i
आणीबाणी	a ɳ i b a ɳ i
आता	a t̪ a
आत्महत्या	a t̪ m ə ɦ ə t̪ j a
आदर	a d̪ ə ɾ
आदर्श	a d̪ ə ɾ ɕ ə
आधी	a d̪ʱ i
आनंद	a n ə n d̪ ə
आनंददायी	a n ə n d̪ d̪ a j i
आपण	a p ə ɳ
आफ्रिका	a pʰ ɾ i k a
आभाळ	a bʱ a ɭ̆
आमटी	a m ʈ i
आम्ल	a m l ə
आम्ले	a m l e
आम्ले	a m l ə
आम्ही	a mʱ i
आयते	a j t̪ e
आयते	a j t̪ ə
आयुष्य	a j u ʂ j ə
आयुष्ये	a j u ʂ j e
आयुष्ये	a j u ʂ j ə
आर	a ɾ
आरसा	a ɾ s a
आर्मेनिया	a ɾ m e n i j a
आलिंगन	a l i ŋ ɡ ə n
आळवणे	a ɭ̆ ə ʋ ɳ e
आळवणे	a ɭ̆ ə ʋ ɳ ə
आळशी	a ɭ̆ ɕ i
आळशीपणा	a ɭ̆ ɕ i p ə ɳ a
आळस	a ɭ̆ ə s
आवड	a ʋ ə ɖ
आवडणे	a ʋ ə ɖ ɳ e
आवाज	a ʋ a d͡z
आवृत्ती	a ʋ ɾ u t̪ t̪ i
आशा	a ɕ a
आशावाद	a ɕ a ʋ a d̪
आस	a s
आसाम	a s a m
आसामी	a s a m i
आसू	a s u
आस्तिक	a s t̪ i k
आस्तिकता	a s t̪ i k t̪ a
आस्मानी	a s m a n i
इ	i
इंगलंड	i ŋ ɡ l ə ɳ ɖ
इंग्रजी	i ŋ ɡ ɾ ə d͡ʑ i
इंग्लंड	i ŋ ɡ l ə ɳ ɖ ə
इंडोनेशिया	i ɳ ɖ o n e ɕ i j a
इंदूर	i n d̪ u ɾ
इंद्रधनुष्य	i n d̪ ɾ ə d̪ʱ n u ʂ j ə
इकडे	i k ɖ e
इकडे	i k ɖ ə
इजिप्त	i d͡ʑ i p t̪ ə
इतर	i t̪ ə ɾ
इतिहास	i t̪ i ɦ a s
इथे	i t̪ʰ e
इथे	i t̪ʰ ə
इमान	i m a n
इराक	i ɾ a k
इराण	i ɾ a ɳ
इलाज	i l a d͡z
इशारा	i ɕ a ɾ a
इसम	i s ə m
इस्पिक	i s p i k
इस्राइल	i s ɾ a i l
इस्रायल	i s ɾ a j ə l
इस्लाम	i s l a m
ई	iː
ईशान्य	i ɕ a n j ə
उ	u
उंच	u n t͡s ə
उंची	u n t͡ɕ i
उंच्या	u n t͡ɕ j a
उंट	u ɳ ʈ ə
उंबरठा	u m b ə ɾ ʈʰ a
उकरणे	u k ə ɾ ɳ e
उकरणे	u k ə ɾ ɳ ə
उकिरडा	u k i ɾ ɖ a
उखाणा	u kʰ a ɳ a
उगारणे	u ɡ a ɾ ɳ e
उगारणे	u ɡ a ɾ ɳ ə
उघडणे	u ɡʱ ə ɖ ɳ e
उघडणे	u ɡʱ ə ɖ ɳ ə
उच्चार	u t͡ɕ t͡ɕ a ɾ
उच्चारणे	u t͡ɕ t͡ɕ a ɾ ɳ e
उच्चारणे	u t͡ɕ t͡ɕ a ɾ ɳ ə
उजळणे	u d͡z ə ɭ̆ ɳ e
उजळणे	u d͡z ə ɭ̆ ɳ ə
उजवे	u d͡z ʋ e
उजवे	u d͡z ʋ ə
उजेड	u d͡ʑ e ɖ
उझबेकिस्तान	u d͡ʑʱ b e k i s t̪ a n
उटणे	u ʈ ɳ e
उटणे	u ʈ ɳ ə
उठणे	u ʈʰ ɳ e
उठणे	u ʈʰ ɳ ə
उठवणे	u ʈʰ ə ʋ ɳ e
उठवणे	u ʈʰ ə ʋ ɳ ə
उडणे	u ɖ ɳ e
उडणे	u ɖ ɳ ə
उड्डाण	u ɖ ɖ a ɳ
उणे	u ɳ e
उणे	u ɳ ə
उतरणे	u t̪ ə ɾ ɳ e
उतरणे	u t̪ ə ɾ ɳ ə
उतार	u t̪ a ɾ
उत्कंठावर्धक	u t̪ k ə ɳ ʈʰ a ʋ ə ɾ d̪ʱ ə k
उत्कृष्ट	u t̪ k ɾ u ʂ ʈ ə
उत्क्रांती	u t̪ k ɾ a n t̪ i
उत्तर	u t̪ t̪ ə ɾ
उत्पन्न	u t̪ p ə n n ə
उत्सव	u t̪ s ə ʋ
उत्साह	u t̪ s a ɦ ə
उत्साही	u t̪ s a ɦ i
उथळ	u t̪ʰ ə ɭ̆
उदजन	u d̪ d͡ʑ ə n
उदय	u d̪ ə j
उदास	u d̪ a s
उदाहरण	u d̪ a ɦ ɾ ə ɳ
उद्योग	u d̪ j o ɡ
उधई	u d̪ʱ ə i
उधळणे	u d̪ʱ ə ɭ̆ ɳ e
उधळणे	u d̪ʱ ə ɭ̆ ɳ ə
उधेल	u d̪ʱ e l
उनाड	u n a ɖ
उन्हाळा	u nʱ a ɭ̆ a
उपचार	u p t͡ɕ a ɾ
उपनिषद	u p n i ʂ ə d̪
उपनिषद्	u p n i ʂ ə d̪
उमजणे	u m ə d͡z ɳ e
उमजणे	u m ə d͡z ɳ ə
उमटणे	u m ə ʈ ɳ e
उमटणे	u m ə ʈ ɳ ə
उमदे	u m d̪ e
उमदे	u m d̪ ə
उमलणे	u m ə l ɳ e
उमलणे	u m ə l ɳ ə
उमेद	u m e d̪
उरणे	u ɾ ɳ e
उरणे	u ɾ ɳ ə
उर्दू	u ɾ d̪ u
उल्हास	u lʱ a s
उल्हासनगर	u lʱ a s n ə ɡ ə ɾ
उशी	u ɕ i
उश्या	u ɕ j a
उष्टे	u ʂ ʈ e
उष्टे	u ʂ ʈ ə
उसळणे	u s ə ɭ̆ ɳ e
उसळणे	u s ə ɭ̆ ɳ ə
उस्मानाबाद	u s m a n a b a d̪
ऊ	u
ऊदबत्ती	u d̪ b ə t̪ t̪ i
ऊर्जा	u ɾ d͡ʑ a
ऋ	ɾ u
ऋण	ɾ u ɳ
ऋतू	ɾ u t̪ u
ए	e
एक	e k
एकटा	e k ʈ a
एकत्र	e k ə t̪ ɾ ə
एकदा	e k d̪ a
एकवीस	e k ʋ i s
एकी	e k i
एकेचाळीस	e k e t͡ɕ a ɭ̆ i s
एकोणचाळीस	e k o ɳ t͡ɕ a ɭ̆ i s
एकोणतीस	e k o ɳ t̪ i s
एकोणपन्नास	e k o ɳ p ə n n a s
एकोणीस	e k o ɳ i s
एडमंटन	e ɖ m ə ɳ ʈ ə n
एप्रिल	e p ɾ i l
एस्टोनिया	e s ʈ o n i j a
ऐ	ə i
ऐंशी	ə i u ɕ i
ऐकणे	ə i k ɳ e
ऐकणे	ə i k ɳ ə
ऐक्य	ə i k j ə
ऑ	ɔ
ऑक्टोबर	ɔ k ʈ o b ə ɾ
ऑगस्ट	ɔ ɡ ə s ʈ ə
ओ	o
ओंगळ	o ŋ ɡ ə ɭ̆
ओंजळ	o n d͡z ə ɭ̆
ओघ	o ɡʱ
ओझरते	o d͡zʱ ə ɾ t̪ e
ओझरते	o d͡zʱ ə ɾ t̪ ə
ओटा	o ʈ a
ओढणे	o ɖʱ ɳ e
ओढणे	o ɖʱ ɳ ə
ओतणे	o t̪ ɳ e
ओतणे	o t̪ ɳ ə
ओथंबणे	o t̪ʰ ə m b ə ɳ e
ओथंबणे	o t̪ʰ ə m b ə ɳ ə
ओमान	o m a n
ओरपणे	o ɾ ə p ɳ e
ओरपणे	o ɾ ə p ɳ ə
ओलांडणे	o l a ɳ ɖ ə ɳ e
ओलांडणे	o l a ɳ ɖ ə ɳ ə
ओळ	o ɭ̆
ओळखणे	o ɭ̆ ə kʰ ɳ e
ओळखणे	o ɭ̆ ə kʰ ɳ ə
ओवा	o ʋ a
ओसंडणे	o s ə ɳ ɖ ə ɳ e
ओसंडणे	o s ə ɳ ɖ ə ɳ ə
ओसरणे	o s ə ɾ ɳ e
ओसरणे	o s ə ɾ ɳ ə
ओहायो	o ɦ a j o
औ	ə u
औरंगाबाद	ə u ɾ ə ŋ ɡ a b a d̪
औषध	ə u ʂ ə d̪ʱ
क	k ə
कंत्राट	k ə n t̪ ɾ a ʈ
कंत्राटदार	k ə n t̪ ɾ a ʈ d̪ a ɾ
कंदील	k ə n d̪ i l
कंबर	k ə m b ə ɾ
कचरा	k ə t͡s ɾ a
कचेरी	k ə t͡ɕ e ɾ i
कटि	k ə ʈ i
कट्यार	k ə ʈ j a ɾ
कठीण	k ə ʈʰ i ɳ
कडू	k ə ɖ u
कढी	k ə ɖʱ i
कण	k ə ɳ
कतार	k ə t̪ a ɾ
कत्तल	k ə t̪ t̪ ə l
कथा	k ə t̪ʰ a
कदाचित	k ə d̪ a t͡ɕ i t̪
कन्नड	k ə n n ə ɖ
कपडा	k ə p ɖ a
कपाट	k ə p a ʈ
कपाटे	k ə p a ʈ e
कपाटे	k ə p a ʈ ə
कपाळ	k ə p a ɭ̆
कपाळे	k ə p a ɭ̆ e
कपाळे	k ə p a ɭ̆ ə
कपोत	k ə p o t̪
कबुतर	k ə b u t̪ ə ɾ
कबूतर	k ə b u t̪ ə ɾ
कमळ	k ə m ə ɭ̆
कमाल	k ə m a l
कमी	k ə m i
करणे	k ə ɾ ɳ e
करणे	k ə ɾ ɳ ə
कराची	k ə ɾ a t͡ɕ i
करुणा	k ə ɾ u ɳ a
कर्क	k ə ɾ k ə
कर्तव्य	k ə ɾ t̪ ə ʋ j ə
कर्तृत्व	k ə ɾ t̪ ɾ u t̪ ʋ ə
कर्बोदक	k ə ɾ b o d̪ ə k
कर्बोदके	k ə ɾ b o d̪ k e
कर्बोदके	k ə ɾ b o d̪ k ə
कर्म	k ə ɾ m ə
कला	k ə l a
कलाकार	k ə l a k a ɾ
कलिंगड	k ə l i ŋ ɡ ə ɖ
कलिंगडे	k ə l i ŋ ɡ ɖ e
कल्लोळ	k ə l l o ɭ̆
कळणे	k ə ɭ̆ ɳ e
कळणे	k ə ɭ̆ ɳ ə
कळशी	k ə ɭ̆ ɕ i
कळी	k ə ɭ̆ i
कळ्या	k ə ɭ̆ j a
कवयित्री	k ə ʋ j i t̪ ɾ i
कवाईत	k ə ʋ a i t̪
कवि	k ə ʋ i
कविता	k ə ʋ i t̪ a
कवी	k ə ʋ i
कष्ट	k ə ʂ ʈ ə
कसे	k ə s e
कसे	k ə s ə
कसोटी	k ə s o ʈ i
कहाणी	k ə ɦ a ɳ i
का	k a
कांदा	k a n d̪ a
काका	k a k a
काकू	k a k u
कागद	k a ɡ ə d̪
काच	k a t͡s
काजळ	k a d͡z ə ɭ̆
काजवा	k a d͡z ʋ a
काठ	k a ʈʰ
काठी	k a ʈʰ i
काठ्या	k a ʈʰ j a
काढणे	k a ɖʱ ɳ e
काढणे	k a ɖʱ ɳ ə
काढा	k a ɖʱ a
कात्री	k a t̪ ɾ i
कान	k a n
कानपूर	k a n p u ɾ
कापड	k a p ə ɖ
कापडे	k a p ɖ e
कापडे	k a p ɖ ə
कापणे	k a p ɳ e
कापणे	k a p ɳ ə
कापूर	k a p u ɾ
कापूस	k a p u s
काफी	k a pʰ i
काम	k a m
कामगार	k a m ɡ a ɾ
काय	k a j
कायदा	k a j d̪ a
कायम	k a j ə m
कारखाना	k a ɾ kʰ a n a
कारण	k a ɾ ə ɳ
कारणे	k a ɾ ɳ e
कारणे	k a ɾ ɳ ə
कारले	k a ɾ l e
कारले	k a ɾ l ə
कारागीर	k a ɾ a ɡ i ɾ
कार्यक्रम	k a ɾ j ə k ɾ ə m
काल	k a l
काळ	k a ɭ̆
काळजी	k a ɭ̆ d͡ʑ i
काळवीट	k a ɭ̆ ʋ i ʈ
काळा	k a ɭ̆ a
काळीज	k a ɭ̆ i d͡z
काळे	k a ɭ̆ e
कावळा	k a ʋ ɭ̆ a
काव्य	k a ʋ j ə
काव्ये	k a ʋ j e
काव्ये	k a ʋ j ə
कासव	k a s ə ʋ
काही	k a ɦ i
किंमत	k i m m ə t̪
किंवा	k i u ʋ a
किडा	k i ɖ a
किडे	k i ɖ e
किडे	k i ɖ ə
किनारा	k i n a ɾ a
किमान	k i m a n
किरण	k i ɾ ə ɳ
किल्ला	k i l l a
किल्ली	k i l l i
किल्ल्या	k i l l j a
किल्वर	k i l ʋ ə ɾ
किवडा	k i ʋ ɖ a
की	k i
कीबोर्ड	k i b o ɾ ɖ ə
कीव	k i ʋ
कुंकू	k u ŋ k u
कुंकूं	k u ŋ k ũ
कुंभ	k u m bʱ ə
कुंभार	k u m bʱ a ɾ
कुटुंब	k u ʈ u m b ə
कुठे	k u ʈʰ e
कुतूहल	k u t̪ u ɦ ə l
कुत्रा	k u t̪ ɾ a
कुराण	k u ɾ a ɳ
कुऱ्हाड	k u ɾʱ a ɖ
कुलकर्णी	k u l k ə ɾ ɳ i
कुलपे	k u l p e
कुलपे	k u l p ə
कुलुपे	k u l u p e
कुलुपे	k u l u p ə
कुलूप	k u l u p
कुवेत	k u ʋ e t̪
केंद्र	k e n d̪ ɾ ə
केरळ	k e ɾ ə ɭ̆
केळं	k e ɭ̆ ə
केळे	k e ɭ̆ e
केळे	k e ɭ̆ ə
केशर	k e ɕ ə ɾ
केशरी	k e ɕ ɾ i
केस	k e s
कोकण	k o k ə ɳ
कोची	k o t͡ɕ i
कोटी	k o ʈ i
कोड	k o ɖ
कोडे	k o ɖ e
कोडे	k o ɖ ə
कोण	k o ɳ
कोणते	k o ɳ t̪ e
कोय	k o j
कोयता	k o j t̪ a
कोयती	k o j t̪ i
कोरणे	k o ɾ ɳ e
कोरणे	k o ɾ ɳ ə
कोरे	k o ɾ e
कोरे	k o ɾ ə
कोल	k o l
कोलकाता	k o l k a t̪ a
कोल्हापूर	k o lʱ a p u ɾ
कोळसा	k o ɭ̆ s a
कोवळे	k o ʋ ɭ̆ e
कोवळे	k o ʋ ɭ̆ ə
कोशिंबीर	k o ɕ i m b i ɾ
कोशीस	k o ɕ i s
क्रांती	k ɾ a n t̪ i
क्रूस	k ɾ u s
क्ष	k ʂ ə
क्षण	k ʂ ə ɳ
क्षार	k ʂ a ɾ
क्षितिज	k ʂ i t̪ i d͡ʑ
क्षुल्लक	k ʂ u l l ə k
ख	kʰ ə
खचणे	kʰ ə t͡s ɳ e
खचणे	kʰ ə t͡s ɳ ə
खजूर	kʰ ə d͡z u ɾ
खटला	kʰ ə ʈ l a
खडू	kʰ ə ɖ u
खड्डा	kʰ ə ɖ ɖ a
खणणे	kʰ ə ɳ ɳ e
खणणे	kʰ ə ɳ ɳ ə
खत्रप	kʰ ə t̪ ɾ ə p
खदखदा	kʰ ə d̪ kʰ ə d̪ a
खपणे	kʰ ə p ɳ e
खपणे	kʰ ə p ɳ ə
खबर	kʰ ə b ə ɾ
खरे	kʰ ə ɾ e
खरे	kʰ ə ɾ ə
खरेदी	kʰ ə ɾ e d̪ i
खर्च	kʰ ə ɾ t͡s ə
खर्चणे	kʰ ə ɾ t͡s ə ɳ e
खर्चणे	kʰ ə ɾ t͡s ə ɳ ə
खलाशी	kʰ ə l a ɕ i
खांडणे	kʰ a ɳ ɖ ɳ e
खांडणे	kʰ a ɳ ɖ ɳ ə
खाऊ	kʰ a u
खाज	kʰ a d͡z
खाजगी	kʰ a d͡z ɡ i
खाजगीकरण	kʰ a d͡z ɡ i k ɾ ə ɳ
खाजणे	kʰ a d͡z ɳ e
खाजणे	kʰ a d͡z ɳ ə
खाजवणे	kʰ a d͡z ə ʋ ɳ e
खाजवणे	kʰ a d͡z ə ʋ ɳ ə
खाट	kʰ a ʈ
खाण	kʰ a ɳ
खाते	kʰ a t̪ e
खाते	kʰ a t̪ ə
खानदेश	kʰ a n d̪ e ɕ
खाना	kʰ a n a
खार	kʰ a ɾ
खारट	kʰ a ɾ ə ʈ
खाली	kʰ a l i
खास	kʰ a s
खिडकी	kʰ i ɖ k i
खिडक्या	kʰ i ɖ ə k j a
खिमा	kʰ i m a
खीर	kʰ i ɾ
खुजे	kʰ u d͡z e
खुजे	kʰ u d͡z ə
खुडणे	kʰ u ɖ ɳ e
खुडणे	kʰ u ɖ ɳ ə
खुद्द	kʰ u d̪ d̪ ə
खुर्ची	kʰ u ɾ t͡ɕ i
खुर्च्या	kʰ u ɾ t͡ɕ j a
खुळे	kʰ u ɭ̆ e
खुळे	kʰ u ɭ̆ ə
खुश	kʰ u ɕ
खूण	kʰ u ɳ
खून	kʰ u n
खेकडा	kʰ e k ɖ a
खेचणे	kʰ e t͡s ɳ e
खेचणे	kʰ e t͡s ɳ ə
खेडे	kʰ e ɖ e
खेडे	kʰ e ɖ ə
खेळणे	kʰ e ɭ̆ ɳ e
खेळणे	kʰ e ɭ̆ ɳ ə
खोचणे	kʰ o t͡s ɳ e
खोचणे	kʰ o t͡s ɳ ə
खोटे	kʰ o ʈ e
खोटे	kʰ o ʈ ə
खोडणे	kʰ o ɖ ɳ e
खोडणे	kʰ o ɖ ɳ ə
खोडरबर	kʰ o ɖ ə ɾ b ə ɾ
खोदणे	kʰ o d̪ ɳ e
खोदणे	kʰ o d̪ ɳ ə
ख्रिस्ती	kʰ ɾ i s t̪ i
ग	ɡ ə
गंधक	ɡ ə n d̪ʱ ə k
गंभीर	ɡ ə m bʱ i ɾ
गट	ɡ ə ʈ
गटार	ɡ ə ʈ a ɾ
गडबड	ɡ ə ɖ b ə ɖ
गडबडणे	ɡ ə ɖ b ə ɖ ɳ e
गडबडणे	ɡ ə ɖ b ə ɖ ɳ ə
गफलत	ɡ ə pʰ l ə t̪
गरज	ɡ ə ɾ ə d͡z
गरजणे	ɡ ə ɾ ə d͡z ɳ e
गरजणे	ɡ ə ɾ ə d͡z ɳ ə
गरीब	ɡ ə ɾ i b
गल्ली	ɡ ə l l i
गळणे	ɡ ə ɭ̆ ɳ e
गळणे	ɡ ə ɭ̆ ɳ ə
गळा	ɡ ə ɭ̆ a
गळे	ɡ ə ɭ̆ e
गळे	ɡ ə ɭ̆ ə
गवसणे	ɡ ə ʋ ə s ɳ e
गवसणे	ɡ ə ʋ ə s ɳ ə
गहिरे	ɡ ə ɦ i ɾ e
गहिरे	ɡ ə ɦ i ɾ ə
गहू	ɡ ə ɦ u
गांगरणे	ɡ a ŋ ɡ ə ɾ ɳ e
गांगरणे	ɡ a ŋ ɡ ə ɾ ɳ ə
गांड	ɡ a ɳ ɖ ə
गांडूळ	ɡ a ɳ ɖ u ɭ̆
गांभीर्य	ɡ a m bʱ i ɾ j ə
गाजणे	ɡ a d͡z ɳ e
गाजणे	ɡ a d͡z ɳ ə
गाजर	ɡ a d͡z ə ɾ
गाझियाबाद	ɡ a d͡zʱ i j a b a d̪
गाठ	ɡ a ʈʰ
गाठणे	ɡ a ʈʰ ɳ e
गाठणे	ɡ a ʈʰ ɳ ə
गाठोडे	ɡ a ʈʰ o ɖ e
गाठोडे	ɡ a ʈʰ o ɖ ə
गाढ	ɡ a ɖʱ
गाणे	ɡ a ɳ e
गाणे	ɡ a ɳ ə
गादी	ɡ a d̪ i
गाभा	ɡ a bʱ a
गाभारा	ɡ a bʱ a ɾ a
गाय	ɡ a j
गायक	ɡ a j ə k
गायिका	ɡ a j i k a
गार	ɡ a ɾ
गारुडी	ɡ a ɾ u ɖ i
गाल	ɡ a l
गिंडी	ɡ i ɳ ɖ i
गिधाड	ɡ i d̪ʱ a ɖ
गिळणे	ɡ i ɭ̆ ɳ e
गिळणे	ɡ i ɭ̆ ɳ ə
गुंतणे	ɡ u n t̪ ə ɳ e
गुंतणे	ɡ u n t̪ ə ɳ ə
गुंतवणे	ɡ u n t̪ ə ʋ ɳ e
गुंतवणे	ɡ u n t̪ ə ʋ ɳ ə
गुंफणे	ɡ u m pʰ ə ɳ e
गुंफणे	ɡ u m pʰ ə ɳ ə
गुज	ɡ u d͡z
गुजरात	ɡ u d͡z ɾ a t̪
गुजराती	ɡ u d͡z ɾ a t̪ i
गुढी	ɡ u ɖʱ i
गुण	ɡ u ɳ
गुणगुणणे	ɡ u ɳ ɡ u ɳ ɳ e
गुणगुणणे	ɡ u ɳ ɡ u ɳ ɳ ə
गुन्हा	ɡ u nʱ a
गुन्हेगार	ɡ u nʱ e ɡ a ɾ
गुरुवार	ɡ u ɾ u ʋ a ɾ
गुरू	ɡ u ɾ u
गुऱ्हाळ	ɡ u ɾʱ a ɭ̆
गुलाब	ɡ u l a b
गुलाबी	ɡ u l a b i
गुहा	ɡ u ɦ a
गूळ	ɡ u ɭ̆
गोंधळ	ɡ o n d̪ʱ ə ɭ̆
गोखले	ɡ o kʰ l e
गोठा	ɡ o ʈʰ a
गोड	ɡ o ɖ
गोडसे	ɡ o ɖ s e
गोणी	ɡ o ɳ i
गोफण	ɡ o pʰ ə ɳ
गोमांस	ɡ o m a u s ə
गोल	ɡ o l
गोष्ट	ɡ o ʂ ʈ ə
गोसावी	ɡ o s a ʋ i
ग्रंथ	ɡ ɾ ə n t̪ʰ ə
ग्रंथालय	ɡ ɾ ə n t̪ʰ a l ə j
ग्रह	ɡ ɾ ə ɦ ə
ग्वाल्हेर	ɡ ʋ a lʱ e ɾ
घ	ɡʱ ə
घटणे	ɡʱ ə ʈ ɳ e
घटणे	ɡʱ ə ʈ ɳ ə
घट्ट	ɡʱ ə ʈ ʈ ə
घट्टपणा	ɡʱ ə ʈ ʈ ə p ə ɳ a
घडणे	ɡʱ ə ɖ ɳ e
घडणे	ɡʱ ə ɖ ɳ ə
घड्याळ	ɡʱ ə ɖ j a ɭ̆
घड्याळे	ɡʱ ə ɖ j a ɭ̆ e
घड्याळे	ɡʱ ə ɖ j a ɭ̆ ə
घर	ɡʱ ə ɾ
घरं	ɡʱ ə ɾ ə
घरजावई	ɡʱ ə ɾ d͡z a ʋ ə i
घराणे	ɡʱ ə ɾ a ɳ e
घराणे	ɡʱ ə ɾ a ɳ ə
घरे	ɡʱ ə ɾ e
घरे	ɡʱ ə ɾ ə
घर्षण	ɡʱ ə ɾ ʂ ə ɳ
घाण	ɡʱ a ɳ
घाबरणे	ɡʱ a b ə ɾ ɳ e
घाबरणे	ɡʱ a b ə ɾ ɳ ə
घाम	ɡʱ a m
घार	ɡʱ a ɾ
घालणे	ɡʱ a l ɳ e
घालणे	ɡʱ a l ɳ ə
घासणे	ɡʱ a s ɳ e
घासणे	ɡʱ a s ɳ ə
घासलेट	ɡʱ a s l e ʈ
घुबड	ɡʱ u b ə ɖ
घुमट	ɡʱ u m ə ʈ
घुमणे	ɡʱ u m ɳ e
घुमणे	ɡʱ u m ɳ ə
घोष	ɡʱ o ʂ
घोषणा	ɡʱ o ʂ ɳ a
च	t͡s ə
च	t͡ɕ ə
चंदन	t͡ɕ ə n d̪ ə n
चंद्र	t͡ɕ ə n d̪ ɾ ə
चंद्रप्रकाश	t͡ɕ ə n d̪ ɾ ə p ɾ ə k a ɕ
चटई	t͡s ə ʈ ə i
चढणे	t͡s ə ɖʱ ɳ e
चढणे	t͡s ə ɖʱ ɳ ə
चमकणे	t͡s ə m ə k ɳ e
चमचा	t͡s ə m t͡s a
चमचा	t͡ɕ ə m t͡ɕ a
चमत्कार	t͡ɕ ə m ə t̪ k a ɾ
चरणे	t͡s ə ɾ ɳ e
चरणे	t͡s ə ɾ ɳ ə
चर्चा	t͡ɕ ə ɾ t͡ɕ a
चलाख	t͡ɕ ə l a kʰ
चव	t͡s ə ʋ
चवताळणे	t͡s ə ʋ t̪ a ɭ̆ ɳ e
चवताळणे	t͡s ə ʋ t̪ a ɭ̆ ɳ ə
चव्वीस	t͡s ə ʋ ʋ i s
चव्वेचाळीस	t͡s ə ʋ ʋ e t͡ɕ a ɭ̆ i s
चव्हाटा	t͡s ə ʋʱ a ʈ a
चश्मा	t͡ɕ ə ɕ m a
चष्मा	t͡ɕ ə ʂ m a
चहा	t͡ɕ ə ɦ a
चांगला	t͡s a ŋ ɡ l a
चांगले	t͡s a ŋ ɡ l e
चांदणी	t͡s a n d̪ ə ɳ i
चांदी	t͡s a n d̪ i
चाक	t͡s a k
चाकू	t͡s a k u
चाखणे	t͡s a kʰ ɳ e
चाखणे	t͡s a kʰ ɳ ə
चाटणे	t͡s a ʈ ɳ e
चाटणे	t͡s a ʈ ɳ ə
चाफा	t͡s a pʰ a
चामडी	t͡s a m ɖ i
चार	t͡ɕ a ɾ
चाल	t͡s a l
चालक	t͡ɕ a l ə k
चालणे	t͡s a l ɳ e
चालणे	t͡s a l ɳ ə
चालू	t͡s a l u
चाळ	t͡s a ɭ̆
चाळणे	t͡s a ɭ̆ ɳ e
चाळणे	t͡s a ɭ̆ ɳ ə
चाळीस	t͡ɕ a ɭ̆ i s
चावणे	t͡s a ʋ ɳ e
चावणे	t͡s a ʋ ɳ ə
चावी	t͡s a ʋ i
चाव्या	t͡s a ʋ j a
चाहणे	t͡ɕ a ɦ ɳ e
चाहणे	t͡ɕ a ɦ ɳ ə
चिंच	t͡ɕ i n t͡s ə
चिंतणे	t͡ɕ i n t̪ ə ɳ e
चिंतणे	t͡ɕ i n t̪ ə ɳ ə
चिंता	t͡ɕ i n t̪ a
चिकण	t͡ɕ i k ə ɳ
चिकणे	t͡ɕ i k ɳ e
चिकणे	t͡ɕ i k ɳ ə
चिखल	t͡ɕ i kʰ ə l
चिठ्ठी	t͡ɕ i ʈ ʈʰ i
चिठ्ठ्या	t͡ɕ i ʈ ʈʰ j a
चिडणे	t͡ɕ i ɖ ɳ e
चिडणे	t͡ɕ i ɖ ɳ ə
चित्ता	t͡ɕ i t̪ t̪ a
चित्तूर	t͡ɕ i t̪ t̪ u ɾ
चित्र	t͡ɕ i t̪ ɾ ə
चित्रकला	t͡ɕ i t̪ ɾ ə k l a
चित्रकार	t͡ɕ i t̪ ɾ ə k a ɾ
चित्रपट	t͡ɕ i t̪ ɾ ə p ə ʈ
चित्रे	t͡ɕ i t̪ ɾ e
चित्रे	t͡ɕ i t̪ ɾ ə
चिन्ह	t͡ɕ i nʱ ə
चिमणी	t͡ɕ i m ɳ i
चीक	t͡ɕ i k
चीज	t͡ɕ i d͡z
चीन	t͡ɕ i n
चीनी	t͡ɕ i n i
चुंबन	t͡ɕ u m b ə n
चुकणे	t͡s u k ɳ e
चुकणे	t͡s u k ɳ ə
चुकवणे	t͡s u k ə ʋ ɳ e
चुकवणे	t͡s u k ə ʋ ɳ ə
चूक	t͡s u k
चूळ	t͡s u ɭ̆
चेंडू	t͡ɕ e ɳ ɖ u
चेन्नई	t͡ɕ e n n ə i
चेपणे	t͡ɕ e p ɳ e
चेपणे	t͡ɕ e p ɳ ə
चेहरा	t͡ɕ e ɦ ɾ a
चॉकलेट	t͡ɕ ɔ k l e ʈ
चोख	t͡s o kʰ
चोखणे	t͡s o kʰ ɳ e
चोखणे	t͡s o kʰ ɳ ə
चोपणे	t͡s o p ɳ e
चोपणे	t͡s o p ɳ ə
चोर	t͡s o ɾ
चोरणे	t͡s o ɾ ɳ e
चोरणे	t͡s o ɾ ɳ ə
चोवीस	t͡s o ʋ i s
चौक	t͡s ə u k
चौकट	t͡s ə u k ə ʈ
चौकोन	t͡s ə u k o n
चौतीस	t͡s ə u t̪ i s
चौथे	t͡s ə u t̪ʰ e
चौथे	t͡s ə u t̪ʰ ə
चौदा	t͡s ə u d̪ a
चौधरी	t͡s ə u d̪ʱ ɾ i
चौरंग	t͡s ə u ɾ ə ŋ ɡ ə
छ	t͡ɕʰ ə
छंद	t͡ɕʰ ə n d̪ ə
छत्तीसगढ	t͡ɕʰ ə t̪ t̪ i s ɡ ə ɖʱ
छत्री	t͡ɕʰ ə t̪ ɾ i
छान	t͡ɕʰ a n
छायाचित्र	t͡ɕʰ a j a t͡ɕ i t̪ ɾ ə
ज	d͡z ə
ज	d͡ʑ ə
जंगली	d͡ʑ ə ŋ ɡ l i
जखम	d͡z ə kʰ ə m
जड	d͡z ə ɖ
जनावर	d͡z ə n a ʋ ə ɾ
जन्म	d͡ʑ ə n m ə
जन्मखूण	d͡ʑ ə n m ə kʰ u ɳ
जपणे	d͡z ə p ɳ e
जपणे	d͡z ə p ɳ ə
जपान	d͡ʑ ə p a n
जपानी	d͡ʑ ə p a n i
जप्त	d͡z ə p t̪ ə
जबडा	d͡z ə b ɖ a
जबाबदार	d͡z ə b a b d̪ a ɾ
जबाबदारी	d͡z ə b a b d̪ a ɾ i
जमणे	d͡z ə m ɳ e
जमणे	d͡z ə m ɳ ə
जमवणे	d͡z ə m ə ʋ ɳ e
जमवणे	d͡z ə m ə ʋ ɳ ə
जमाना	d͡z ə m a n a
जमीन	d͡z ə m i n
जय	d͡ʑ ə j
जयपूर	d͡ʑ ə j p u ɾ
जल	d͡ʑ ə l
जळणे	d͡z ə ɭ̆ ɳ e
जळणे	d͡z ə ɭ̆ ɳ ə
जळू	d͡z ə ɭ̆ u
जव	d͡z ə ʋ
जवळ	d͡ʑ ə ʋ ə ɭ̆
जहाज	d͡z ə ɦ a d͡z
जा	d͡ʑ a
जांभळा	d͡z a m bʱ ɭ̆ a
जाऊ	d͡z a u
जागणे	d͡z a ɡ ɳ e
जागणे	d͡z a ɡ ɳ ə
जागा	d͡z a ɡ a
जागे	d͡z a ɡ e
जागे	d͡z a ɡ ə
जाणणे	d͡z a ɳ ɳ e
जाणणे	d͡z a ɳ ɳ ə
जाणूनबुजून	d͡z a ɳ u n b u d͡z u n
जाणे	d͡z a ɳ e
जाणे	d͡z a ɳ ə
जादा	d͡ʑ a d̪ a
जानेवारी	d͡ʑ a n e ʋ a ɾ i
जाब	d͡z a b
जायफळ	d͡z a j pʰ ə ɭ̆
जारी	d͡ʑ a ɾ i
जाळणे	d͡z a ɭ̆ ɳ e
जाळणे	d͡z a ɭ̆ ɳ ə
जाळी	d͡ʑ a ɭ̆ i
जाळ्या	d͡z a ɭ̆ j a
जावई	d͡z a ʋ ə i
जास्त	d͡ʑ a s t̪ ə
जाहिरात	d͡ʑ a ɦ i ɾ a t̪
जाहीर	d͡ʑ a ɦ i ɾ
जिंकणे	d͡ʑ i ŋ k ɳ e
जिंकणे	d͡ʑ i ŋ k ɳ ə
जिज्ञासा	d͡ʑ i d͡ʑ n a s a
जिवंत	d͡ʑ i ʋ ə n t̪ ə
जिव्हाळा	d͡ʑ i ʋʱ a ɭ̆ a
जीभ	d͡ʑ i bʱ
जीव	d͡ʑ i ʋ
जीवन	d͡ʑ i ʋ ə n
जीवशास्त्र	d͡ʑ i ʋ ɕ a s t̪ ɾ ə
जीवाणू	d͡ʑ i ʋ a ɳ u
जुंपणे	d͡z u m p ə ɳ e
जुंपणे	d͡z u m p ə ɳ ə
जुगार	d͡z u ɡ a ɾ
जुलै	d͡ʑ u l ə i
जुळणे	d͡z u ɭ̆ ɳ e
जुळणे	d͡z u ɭ̆ ɳ ə
जुळवणे	d͡z u ɭ̆ ə ʋ ɳ e
जुळवणे	d͡z u ɭ̆ ə ʋ ɳ ə
जुळे	d͡z u ɭ̆ e
जुळे	d͡z u ɭ̆ ə
जून	d͡ʑ u n
जेवण	d͡ʑ e ʋ ə ɳ
जेवणे	d͡ʑ e ʋ ɳ e
जेवणे	d͡ʑ e ʋ ɳ ə
जैन	d͡ʑ ə i n
जैविक	d͡ʑ ə i ʋ i k
जॉर्डन	d͡ʑ ɔ ɾ ɖ ə n
जोखीम	d͡z o kʰ i m
जोडणे	d͡ʑ o ɖ ɳ e
जोर	d͡z o ɾ
जोरदार	d͡z o ɾ d̪ a ɾ
ज्ञ	d ɲ ə
ज्ञान	d͡ʑ n a n
ज्ञानी	d͡ʑ n a n i
ज्ञानेंद्रिय	d͡ʑ n a n e n d̪ ɾ i j
ज्यामिति	d͡ʑ j a m i t̪ i
झ	d͡zʱ ə
झ	d͡ʑʱ ə
झगडणे	d͡zʱ ə ɡ ə ɖ ɳ e
झगडणे	d͡zʱ ə ɡ ə ɖ ɳ ə
झटकणे	d͡zʱ ə ʈ ə k ɳ e
झटकणे	d͡zʱ ə ʈ ə k ɳ ə
झटका	d͡zʱ ə ʈ k a
झपाटणे	d͡zʱ ə p a ʈ ɳ e
झपाटणे	d͡zʱ ə p a ʈ ɳ ə
झवणे	d͡zʱ ə ʋ ɳ e
झवणे	d͡zʱ ə ʋ ɳ ə
झांज	d͡zʱ a n d͡z ə
झाकणे	d͡zʱ a k ɳ e
झाकणे	d͡zʱ a k ɳ ə
झाड	d͡zʱ a ɖ
झाडू	d͡zʱ a ɖ u
झाडे	d͡zʱ a ɖ e
झाडे	d͡zʱ a ɖ ə
झारखंड	d͡zʱ a ɾ kʰ ə ɳ ɖ ə
झाला	d͡ʑʱ a l a
झाले	d͡zʱ a l e
झाले	d͡zʱ a l ə
झाशी	d͡zʱ a ɕ i
झिजणे	d͡ʑʱ i d͡z ɳ e
झिजणे	d͡ʑʱ i d͡z ɳ ə
झुंज	d͡zʱ u n d͡z ə
झुंजणे	d͡zʱ u n d͡z ə ɳ e
झुंजणे	d͡zʱ u n d͡z ə ɳ ə
झुकणे	d͡zʱ u k ɳ e
झुकणे	d͡zʱ u k ɳ ə
झुमका	d͡zʱ u m k a
झुरणे	d͡zʱ u ɾ ɳ e
झुरणे	d͡zʱ u ɾ ɳ ə
झुलणे	d͡zʱ u l ɳ e
झुलणे	d͡zʱ u l ɳ ə
झुळूक	d͡zʱ u ɭ̆ u k
झेंडा	d͡ʑʱ e ɳ ɖ a
झेंडे	d͡ʑʱ e ɳ ɖ e
झेंडे	d͡ʑʱ e ɳ ɖ ə
झेलणे	d͡ʑʱ e l ɳ e
झेलणे	d͡ʑʱ e l ɳ ə
झोडणे	d͡zʱ o ɖ ɳ e
झोडणे	d͡zʱ o ɖ ɳ ə
झोप	d͡zʱ o p
झोपडी	d͡zʱ o p ɖ i
झोपणे	d͡zʱ o p ɳ e
झोपणे	d͡zʱ o p ɳ ə
ञ	j ə̃
ट	ʈ ə
टक	ʈ ə k
टक्कर	ʈ ə k k ə ɾ
टक्कल	ʈ ə k k ə l
टरबुजे	ʈ ə ɾ b u d͡ʑ e
टरबूज	ʈ ə ɾ b u d͡z
टळणे	ʈ ə ɭ̆ ɳ e
टळणे	ʈ ə ɭ̆ ɳ ə
टांगणे	ʈ a ŋ ɡ ə ɳ e
टांगणे	ʈ a ŋ ɡ ə ɳ ə
टाकणे	ʈ a k ɳ e
टाकणे	ʈ a k ɳ ə
टाळी	ʈ a ɭ̆ i
टिकणे	ʈ i k ɳ e
टिकणे	ʈ i k ɳ ə
टिकली	ʈ i k l i
टिकाऊ	ʈ i k a u
टिकाव	ʈ i k a ʋ
टीम	ʈ i m
टेकडी	ʈ e k ɖ i
टेकणे	ʈ e k ɳ e
टेकणे	ʈ e k ɳ ə
टोकियो	ʈ o k i j o
टोळी	ʈ o ɭ̆ i
ट्रेन	ʈ ɾ e n
ठ	ʈʰ ə
ठरणे	ʈʰ ə ɾ ɳ e
ठरणे	ʈʰ ə ɾ ɳ ə
ठरवणे	ʈʰ ə ɾ ə ʋ ɳ e
ठरवणे	ʈʰ ə ɾ ə ʋ ɳ ə
ठळक	ʈʰ ə ɭ̆ ə k
ठसा	ʈʰ ə s a
ठाऊक	ʈʰ a u k
ठाकरे	ʈʰ a k ɾ e
ठाण	ʈʰ a ɳ
ठाणे	ʈʰ a ɳ e
ठाम	ʈʰ a m
ठिकाण	ʈʰ i k a ɳ
ठिकाणे	ʈʰ i k a ɳ e
ठिकाणे	ʈʰ i k a ɳ ə
ठीक	ʈʰ i k
ठेंगणे	ʈʰ e ŋ ɡ ə ɳ e
ठेंगणे	ʈʰ e ŋ ɡ ə ɳ ə
ठेका	ʈʰ e k a
ठेकेदार	ʈʰ e k e d̪ a ɾ
ठोकणे	ʈʰ o k ɳ e
ठोकणे	ʈʰ o k ɳ ə
ड	ɖ ə
डबा	ɖ ə b a
डसणे	ɖ ə s ɳ e
डसणे	ɖ ə s ɳ ə
डांबर	ɖ a m b ə ɾ
डाखीण	ɖ a kʰ i ɳ
डाग	ɖ a ɡ
डाळ	ɖ a ɭ̆
डाळिंब	ɖ a ɭ̆ i m b ə
डिवचणे	ɖ i ʋ ə t͡s ɳ e
डिवचणे	ɖ i ʋ ə t͡s ɳ ə
डिसेंबर	ɖ i s e m b ə ɾ
डुंबणे	ɖ u m b ə ɳ e
डुंबणे	ɖ u m b ə ɳ ə
डोके	ɖ o k e
डोके	ɖ o k ə
डोळा	ɖ o ɭ̆ a
डोहाळा	ɖ o ɦ a ɭ̆ a
ढ	ɖʱ ə
ढग	ɖʱ ə ɡ
ढगाळ	ɖʱ ə ɡ a ɭ̆
ढाल	ɖʱ a l
ढोर	ɖʱ o ɾ
ण	ɳ ə
त	t̪ ə
तंत्र	t̪ ə n t̪ ɾ ə
तंत्रज्ञान	t̪ ə n t̪ ɾ ə d͡ʑ n a n
तंबाखू	t̪ ə m b a kʰ u
तंबू	t̪ ə m b u
तक्ता	t̪ ə k t̪ a
तक्ते	t̪ ə k t̪ e
तडजोड	t̪ ə ɖ d͡z o ɖ
तडफडणे	t̪ ə ɖ pʰ ə ɖ ɳ e
तडफडणे	t̪ ə ɖ pʰ ə ɖ ɳ ə
तथागत	t̪ ə t̪ʰ a ɡ ə t̪
तपकिरी	t̪ ə p k i ɾ i
तपासणे	t̪ ə p a s ɳ e
तपासणे	t̪ ə p a s ɳ ə
तबला	t̪ ə b l a
तमिळ	t̪ ə m i ɭ̆
तयार	t̪ ə j a ɾ
तरंग	t̪ ə ɾ ə ŋ ɡ ə
तरंगणे	t̪ ə ɾ ə ŋ ɡ ə ɳ e
तरंगणे	t̪ ə ɾ ə ŋ ɡ ə ɳ ə
तरुण	t̪ ə ɾ u ɳ
तऱ्हा	t̪ ə ɾʱ a
तलवार	t̪ ə l ʋ a ɾ
तलाव	t̪ ə l a ʋ
तळणे	t̪ ə ɭ̆ ɳ e
तळणे	t̪ ə ɭ̆ ɳ ə
तसे	t̪ ə s e
तसे	t̪ ə s ə
तहान	t̪ ə ɦ a n
तांत्रिक	t̪ a n t̪ ɾ i k
तांदूळ	t̪ a n d̪ u ɭ̆
तांबडा	t̪ a m b ɖ a
ताक	t̪ a k
ताकद	t̪ a k ə d̪
ताकीद	t̪ a k i d̪
ताग	t̪ a ɡ
ताजे	t̪ a d͡z e
ताट	t̪ a ʈ
ताठ	t̪ a ʈʰ
ताण	t̪ a ɳ
ताणणे	t̪ a ɳ ɳ e
ताणणे	t̪ a ɳ ɳ ə
ताप	t̪ a p
तापणे	t̪ a p ɳ e
तापणे	t̪ a p ɳ ə
ताबा	t̪ a b a
तार	t̪ a ɾ
तारण	t̪ a ɾ ə ɳ
तारा	t̪ a ɾ a
तारीफ	t̪ a ɾ i pʰ
तारे	t̪ a ɾ e
तालीम	t̪ a l i m
तालुका	t̪ a l u k a
तावणे	t̪ a ʋ ɳ e
तावणे	t̪ a ʋ ɳ ə
तास	t̪ a s
तिकडे	t̪ i k ɖ e
तिकडे	t̪ i k ɖ ə
तिजोरी	t̪ i d͡z o ɾ i
तिथे	t̪ i t̪ʰ e
तिथे	t̪ i t̪ʰ ə
तिरके	t̪ i ɾ k e
तिरके	t̪ i ɾ k ə
तिरुचिरापल्ली	t̪ i ɾ u t͡ɕ i ɾ a p ə l l i
तिरुवनंतपुरम	t̪ i ɾ u ʋ n ə n t̪ ə p u ɾ ə m
तिला	t̪ i l a
तिसरे	t̪ i s ɾ e
ती	t̪ i
तीळ	t̪ i ɭ̆
तुटणे	t̪ u ʈ ɳ e
तुटणे	t̪ u ʈ ɳ ə
तुम्ही	t̪ u mʱ i
तुरुंग	t̪ u ɾ u ŋ ɡ ə
तुला	t̪ u l a
तुळसी	t̪ u ɭ̆ s i
तू	t̪ u
तूप	t̪ u p
तूळ	t̪ u ɭ̆
तृप्ती	t̪ ɾ u p t̪ i
तेंडुलकर	t̪ e ɳ ɖ u l k ə ɾ
तेरा	t̪ e ɾ a
तेल	t̪ e l
तेलुगू	t̪ e l u ɡ u
तेवीस	t̪ e ʋ i s
तेहतीस	t̪ e ɦ t̪ i s
तो	t̪ o
तोंड	t̪ o ɳ ɖ ə
तोंडे	t̪ o ɳ ɖ e
तोंडे	t̪ o ɳ ɖ ə
तोडणे	t̪ o ɖ ɳ e
तोडणे	t̪ o ɖ ɳ ə
तोलणे	t̪ o l ɳ e
तोलणे	t̪ o l ɳ ə
तोळा	t̪ o ɭ̆ a
त्याग	t̪ j a ɡ
त्रेचाळीस	t̪ ɾ e t͡ɕ a ɭ̆ i s
थ	t̪ʰ ə
थंड	t̪ʰ ə ɳ ɖ ə
थकणे	t̪ʰ ə k ɳ e
थकणे	t̪ʰ ə k ɳ ə
थट्टा	t̪ʰ ə ʈ ʈ a
थर	t̪ʰ ə ɾ
थरथरणे	t̪ʰ ə ɾ t̪ʰ ə ɾ ɳ e
थरथरणे	t̪ʰ ə ɾ t̪ʰ ə ɾ ɳ ə
थवा	t̪ʰ ə ʋ a
थांबणे	t̪ʰ a m b ɳ e
थांबणे	t̪ʰ a m b ɳ ə
थायलंड	t̪ʰ a j l ə ɳ ɖ ə
थाळी	t̪ʰ a ɭ̆ i
थिजणे	t̪ʰ i d͡z ɳ e
थिजणे	t̪ʰ i d͡z ɳ ə
थुंकणे	t̪ʰ u ŋ k ɳ e
थुंकणे	t̪ʰ u ŋ k ɳ ə
थुंकी	t̪ʰ u ŋ k i
थेंब	t̪ʰ e m b ə
थेट	t̪ʰ e ʈ
थोडे	t̪ʰ o ɖ e
थोडे	t̪ʰ o ɖ ə
थोबाड	t̪ʰ o b a ɖ
द	d ə
दक्ष	d̪ ə k ʂ ə
दक्षिण	d̪ ə k ʂ i ɳ
दगड	d̪ ə ɡ ə ɖ
दचकणे	d̪ ə t͡s ə k ɳ e
दबाव	d̪ ə b a ʋ
दमणे	d̪ ə m ɳ e
दमणे	d̪ ə m ɳ ə
दया	d̪ ə j a
दरबार	d̪ ə ɾ b a ɾ
दरवाजा	d̪ ə ɾ ʋ a d͡z a
दरी	d̪ ə ɾ i
दर्या	d̪ ə ɾ j a
दलाल	d̪ ə l a l
दवाखाना	d̪ ə ʋ a kʰ a n a
दहा	d̪ ə ɦ a
दहावे	d̪ ə ɦ a ʋ e
दहावे	d̪ ə ɦ a ʋ ə
दही	d̪ ə ɦ i
दाखल	d̪ a kʰ ə l
दाखवणे	d̪ a kʰ ə ʋ ɳ e
दाखवणे	d̪ a kʰ ə ʋ ɳ ə
दाट	d̪ a ʈ
दाटणे	d̪ a ʈ ɳ e
दाटणे	d̪ a ʈ ɳ ə
दाढी	d̪ a ɖʱ i
दात	d̪ a t̪
दाता	d̪ a t̪ a
दाते	d̪ a t̪ e
दाते	d̪ a t̪ ə
दादा	d̪ a d̪ a
दाब	d̪ a b
दाबणे	d̪ a b ɳ e
दाबणे	d̪ a b ɳ ə
दार	d̪ a ɾ
दारू	d̪ a ɾ u
दारे	d̪ a ɾ e
दारे	d̪ a ɾ ə
दिग्दर्शक	d̪ i ɡ d̪ ə ɾ ɕ ə k
दिन	d̪ i n
दिपणे	d̪ i p ɳ e
दिपणे	d̪ i p ɳ ə
दिल	d̪ i l
दिल्ली	d̪ i l l i
दिवस	d̪ i ʋ ə s
दिवा	d̪ i ʋ a
दिवाणे	d̪ i ʋ a ɳ e
दिवाणे	d̪ i ʋ a ɳ ə
दिवाळी	d̪ i ʋ a ɭ̆ i
दिशा	d̪ i ɕ a
दिसणे	d̪ i s ɳ e
दिसणे	d̪ i s ɳ ə
दीदी	d̪ i d̪ i
दीर	d̪ i ɾ
दुखणे	d̪ u kʰ ɳ e
दुखणे	d̪ u kʰ ɳ ə
दुधी	d̪ u d̪ʱ i
दुरुस्त	d̪ u ɾ u s t̪ ə
दुर्ग	d̪ u ɾ ɡ ə
दुसरे	d̪ u s ɾ e
दूध	d̪ u d̪ʱ
दूर	d̪ u ɾ
दृश्य	d̪ ɾ u ɕ j ə
दृश्ये	d̪ ɾ u ɕ j e
दृश्ये	d̪ ɾ u ɕ j ə
देणे	d̪ e ɳ e
देणे	d̪ e ɳ ə
देव	d̪ e ʋ
देवी	d̪ e ʋ i
देव्या	d̪ e ʋ j a
दोन	d̪ o n
दोनदा	d̪ o n d̪ a
दोन्ही	d̪ o nʱ i
दोरी	d̪ o ɾ i
दौडणे	d̪ ə u ɖ ɳ e
दौडणे	d̪ ə u ɖ ɳ ə
दौरा	d̪ ə u ɾ a
दौलत	d̪ ə u l ə t̪
द्राक्ष	d̪ ɾ a k ʂ ə
ध	d̪ʱ ə
धंदा	d̪ʱ ə n d̪ a
धंदे	d̪ʱ ə n d̪ e
धक्का	d̪ʱ ə k k a
धक्कादायक	d̪ʱ ə k k a d̪ a j ə k
धगधगणे	d̪ʱ ə ɡ d̪ʱ ə ɡ ɳ e
धगधगणे	d̪ʱ ə ɡ d̪ʱ ə ɡ ɳ ə
धडकणे	d̪ʱ ə ɖ ə k ɳ e
धडकणे	d̪ʱ ə ɖ ə k ɳ ə
धडा	d̪ʱ ə ɖ a
धनादेश	d̪ʱ ə n a d̪ e ɕ
धनु	d̪ʱ ə n u
धनुष्य	d̪ʱ ə n u ʂ j ə
धन्य	d̪ʱ ə n j ə
धबधबा	d̪ʱ ə b d̪ʱ ə b a
धमनी	d̪ʱ ə m n i
धमन्या	d̪ʱ ə m ə n j a
धरणे	d̪ʱ ə ɾ ɳ e
धरणे	d̪ʱ ə ɾ ɳ ə
धर्म	d̪ʱ ə ɾ m ə
धर्मग्रंथ	d̪ʱ ə ɾ m ə ɡ ɾ ə n t̪ʰ ə
धर्मनिरपेक्ष	d̪ʱ ə ɾ m ə n i ɾ ə p e k ʂ ə
धर्मनिरपेक्षता	d̪ʱ ə ɾ m ə n i ɾ ə p e k ʂ ə t̪ a
धाडणे	d̪ʱ a ɖ ɳ e
धाडणे	d̪ʱ a ɖ ɳ ə
धाडस	d̪ʱ a ɖ ə s
धातू	d̪ʱ a t̪ u
धाप	d̪ʱ a p
धाराशिव	d̪ʱ a ɾ a ɕ i ʋ
धार्मिक	d̪ʱ a ɾ m i k
धार्मिकता	d̪ʱ a ɾ m i k t̪ a
धावणे	d̪ʱ a ʋ ɳ e
धावणे	d̪ʱ a ʋ ɳ ə
धिमे	d̪ʱ i m e
धिमे	d̪ʱ i m ə
धुंद	d̪ʱ u n d̪ ə
धूर	d̪ʱ u ɾ
धूळ	d̪ʱ u ɭ̆
धैर्य	d̪ʱ ə i ɾ j ə
ध्यान	d̪ʱ j a n
ध्वज	d̪ʱ ʋ ə d͡ʑ
न	n ə
नऊ	n ə u
नकाशा	n ə k a ɕ a
नक्कल	n ə k k ə l
नजर	n ə d͡z ə ɾ
नजराणा	n ə d͡z ɾ a ɳ a
नजीक	n ə d͡ʑ i k
नट	n ə ʈ
नटी	n ə ʈ i
नणंद	n ə ɳ ə n d̪ ə
नपुंसकलिंग	n ə p u u s ə k l i ŋ ɡ ə
नमाज	n ə m a d͡ʑ
नमुना	n ə m u n a
नयन	n ə j ə n
नळ	n ə ɭ̆
नवरा	n ə ʋ ɾ a
नवरी	n ə ʋ ɾ i
नववे	n ə ʋ ʋ e
नववे	n ə ʋ ʋ ə
नवस	n ə ʋ ə s
नवा	n ə ʋ a
नवे	n ə ʋ e
नव्वद	n ə ʋ ʋ ə d̪
नव्व्याण्णव	n ə ʋ ʋ j a ɳ ɳ ə ʋ
नशीब	n ə ɕ i b
नष्ट	n ə ʂ ʈ ə
नस	n ə s
नाक	n a k
नाकपुडी	n a k p u ɖ i
नाकपुड्या	n a k p u ɖ j a
नाका	n a k a
नाके	n a k e
नाके	n a k ə
नाखुश	n a kʰ u ɕ
नागपूर	n a ɡ p uː ɾ
नागरिक	n a ɡ ə ɾ i k
नाच	n a t͡s
नाचक्की	n a t͡ɕ ə k k i
नाचणे	n a t͡s ɳ e
नाचणे	n a t͡s ɳ ə
नाचवणे	n a t͡s ə ʋ ɳ e
नाचवणे	n a t͡s ə ʋ ɳ ə
नाडी	n a ɖ i
नाणं	n a ɳ ə
नाणे	n a ɳ e
नाणे	n a ɳ ə
नात	n a t̪
नाताळ	n a t̪ a ɭ̆
नातीण	n a t̪ i ɳ
नातू	n a t̪ u
नाते	n a t̪ e
नाते	n a t̪ ə
नापसंत	n a p ə s ə n t̪ ə
नारळ	n a ɾ ə ɭ̆
नाव	n a ʋ
नावाजणे	n a ʋ a d͡z ɳ e
नावाजणे	n a ʋ a d͡z ɳ ə
नावाडी	n a ʋ a ɖ i
नाश	n a ɕ
नाशिक	n a ɕ i k
नाश्ता	n a ɕ t̪ a
नाष्टा	n a ʂ ʈ a
नासणे	n a s ɳ e
नासणे	n a s ɳ ə
नास्तिक	n a s t̪ i k
नास्तिकता	n a s t̪ i k t̪ a
नाही	n a ɦ i
नि	n i
निका	n i k a
निखळणे	n i kʰ ə ɭ̆ ɳ e
निखळणे	n i kʰ ə ɭ̆ ɳ ə
निजणे	n i d͡z ɳ e
निदान	n i d̪ a n
निद्रा	n i d̪ ɾ a
निधि	n i d̪ʱ i
निपजणे	n i p ə d͡z ɳ e
निपजणे	n i p ə d͡z ɳ ə
निबर	n i b ə ɾ
निभावणे	n i bʱ a ʋ ɳ e
निभावणे	n i bʱ a ʋ ɳ ə
नियम	n i j ə m
निरोध	n i ɾ o d̪ʱ
निर्जीव	n i ɾ d͡ʑ i ʋ
निर्भय	n i ɾ bʱ ə j
निर्मळ	n i ɾ m ə ɭ̆
निर्माता	n i ɾ m a t̪ a
निर्माते	n i ɾ m a t̪ e
निर्मिती	n i ɾ m i t̪ i
निवडणूक	n i ʋ ə ɖ ɳ u k
निवळणे	n i ʋ ə ɭ̆ ɳ e
निवळणे	n i ʋ ə ɭ̆ ɳ ə
निवारा	n i ʋ a ɾ a
निव्वळ	n i ʋ ʋ ə ɭ̆
निशिगंध	n i ɕ i ɡ ə n d̪ʱ ə
निष्णात	n i ʂ ɳ a t̪
निसटणे	n i s ə ʈ ɳ e
निसटणे	n i s ə ʈ ɳ ə
निस्तरणे	n i s t̪ ə ɾ ɳ e
निस्तरणे	n i s t̪ ə ɾ ɳ ə
नेणे	n e ɳ e
नेणे	n e ɳ ə
नेतृत्व	n e t̪ ɾ u t̪ ʋ ə
नेत्र	n e t̪ ɾ ə
नेपाळ	n e p a ɭ̆
नेपाळी	n e p a ɭ̆ i
नेसणे	n e s ɳ e
नेसणे	n e s ɳ ə
नैऋत्य	n ə i ɾ u t̪ j ə
नोंदणे	n o n d̪ & kʰ 2 A ; ɳ e
नोकर	n o k ə ɾ
नोव्हेंबर	n o ʋʱ e m b ə ɾ
न्याहारी	n j a ɦ a ɾ i
न्हावी	nʱ a ʋ i
प	p ə
पंख	p ə ŋ kʰ ə
पंखा	p ə ŋ kʰ a
पंखे	p ə ŋ kʰ e
पंचवीस	p ə n t͡ɕ ʋ i s
पंचेचाळीस	p ə n t͡s e t͡ɕ a ɭ̆ i s
पंतप्रधान	p ə n t̪ ə p ɾ ə d̪ʱ a n
पंधरा	p ə n d̪ʱ ɾ a
पकडणे	p ə k ə ɖ ɳ e
पकडणे	p ə k ə ɖ ɳ ə
पगार	p ə ɡ a ɾ
पचणे	p ə t͡s ɳ e
पचणे	p ə t͡s ɳ ə
पचवणे	p ə t͡s ə ʋ ɳ e
पचवणे	p ə t͡s ə ʋ ɳ ə
पटणे	p ə ʈ ɳ e
पटणे	p ə ʈ ɳ ə
पटवणे	p ə ʈ ə ʋ ɳ e
पटवणे	p ə ʈ ə ʋ ɳ ə
पट्टा	p ə ʈ ʈ a
पट्टी	p ə ʈ ʈ i
पट्टे	p ə ʈ ʈ e
पट्टे	p ə ʈ ʈ ə
पट्ट्या	p ə ʈ ʈ j a
पठाण	p ə ʈʰ a ɳ
पठार	p ə ʈʰ a ɾ
पडणे	p ə ɖ ɳ e
पडणे	p ə ɖ ɳ ə
पडदा	p ə ɖ d̪ a
पडवळ	p ə ɖ ʋ ə ɭ̆
पडाव	p ə ɖ a ʋ
पढवणे	p ə ɖʱ ə ʋ ɳ e
पढवणे	p ə ɖʱ ə ʋ ɳ ə
पण	p ə ɳ
पणजी	p ə ɳ d͡ʑ i
पणती	p ə ɳ t̪ i
पणतू	p ə ɳ t̪ u
पताका	p ə t̪ a k a
पताके	p ə t̪ a k e
पताके	p ə t̪ a k ə
पती	p ə t̪ i
पत्ता	p ə t̪ t̪ a
पत्ते	p ə t̪ t̪ e
पत्ते	p ə t̪ t̪ ə
पत्रकार	p ə t̪ ɾ ə k a ɾ
पथ	p ə t̪ʰ
पदार्थ	p ə d̪ a ɾ t̪ʰ ə
पदार्पण	p ə d̪ a ɾ p ə ɳ
पदार्पणे	p ə d̪ a ɾ p ə ɳ e
पदार्पणे	p ə d̪ a ɾ p ə ɳ ə
पन्हे	p ə nʱ e
पन्हे	p ə nʱ ə
परत	p ə ɾ ə t̪
परतणे	p ə ɾ ə t̪ ɳ e
परतणे	p ə ɾ ə t̪ ɳ ə
परवड	p ə ɾ ʋ ə ɖ
परवडणे	p ə ɾ ʋ ə ɖ ɳ e
परवडणे	p ə ɾ ʋ ə ɖ ɳ ə
पराजय	p ə ɾ a d͡ʑ ə j
परिपूर्ण	p ə ɾ i p u ɾ ɳ ə
परिस्थिती	p ə ɾ i s t̪ʰ i t̪ i
पर्यटक	p ə ɾ j ə ʈ ə k
पर्यटन	p ə ɾ j ə ʈ ə n
पलंग	p ə l ə ŋ ɡ ə
पळणे	p ə ɭ̆ ɳ e
पळणे	p ə ɭ̆ ɳ ə
पळवणे	p ə ɭ̆ ə ʋ ɳ e
पळवणे	p ə ɭ̆ ə ʋ ɳ ə
पशू	p ə ɕ u
पश्चिम	p ə ɕ t͡ɕ i m
पसंत	p ə s ə n t̪ ə
पसारा	p ə s a ɾ a
पस्तावणे	p ə s t̪ a ʋ ɳ e
पस्तावणे	p ə s t̪ a ʋ ɳ ə
पस्तीस	p ə s t̪ i s
पहाट	p ə ɦ a ʈ
पहिले	p ə ɦ i l e
पांगणे	p a ŋ ɡ ə ɳ e
पांगणे	p a ŋ ɡ ə ɳ ə
पांघरणे	p a ŋ ɡʱ ə ɾ ɳ e
पांघरणे	p a ŋ ɡʱ ə ɾ ɳ ə
पांघरुणे	p a ŋ ɡʱ ɾ u ɳ e
पांघरुणे	p a ŋ ɡʱ ɾ u ɳ ə
पांघरूण	p a ŋ ɡʱ ɾ u ɳ
पाऊल	p a u l
पाऊलखूण	p a u l kʰ u ɳ
पाऊस	p a u s
पाक	p a k
पाकळी	p a k ɭ̆ i
पाखरू	p a kʰ ɾ u
पाखरे	p a kʰ ɾ e
पाखरे	p a kʰ ɾ ə
पाच	p a t͡s
पाजणे	p a d͡z ɳ e
पाजणे	p a d͡z ɳ ə
पाझर	p a d͡zʱ ə ɾ
पाझरणे	p a d͡zʱ ə ɾ ɳ e
पाझरणे	p a d͡zʱ ə ɾ ɳ ə
पाठ	p a ʈʰ
पाठवणे	p a ʈʰ ə ʋ ɳ e
पाठवणे	p a ʈʰ ə ʋ ɳ ə
पाठ्यपुस्तक	p a ʈʰ j ə p u s t̪ ə k
पाडणे	p a ɖ ɳ e
पाडणे	p a ɖ ɳ ə
पाडवणे	p a ɖ ə ʋ ɳ e
पाडवणे	p a ɖ ə ʋ ɳ ə
पाडवा	p a ɖ ʋ a
पाडवा	p a ɖ ʋ ə
पाणावणे	p a ɳ a ʋ ɳ e
पाणावणे	p a ɳ a ʋ ɳ ə
पाणी	p a ɳ i
पादणे	p a d̪ ɳ e
पादणे	p a d̪ ɳ ə
पाद्री	p a d̪ ɾ i
पान	p a n
पाने	p a n e
पाने	p a n ə
पाय	p a j
पायथा	p a j t̪ʰ a
पायपुसणे	p a j p u s ɳ e
पायपुसणे	p a j p u s ɳ ə
पायरी	p a j ɾ i
पायवाट	p a j ʋ a ʈ
पारखणे	p a ɾ ə kʰ ɳ e
पारखणे	p a ɾ ə kʰ ɳ ə
पारिभाषिक	p a ɾ i bʱ a ʂ i k
पारोसे	p a ɾ o s e
पारोसे	p a ɾ o s ə
पार्वती	p a ɾ ʋ ə t̪ i
पाल	p a l
पालक	p a l ə k
पालटणे	p a l ə ʈ ɳ e
पालटणे	p a l ə ʈ ɳ ə
पाळणे	p a ɭ̆ ɳ e
पाळणे	p a ɭ̆ ɳ ə
पाव	p a ʋ
पाहणे	p a ɦ ɳ e
पाहणे	p a ɦ ɳ ə
पाहुणा	p a ɦ u ɳ a
पिंजरा	p i n d͡z ɾ a
पिक्चर	p i k t͡ɕ ə ɾ
पिझ्झा	p i d͡z d͡zʱ a
पिठी	p i ʈʰ i
पिल्लू	p i l l u
पिळणे	p i ɭ̆ ɳ e
पिळणे	p i ɭ̆ ɳ ə
पिवळा	p i ʋ ɭ̆ a
पिशवी	p i ɕ ʋ i
पिशव्या	p i ɕ ə ʋ j a
पिसणे	p i s ɳ e
पिसणे	p i s ɳ ə
पिसारा	p i s a ɾ a
पिसुरडा	p i s u ɾ ɖ a
पीठ	p i ʈʰ
पीस	p i s
पुठ्ठा	p u ʈ ʈʰ a
पुडा	p u ɖ a
पुडी	p u ɖ i
पुडे	p u ɖ e
पुडे	p u ɖ ə
पुड्या	p u ɖ j a
पुढे	p u ɖʱ e
पुणे	p u ɳ e
पुतण्या	p u t̪ ə ɳ j a
पुतळा	p u t̪ ɭ̆ a
पुनावाला	p u n a ʋ a l a
पुन्हा	p u nʱ a
पुरणे	p u ɾ ɳ e
पुरणे	p u ɾ ɳ ə
पुरते	p u ɾ t̪ e
पुरते	p u ɾ t̪ ə
पुरस्कार	p u ɾ ə s k a ɾ
पुराणा	p u ɾ a ɳ a
पुरावा	p u ɾ a ʋ a
पुरुष	p u ɾ u ʂ
पुल्लिंग	p u l l i ŋ ɡ ə
पुष्कलावती	p u ʂ k ə l a ʋ ə t̪ i
पुसणे	p u s ɳ e
पुसणे	p u s ɳ ə
पुस्तक	p u s t̪ ə k
पुस्तकालय	p u s t̪ ə k a l ə j
पुस्तके	p u s t̪ ə k e
पुस्तके	p u s t̪ ə k ə
पुस्तिका	p u s t̪ i k a
पूड	p u ɖ
पूनावाला	p u n a ʋ a l a
पूर	p u ɾ
पूर्ण	p u ɾ ɳ ə
पूर्व	p u ɾ ʋ ə
पूर्वज	p u ɾ ʋ ə d͡ʑ
पृथ्वी	p ɾ u t̪ʰ ʋ i
पृथ्व्या	p ɾ u t̪ʰ ʋ j a
पॅरिस	p æ ɾ i s
पेज	p e d͡z
पेटी	p e ʈ i
पेठ	p e ʈʰ
पेढा	p e ɖʱ a
पेढी	p e ɖʱ i
पेढ्या	p e ɖʱ j a
पेरणे	p e ɾ ɳ e
पेरणे	p e ɾ ɳ ə
पेरू	p e ɾ u
पेलणे	p e l ɳ e
पेलणे	p e l ɳ ə
पेला	p e l a
पेहलवान	p e ɦ ə l ʋ a n
पैज	p ə i d͡z
पैदा	p ə i d̪ a
पैसा	p ə i s a
पोकळ	p o k ə ɭ̆
पोक्त	p o k t̪ ə
पोट	p o ʈ
पोत	p o t̪
पोते	p o t̪ e
पोते	p o t̪ ə
पोतेरे	p o t̪ e ɾ e
पोतेरे	p o t̪ e ɾ ə
पोपटी	p o p ʈ i
पोवाडा	p o ʋ a ɖ a
पोषाख	p o ʂ a kʰ
प्यादे	p j a d̪ e
प्यादे	p j a d̪ ə
प्रकार	p ɾ ə k a ɾ
प्रचंड	p ɾ ə t͡ɕ ə ɳ ɖ ə
प्रजासत्ताक	p ɾ ə d͡ʑ a s ə t̪ t̪ a k
प्रतिक्रिया	p ɾ ə t̪ i k ɾ i j a
प्रतिज्ञा	p ɾ ə t̪ i d͡ʑ n a
प्रतिनिधित्व	p ɾ ə t̪ i n i d̪ʱ i t̪ ʋ ə
प्रतिनिधी	p ɾ ə t̪ i n i d̪ʱ i
प्रत्येक	p ɾ ə t̪ j e k
प्रथिन	p ɾ ə t̪ʰ i n
प्रथिने	p ɾ ə t̪ʰ i n e
प्रथिने	p ɾ ə t̪ʰ i n ə
प्रदेश	p ɾ ə d̪ e ɕ
प्रबोधिका	p ɾ ə b o d̪ʱ i k a
प्रभा	p ɾ ə bʱ a
प्रभुत्व	p ɾ ə bʱ u t̪ ʋ ə
प्रमाद	p ɾ ə m a d̪
प्रवास	p ɾ ə ʋ a s
प्रश्न	p ɾ ə ɕ n ə
प्राकृत	p ɾ a k ɾ u t̪
प्राचार्य	p ɾ a t͡ɕ a ɾ j ə
प्रादेशिक	p ɾ a d̪ e ɕ i k
प्रादेशिकता	p ɾ a d̪ e ɕ i k t̪ a
प्रेम	p ɾ e m
फ	f ə
फ	pʰ ə
फजिती	pʰ ə d͡ʑ i t̪ i
फरक	pʰ ə ɾ ə k
फराळ	pʰ ə ɾ a ɭ̆
फरीदाबाद	pʰ ə ɾ i d̪ a b a d̪
फळ	pʰ ə ɭ̆
फळं	pʰ ə ɭ̆ ə
फळा	pʰ ə ɭ̆ a
फळे	pʰ ə ɭ̆ e
फळे	pʰ ə ɭ̆ ə
फसणे	pʰ ə s ɳ e
फसणे	pʰ ə s ɳ ə
फसवणे	pʰ ə s ə ʋ ɳ e
फाडणे	pʰ a ɖ ɳ e
फाडणे	pʰ a ɖ ɳ ə
फावडे	pʰ a ʋ ɖ e
फावडे	pʰ a ʋ ɖ ə
फावणे	pʰ a ʋ ɳ e
फावणे	pʰ a ʋ ɳ ə
फिरणे	pʰ i ɾ ɳ e
फिरणे	pʰ i ɾ ɳ ə
फिर्याद	pʰ i ɾ j a d̪
फिसकटणे	pʰ i s k ə ʈ ɳ e
फिसकटणे	pʰ i s k ə ʈ ɳ ə
फुगणे	pʰ u ɡ ɳ e
फुगणे	pʰ u ɡ ɳ ə
फुगा	pʰ u ɡ a
फुटणे	pʰ u ʈ ɳ e
फुटणे	pʰ u ʈ ɳ ə
फुफ्फुस	pʰ u p pʰ u s
फुफ्फुसे	pʰ u p pʰ u s e
फुफ्फुसे	pʰ u p pʰ u s ə
फुरसत	pʰ u ɾ s ə t̪
फुरसोनं	pʰ u ɾ s o n ə
फुलणे	pʰ u l ɳ e
फुलणे	pʰ u l ɳ ə
फुलपाखरू	pʰ u l p a kʰ ɾ u
फुलपाखरे	pʰ u l p a kʰ ɾ e
फुलपाखरे	pʰ u l p a kʰ ɾ ə
फुले	pʰ u l e
फुले	pʰ u l ə
फूल	pʰ u l
फेब्रुवारी	pʰ e b ɾ u ʋ a ɾ i
फोड	pʰ o ɖ
फोडणे	pʰ o ɖ ɳ e
फोडणे	pʰ o ɖ ɳ ə
फौज	pʰ ə u d͡z
फ्रान्स	pʰ ɾ a n s
ब	b ə
बँक	b æ ŋ k
बंगला	b ə ŋ ɡ l a
बंगले	b ə ŋ ɡ l e
बंगळूर	b ə ŋ ɡ ɭ̆ u ɾ
बंगाली	b ə ŋ ɡ a l i
बंद	b ə n d̪ ə
बंदी	b ə n d̪ i
बंब	b ə m b ə
बकणे	b ə k ɳ e
बकणे	b ə k ɳ ə
बक्षीस	b ə k ʂ i s
बघणे	b ə ɡʱ ɳ e
बघणे	b ə ɡʱ ɳ ə
बचावणे	b ə t͡ɕ a ʋ ɳ e
बचावणे	b ə t͡ɕ a ʋ ɳ ə
बजावणे	b ə d͡ʑ a ʋ ɳ e
बजावणे	b ə d͡ʑ a ʋ ɳ ə
बत्ती	b ə t̪ t̪ i
बदाम	b ə d̪ a m
बनणे	b ə n ɳ e
बनणे	b ə n ɳ ə
बनवणे	b ə n ə ʋ ɳ e
बनवणे	b ə n ə ʋ ɳ ə
बनावट	b ə n a ʋ ə ʈ
बरे	b ə ɾ e
बरे	b ə ɾ ə
बरोबर	b ə ɾ o b ə ɾ
बर्फ	b ə ɾ pʰ ə
बळ	b ə ɭ̆
बशी	b ə ɕ i
बसणे	b ə s ɳ e
बसणे	b ə s ɳ ə
बहरैन	b ə ɦ ɾ ə i n
बहाद्दर	b ə ɦ a d̪ d̪ ə ɾ
बहुतेक	b ə ɦ u t̪ e k
बांगलादेश	b a ŋ ɡ l a d̪ e ɕ
बाक	b a k
बाकी	b a k i
बाक्या	b a k j a
बाजार	b a d͡z a ɾ
बाटली	b a ʈ l i
बाटल्या	b a ʈ ə l j a
बाण	b a ɳ
बातमी	b a t̪ m i
बातम्या	b a t̪ ə m j a
बादशहा	b a d̪ ɕ ə ɦ a
बारा	b a ɾ a
बाळ	b a ɭ̆
बाळे	b a ɭ̆ e
बाळे	b a ɭ̆ ə
बावीस	b a ʋ i s
बाहुली	b a ɦ u l i
बाहू	b a ɦ u
बिंदू	b i n d̪ u
बिचारे	b i t͡ɕ a ɾ e
बिचारे	b i t͡ɕ a ɾ ə
बिर्याणी	b i ɾ j a ɳ i
बी	b i
बुगडी	b u ɡ ɖ i
बुडबुडा	b u ɖ b u ɖ a
बुद्ध	b u d̪ d̪ʱ ə
बुद्धिबळ	b u d̪ d̪ʱ i b ə ɭ̆
बुद्धिमत्ता	b u d̪ d̪ʱ i m ə t̪ t̪ a
बुद्धी	b u d̪ d̪ʱ i
बुद्ध्यांक	b u d̪ d̪ʱ j a ŋ k ə
बुध	b u d̪ʱ
बुधवार	b u d̪ʱ ʋ a ɾ
बुरशी	b u ɾ ɕ i
बुवा	b u ʋ a
बॅंक	b æ ŋ k ə
बेचाळीस	b e t͡ɕ a ɭ̆ i s
बेजबाबदार	b e d͡z ə b a b d̪ a ɾ
बेडूक	b e ɖ u k
बेसुमार	b e s u m a ɾ
बैठक	b ə i ʈʰ ə k
बैरूत	b ə i ɾ u t̪
बोकड	b o k ə ɖ
बोका	b o k a
बोके	b o k e
बोट	b o ʈ
बोल	b o l
बोलणे	b o l ɳ e
बोलणे	b o l ɳ ə
बोली	b o l i
बोलीभाषा	b o l i bʱ a ʂ a
बोळा	b o ɭ̆ a
बौद्ध	b ə u d̪ d̪ʱ ə
ब्राझील	b ɾ a d͡zʱ i l
ब्रुनेई	b ɾ u n e i
भ	bʱ ə
भगवा	bʱ ə ɡ ʋ a
भजन	bʱ ə d͡ʑ ə n
भटकणे	bʱ ə ʈ ə k ɳ e
भटकणे	bʱ ə ʈ ə k ɳ ə
भडकणे	bʱ ə ɖ ə k ɳ e
भडकणे	bʱ ə ɖ ə k ɳ ə
भणभणणे	bʱ ə ɳ bʱ ə ɳ ɳ e
भणभणणे	bʱ ə ɳ bʱ ə ɳ ɳ ə
भर	bʱ ə ɾ
भरणे	bʱ ə ɾ ɳ e
भरणे	bʱ ə ɾ ɳ ə
भरवणे	bʱ ə ɾ ə ʋ ɳ e
भरवणे	bʱ ə ɾ ə ʋ ɳ ə
भांडण	bʱ a ɳ ɖ ə ɳ
भांडणे	bʱ a ɳ ɖ ə ɳ e
भांडणे	bʱ a ɳ ɖ ə ɳ ə
भांडवल	bʱ a ɳ ɖ ə ʋ ə l
भाऊ	bʱ a u
भाकरी	bʱ a k ɾ i
भाची	bʱ a t͡ɕ i
भात	bʱ a t̪
भारत	bʱ a ɾ ə t̪
भारतीय	bʱ a ɾ t̪ i j ə
भावंड	bʱ a ʋ ə ɳ ɖ ə
भावजय	bʱ a ʋ d͡z ə j
भाषा	bʱ a ʂ a
भाषांतर	bʱ a ʂ a n t̪ ə ɾ
भाषांतरकार	bʱ a ʂ a n t̪ ə ɾ k a ɾ
भाषाकुळ	bʱ a ʂ a k u ɭ̆
भाषाविज्ञान	bʱ a ʂ a ʋ i d͡ʑ n a n
भासणे	bʱ a s ɳ e
भासणे	bʱ a s ɳ ə
भिंत	bʱ i n t̪ ə
भिडणे	bʱ i ɖ ɳ e
भिडणे	bʱ i ɖ ɳ ə
भिणे	bʱ i ɳ e
भिणे	bʱ i ɳ ə
भिनणे	bʱ i n ɳ e
भिनणे	bʱ i n ɳ ə
भिस्मिल्ला	bʱ i s m i l l a
भीक	bʱ i k
भीती	bʱ i t̪ i
भुई	bʱ u i
भू	bʱ u
भूक	bʱ u k
भूकंप	bʱ u k ə m p ə
भूगोल	bʱ u ɡ o l
भूतान	bʱ u t̪ a n
भूमिती	bʱ u m i t̪ i
भूल	bʱ u l
भें	bʱ ẽ
भेद	bʱ e d̪
भेदभाव	bʱ e d̪ bʱ a ʋ
भेळ	bʱ e ɭ̆
भोक	bʱ o k
भोके	bʱ o k e
भोके	bʱ o k ə
भोजपुरी	bʱ o d͡ʑ p u ɾ i
भोळे	bʱ o ɭ̆ e
भोळे	bʱ o ɭ̆ ə
भोवरा	bʱ o ʋ ɾ a
भौतिक	bʱ ə u t̪ i k
भौतिकशास्त्र	bʱ ə u t̪ i k ɕ a s t̪ ɾ ə
म	m ə
मंगळवार	m ə ŋ ɡ ə ɭ̆ ʋ a ɾ
मंगेशकर	m ə ŋ ɡ e ɕ k ə ɾ
मंडई	m ə ɳ ɖ ə i
मंडळ	m ə ɳ ɖ ə ɭ̆
मंत्री	m ə n t̪ ɾ i
मंदी	m ə n d̪ i
मऊ	m ə u
मकर	m ə k ə ɾ
मका	m ə k a
मग	m ə ɡ
मगर	m ə ɡ ə ɾ
मजबूत	m ə d͡z b u t̪
मजला	m ə d͡z l a
मजा	m ə d͡ʑ a
मज्जा	m ə d͡ʑ d͡ʑ a
मडगाव	m ə ɖ ɡ a ʋ
मढवणे	m ə ɖʱ ə ʋ ɳ e
मढवणे	m ə ɖʱ ə ʋ ɳ ə
मत्सर	m ə t̪ s ə ɾ
मदत	m ə d̪ ə t̪
मद्य	m ə d̪ j ə
मध	m ə d̪ʱ
मधमाशी	m ə d̪ʱ m a ɕ i
मधु	m ə d̪ʱ u
मध्य	m ə d̪ʱ j ə
मध्ये	m ə d̪ʱ e
मध्ये	m ə d̪ʱ j e
मन	m ə n
मनगट	m ə n ɡ ə ʈ
मनसुबा	m ə n s u b a
मनस्थिती	m ə n ə s t̪ʰ i t̪ i
मनुष्य	m ə n u ʂ j ə
मने	m ə n e
मने	m ə n ə
मनोरंजन	m ə n o ɾ ə n d͡ʑ ə n
मनोरा	m ə n o ɾ a
मरण	m ə ɾ ə ɳ
मरणे	m ə ɾ ɳ e
मरणे	m ə ɾ ɳ ə
मराठा	m ə ɾ a ʈʰ a
मराठी	m ə ɾ a ʈʰ i
मलपृष्ठ	m ə l p ɾ u ʂ ʈʰ ə
मला	m ə l a
मलूल	m ə l u l
मलेशिया	m ə l e ɕ i j a
मशीद	m ə ɕ i d̪
मस्करी	m ə s k ə ɾ i
मस्का	m ə s k a
मस्त	m ə s t̪ ə
महत्त्व	m ə ɦ ə t̪ t̪ ʋ ə
महत्व	m ə ɦ ə t̪ ʋ ə
महाग	m ə ɦ a ɡ
महान	m ə ɦ a n
महामंडळ	m ə ɦ a m ə ɳ ɖ ə ɭ̆
महायान	m ə ɦ a j a n
महाराष्ट्र	m ə ɦ a ɾ a ʂ ʈ ɾ ə
महाविद्यालय	m ə ɦ a ʋ i d̪ j a l ə j
मांजर	m a n d͡z ə ɾ
मांडणे	m a ɳ ɖ ə ɳ e
मांडणे	m a ɳ ɖ ə ɳ ə
मांदूस	m a n d̪ u s
मांस	m a u s ə
माकड	m a k ə ɖ
माकडे	m a k ɖ e
माकडे	m a k ɖ ə
मागणी	m a ɡ ɳ i
मागणे	m a ɡ ɳ e
मागणे	m a ɡ ɳ ə
मागे	m a ɡ e
मागे	m a ɡ ə
माज	m a d͡z
माजी	m a d͡ʑ i
माझे	m a d͡zʱ e
माणसे	m a ɳ s e
माणसे	m a ɳ s ə
माणूस	m a ɳ u s
मातृभाषा	m a t̪ ɾ u bʱ a ʂ a
मान	m a n
मानणे	m a n ɳ e
मानणे	m a n ɳ ə
मानसिक	m a n s i k
मानसिकता	m a n s i k t̪ a
माने	m a n e
मामा	m a m a
मामी	m a m i
मायबोली	m a j b o l i
मारणे	m a ɾ ɳ e
मारणे	m a ɾ ɳ ə
मारेकरी	m a ɾ e k ɾ i
मार्ग	m a ɾ ɡ ə
मार्च	m a ɾ t͡ɕ ə
मालक	m a l ə k
माळ	m a ɭ̆
माळी	m a ɭ̆ i
मावणे	m a ʋ ɳ e
मावणे	m a ʋ ɳ ə
माशी	m a ɕ i
मासा	m a s a
माहीत	m a ɦ i t̪
माहेर	m a ɦ e ɾ
मिटणे	m i ʈ ɳ e
मिटणे	m i ʈ ɳ ə
मिठी	m i ʈʰ i
मिठ्या	m i ʈʰ j a
मिथुन	m i t̪ʰ u n
मिरवणे	m i ɾ ə ʋ ɳ e
मिरवणे	m i ɾ ə ʋ ɳ ə
मिळणे	m i ɭ̆ ɳ e
मिळणे	m i ɭ̆ ɳ ə
मिळवणे	m i ɭ̆ ə ʋ ɳ e
मिळवणे	m i ɭ̆ ə ʋ ɳ ə
मिशी	m i ɕ i
मिसळ	m i s ə ɭ̆
मिसळणे	m i s ə ɭ̆ ɳ e
मिसळणे	m i s ə ɭ̆ ɳ ə
मीठ	m i ʈʰ
मीन	m i n
मुंगी	m u ŋ ɡ i
मुंगूस	m u ŋ ɡ u s
मुंबई	m u m b ə i
मुंबा	m u m b a
मुकणे	m u k ɳ e
मुकणे	m u k ɳ ə
मुके	m u k e
मुके	m u k ə
मुक्काम	m u k k a m
मुक्त	m u k t̪ ə
मुक्ती	m u k t̪ i
मुख	m u kʰ
मुख्य	m u kʰ j ə
मुख्यमंत्री	m u kʰ j ə m ə n t̪ ɾ i
मुख्याध्यापक	m u kʰ j a d̪ʱ j a p ə k
मुतणे	m u t̪ ɳ e
मुतणे	m u t̪ ɳ ə
मुद्दा	m u d̪ d̪ a
मुद्दाम	m u d̪ d̪ a m
मुलगी	m u l ɡ i
मुलायम	m u l a j ə m
मुले	m u l e
मुले	m u l ə
मुळा	m u ɭ̆ a
मुळे	m u ɭ̆ e
मुळे	m u ɭ̆ ə
मुश्कील	m u ɕ k i l
मुसळ	m u s ə ɭ̆
मूग	m u ɡ
मूठ	m u ʈʰ
मूत्र	m u t̪ ɾ ə
मूल	m u l
मूळ	m u ɭ̆
मृत	m ɾ u t̪ ə
मे	m e
मेंदी	m e n d̪ i
मेंदू	m e n d̪ u
मेघ	m e ɡʱ
मेज	m e d͡z
मेण	m e ɳ
मेणबत्ती	m e ɳ b ə t̪ t̪ i
मेथी	m e t̪ʰ i
मेष	m e ʂ
मेहनत	m e ɦ n ə t̪
मेहनती	m e ɦ ə n t̪ i
मैथिली	m ə i t̪ʰ i l i
मैदा	m ə i d̪ a
मैदान	m ə i d̪ a n
मोका	m o k a
मोजणे	m o d͡z ɳ e
मोजा	m o d͡z a
मोटारसायकल	m o ʈ a ɾ s a j k ə l
मोडणे	m o ɖ ɳ e
मोडणे	m o ɖ ɳ ə
मोडी	m o ɖ i
मोहीम	m o ɦ i m
म्हणणे	mʱ ə ɳ ɳ e
म्हणणे	mʱ ə ɳ ɳ ə
म्हणवणे	mʱ ə ɳ ə ʋ ɳ e
म्हणवणे	mʱ ə ɳ ə ʋ ɳ ə
म्हणून	mʱ ə ɳ u n
य	j ə
यंत्रमानव	j ə n t̪ ɾ ə m a n ə ʋ
यम	j ə m
यादी	j a d̪ i
यान	j a n
युरेनस	j u ɾ e n ə s
येणे	j e ɳ e
येणे	j e ɳ ə
योग्य	j o ɡ j ə
र	ɾ ə
रंग	ɾ ə ŋ ɡ ə
रंगणे	ɾ ə ŋ ɡ ə ɳ e
रंगणे	ɾ ə ŋ ɡ ə ɳ ə
रक्त	ɾ ə k t̪ ə
रक्तगट	ɾ ə k t̪ ə ɡ ə ʈ
रक्तदाब	ɾ ə k t̪ ə d̪ a b
रक्तपेढी	ɾ ə k t̪ ə p e ɖʱ i
रक्तपेशी	ɾ ə k t̪ ə p e ɕ i
रक्तवाहिनी	ɾ ə k t̪ ə ʋ a ɦ i n i
रक्तवाहिन्या	ɾ ə k t̪ ə ʋ a ɦ i n j a
रक्ताभिसरण	ɾ ə k t̪ a bʱ i s ɾ ə ɳ
रचणे	ɾ ə t͡s ɳ e
रचणे	ɾ ə t͡s ɳ ə
रडणे	ɾ ə ɖ ɳ e
रडणे	ɾ ə ɖ ɳ ə
रडवणे	ɾ ə ɖ ə ʋ ɳ e
रडवणे	ɾ ə ɖ ə ʋ ɳ ə
रताळे	ɾ ə t̪ a ɭ̆ e
रताळे	ɾ ə t̪ a ɭ̆ ə
रद्द	ɾ ə d̪ d̪ ə
रबर	ɾ ə b ə ɾ
रबरी	ɾ ə b ɾ i
रमजान	ɾ ə m d͡z a n
रमणे	ɾ ə m ɳ e
रमणे	ɾ ə m ɳ ə
रयत	ɾ ə j ə t̪
रवा	ɾ ə ʋ a
रविवार	ɾ ə ʋ i ʋ a ɾ
रशियन	ɾ ə ɕ i j ə n
रशिया	ɾ ə ɕ i j a
रस	ɾ ə s
रसायन	ɾ ə s a j ə n
रसायनशास्त्र	ɾ ə s a j ə n ɕ a s t̪ ɾ ə
रसायने	ɾ ə s a j n e
रसायने	ɾ ə s a j n ə
रस्ता	ɾ ə s t̪ a
रहस्य	ɾ ə ɦ ə s j ə
रांगोळी	ɾ a ŋ ɡ o ɭ̆ i
राई	ɾ a i
राऊ	ɾ a u
राऊत	ɾ a u t̪
राकस	ɾ a k ə s
राखणे	ɾ a kʰ ɳ e
राखणे	ɾ a kʰ ɳ ə
राखाडी	ɾ a kʰ a ɖ i
राग	ɾ a ɡ
राजकारण	ɾ a d͡ʑ k a ɾ ə ɳ
राजकारणी	ɾ a d͡ʑ k a ɾ ɳ i
राजधानी	ɾ a d͡ʑ d̪ʱ a n i
राजस्थान	ɾ a d͡ʑ ə s t̪ʰ a n
राजा	ɾ a d͡ʑ a
राजी	ɾ a d͡z i
राजी	ɾ a d͡ʑ i
राज्यपाल	ɾ a d͡ʑ j ə p a l
राज्यभाषा	ɾ a d͡ʑ j ə bʱ a ʂ a
राणी	ɾ a ɳ i
रात्र	ɾ a t̪ ɾ ə
राबणे	ɾ a b ɳ e
राबणे	ɾ a b ɳ ə
राव	ɾ a ʋ
राष्ट्र	ɾ a ʂ ʈ ɾ ə
राष्ट्रपती	ɾ a ʂ ʈ ɾ ə p t̪ i
राष्ट्रभाषा	ɾ a ʂ ʈ ɾ ə bʱ a ʂ a
राष्ट्रवाद	ɾ a ʂ ʈ ɾ ə ʋ a d̪
राष्ट्रवादी	ɾ a ʂ ʈ ɾ ə ʋ a d̪ i
राष्ट्रीय	ɾ a ʂ ʈ ɾ i j ə
रास	ɾ a s
राहणे	ɾ a ɦ ɳ e
राहणे	ɾ a ɦ ɳ ə
रिकामे	ɾ i k a m e
रिकामे	ɾ i k a m ə
रीत	ɾ i t̪
रुंदी	ɾ u n d̪ i
रुंद्या	ɾ u n d̪ j a
रुग्ण	ɾ u ɡ ɳ ə
रुग्णवाहिका	ɾ u ɡ ɳ ə ʋ a ɦ i k a
रुग्णालय	ɾ u ɡ ɳ a l ə j
रुजणे	ɾ u d͡z ɳ e
रुजणे	ɾ u d͡z ɳ ə
रुतणे	ɾ u t̪ ɳ e
रुतणे	ɾ u t̪ ɳ ə
रुमाल	ɾ u m a l
रुळणे	ɾ u ɭ̆ ɳ e
रुळणे	ɾ u ɭ̆ ɳ ə
रुसणे	ɾ u s ɳ e
रुसणे	ɾ u s ɳ ə
रेखा	ɾ e kʰ a
रेखागणित	ɾ e kʰ a ɡ ɳ i t̪
रेघ	ɾ e ɡʱ
रेषा	ɾ e ʂ a
रोकड	ɾ o k ə ɖ
रोख	ɾ o kʰ
रोज	ɾ o d͡z
रोजा	ɾ o d͡ʑ a
रोटी	ɾ o ʈ i
र्‍	r
ल	l ə
लंड	l ə ɳ ɖ ə
लक्ष्मी	l ə k ʂ m i
लखनऊ	l ə kʰ n ə u
लखनौ	l ə kʰ n ə u
लग्न	l ə ɡ n ə
लटकणे	l ə ʈ ə k ɳ e
लटकणे	l ə ʈ ə k ɳ ə
लटकावणे	l ə ʈ k a ʋ ɳ e
लटकावणे	l ə ʈ k a ʋ ɳ ə
लढवणे	l ə ɖʱ ə ʋ ɳ e
लढवणे	l ə ɖʱ ə ʋ ɳ ə
लपवणे	l ə p ə ʋ ɳ e
लपवणे	l ə p ə ʋ ɳ ə
लफडे	l ə pʰ ɖ e
लफडे	l ə pʰ ɖ ə
लबाड	l ə b a ɖ
लवणे	l ə ʋ ɳ e
लवणे	l ə ʋ ɳ ə
लहर	l ə ɦ ə ɾ
लहान	l ə ɦ a n
लांडे	l a ɳ ɖ e
लांडे	l a ɳ ɖ ə
लांब	l a m b ə
लांबणे	l a m b ə ɳ e
लांबणे	l a m b ə ɳ ə
लांबी	l a m b i
लांब्या	l a m b j a
लाओस	l a o s
लाख	l a kʰ
लाज	l a d͡z
लाजणे	l a d͡z ɳ e
लाजणे	l a d͡z ɳ ə
लाट	l a ʈ
लाटणे	l a ʈ ɳ e
लाटणे	l a ʈ ɳ ə
लातूर	l a t̪ u ɾ
लाथ	l a t̪ʰ
लादणे	l a d̪ ɳ e
लादणे	l a d̪ ɳ ə
लाल	l a l
लाळ	l a ɭ̆
लाही	l a ɦ i
लाहोर	l a ɦ o ɾ
लाह्या	l a ɦ j a
लिंग	l i ŋ ɡ ə
लिलाव	l i l a ʋ
लिहिणे	l i ɦ i ɳ e
लिहिणे	l i ɦ i ɳ ə
लेख	l e kʰ
लेखक	l e kʰ ə k
लेखणी	l e kʰ ɳ i
लेखण्या	l e kʰ ə ɳ j a
लेखन	l e kʰ ə n
लेखिका	l e kʰ i k a
लोकशाही	l o k ɕ a ɦ i
लोखंड	l o kʰ ə ɳ ɖ ə
लोळणे	l o ɭ̆ ɳ e
लोळणे	l o ɭ̆ ɳ ə
लोह	l o ɦ
लोहार	l o ɦ a ɾ
ल्हासा	lʱ a s a
ळ	ɭ̆ ə
व	ʋ ə
वगळणे	ʋ ə ɡ ə ɭ̆ ɳ e
वगळणे	ʋ ə ɡ ə ɭ̆ ɳ ə
वडील	ʋ ə ɖ i l
वय	ʋ ə j
वये	ʋ ə j e
वये	ʋ ə j ə
वर	ʋ ə ɾ
वरात	ʋ ə ɾ a t̪
वरीस	ʋ ə ɾ i s
वर्ग	ʋ ə ɾ ɡ ə
वर्ण	ʋ ə ɾ ɳ ə
वर्धापनदिन	ʋ ə ɾ d̪ʱ a p ə n d̪ i n
वर्ष	ʋ ə ɾ ʂ ə
वर्षा	ʋ ə ɾ ʂ a
वळण	ʋ ə ɭ̆ ə ɳ
वळणे	ʋ ə ɭ̆ ɳ e
वळणे	ʋ ə ɭ̆ ɳ ə
वसंत	ʋ ə s ə n t̪
वहाण	ʋ ə ɦ a ɳ
वहिणी	ʋ ə ɦ i ɳ i
वहिनी	ʋ ə ɦ i n i
वही	ʋ ə ɦ i
वह्या	ʋ ə ɦ j a
वांगं	ʋ a ŋ ɡ ə
वांगे	ʋ a ŋ ɡ e
वाकडे	ʋ a k ɖ e
वाकडे	ʋ a k ɖ ə
वागणे	ʋ a ɡ ɳ e
वागणे	ʋ a ɡ ɳ ə
वाचणे	ʋ a t͡s ɳ e
वाचणे	ʋ a t͡s ɳ ə
वाचन	ʋ a t͡ɕ ə n
वाचवणे	ʋ a t͡s ə ʋ ɳ e
वाचवणे	ʋ a t͡s ə ʋ ɳ ə
वाजणे	ʋ a d͡z ɳ e
वाजणे	ʋ a d͡z ɳ ə
वाजवणे	ʋ a d͡z ə ʋ ɳ e
वाजवणे	ʋ a d͡z ə ʋ ɳ ə
वाट	ʋ a ʈ
वाटणे	ʋ a ʈ ɳ e
वाटणे	ʋ a ʈ ɳ ə
वाडी	ʋ a ɖ i
वाढ	ʋ a ɖʱ
वाढणे	ʋ a ɖʱ ɳ e
वाढणे	ʋ a ɖʱ ɳ ə
वाढदिवस	ʋ a ɖʱ d̪ i ʋ ə s
वानर	ʋ a n ə ɾ
वापरणे	ʋ a p ə ɾ ɳ e
वायदा	ʋ a j d̪ a
वायव्य	ʋ a j ə ʋ j ə
वायू	ʋ a j u
वार	ʋ a ɾ
वारणे	ʋ a ɾ ɳ e
वारणे	ʋ a ɾ ɳ ə
वारा	ʋ a ɾ a
वाळणे	ʋ a ɭ̆ ɳ e
वाळणे	ʋ a ɭ̆ ɳ ə
वाळवंट	ʋ a ɭ̆ ʋ ə ɳ ʈ ə
वाळवणे	ʋ a ɭ̆ ə ʋ ɳ e
वाळवणे	ʋ a ɭ̆ ə ʋ ɳ ə
वाळू	ʋ a ɭ̆ u
वास	ʋ a s
वास्तु	ʋ a s t̪ u
वाहक	ʋ a ɦ ə k
वाहणे	ʋ a ɦ ɳ e
वाहणे	ʋ a ɦ ɳ ə
वाहिका	ʋ a ɦ i k a
विंचरणे	ʋ i n t͡s ə ɾ ɳ e
विंचरणे	ʋ i n t͡s ə ɾ ɳ ə
विंचू	ʋ i n t͡s u
विखुरणे	ʋ i kʰ u ɾ ɳ e
विखुरणे	ʋ i kʰ u ɾ ɳ ə
विचार	ʋ i t͡ɕ a ɾ
विचारणे	ʋ i t͡ɕ a ɾ ɳ e
विचारणे	ʋ i t͡ɕ a ɾ ɳ ə
विजय	ʋ i d͡ʑ ə j
विज्ञान	ʋ i d͡ʑ n a n
विझणे	ʋ i d͡zʱ ɳ e
विझणे	ʋ i d͡zʱ ɳ ə
विझवणे	ʋ i d͡zʱ ə ʋ ɳ e
विझवणे	ʋ i d͡zʱ ə ʋ ɳ ə
विडूर	ʋ i ɖ u ɾ
वितरण	ʋ i t̪ ɾ ə ɳ
वितळणे	ʋ i t̪ ə ɭ̆ ɳ e
वितळणे	ʋ i t̪ ə ɭ̆ ɳ ə
विनंती	ʋ i n ə n t̪ i
विमान	ʋ i m a n
विमाने	ʋ i m a n e
विमाने	ʋ i m a n ə
विलायत	ʋ i l a j ə t̪
विशिष्ट	ʋ i ɕ i ʂ ʈ ə
विशेष	ʋ i ɕ e ʂ
विशेषण	ʋ i ɕ e ʂ ə ɳ
विश्व	ʋ i ɕ ʋ ə
विष	ʋ i ʂ
विषाणू	ʋ i ʂ a ɳ u
विषारी	ʋ i ʂ a ɾ i
विषारीपणा	ʋ i ʂ a ɾ i p ə ɳ a
विसरणे	ʋ i s ə ɾ ɳ e
विसरणे	ʋ i s ə ɾ ɳ ə
विसळणे	ʋ i s ə ɭ̆ ɳ e
विसळणे	ʋ i s ə ɭ̆ ɳ ə
विस्कटणे	ʋ i s k ə ʈ ɳ e
विस्कटणे	ʋ i s k ə ʈ ɳ ə
विहीर	ʋ i ɦ i ɾ
वीज	ʋ i d͡z
वीट	ʋ i ʈ
वीस	ʋ i s
वृक्ष	ʋ ɾ u k ʂ ə
वृश्चिक	ʋ ɾ u ɕ t͡ɕ i k
वृषभ	ʋ ɾ u ʂ ə bʱ
वेगळे	ʋ e ɡ ɭ̆ e
वेगळेपण	ʋ e ɡ ɭ̆ e p ə ɳ
वेधणे	ʋ e d̪ʱ ɳ e
वेधणे	ʋ e d̪ʱ ɳ ə
वेलची	ʋ e l t͡ɕ i
वेळ	ʋ e ɭ̆
वैज्ञानिक	ʋ ə i d͡ʑ n a n i k
वैतागणे	ʋ ə i t̪ a ɡ ɳ e
वैतागणे	ʋ ə i t̪ a ɡ ɳ ə
वैध	ʋ ə i d̪ʱ
व्यक्ती	ʋ j ə k t̪ i
व्यवसाय	ʋ j ə ʋ s a j
व्याकरण	ʋ j a k ɾ ə ɳ
व्याख्या	ʋ j a kʰ j a
व्याही	ʋ j a ɦ i
व्रण	ʋ ɾ ə ɳ
व्हियेतनाम	ʋʱ i j e t̪ n a m
श	ɕ ə
शंभर	ɕ ə m bʱ ə ɾ
शकणे	ɕ ə k ɳ e
शक्ती	ɕ ə k t̪ i
शक्य	ɕ ə k j ə
शत्रू	ɕ ə t̪ ɾ u
शनिवार	ɕ ə n i ʋ a ɾ
शब्द	ɕ ə b d̪ ə
शब्दकोश	ɕ ə b d̪ ə k o ɕ
शब्दकोष	ɕ ə b d̪ ə k o ʂ
शरम	ɕ ə ɾ ə m
शरीर	ɕ ə ɾ i ɾ
शर्करा	ɕ ə ɾ k ə ɾ a
शर्मा	ɕ ə ɾ m a
शहर	ɕ ə ɦ ə ɾ
शहरी	ɕ ə ɦ ɾ i
शहा	ɕ ə ɦ a
शांत	ɕ a n t̪ ə
शाबास	ɕ a b a s
शाब्दिक	ɕ a b d̪ i k
शाल	ɕ a l
शाळा	ɕ a ɭ̆ a
शास्त्र	ɕ a s t̪ ɾ ə
शास्त्रज्ञ	ɕ a s t̪ ɾ ə d͡ʑ n ə
शाहीर	ɕ a ɦ i ɾ
शिंक	ɕ i ŋ k ə
शिंकणे	ɕ i ŋ k ɳ e
शिंकणे	ɕ i ŋ k ɳ ə
शिंग	ɕ i ŋ ɡ ə
शिंतोडा	ɕ i n t̪ o ɖ a
शिंपडणे	ɕ i m p ə ɖ ɳ e
शिंपडणे	ɕ i m p ə ɖ ɳ ə
शिकणे	ɕ i k ɳ e
शिकणे	ɕ i k ɳ ə
शिकवणे	ɕ i k ə ʋ ɳ e
शिकवणे	ɕ i k ə ʋ ɳ ə
शिक्का	ɕ i k k a
शिक्षक	ɕ i k ʂ ə k
शिक्षण	ɕ i k ʂ ə ɳ
शिक्षा	ɕ i k ʂ a
शिक्षिका	ɕ i k ʂ i k a
शिजणे	ɕ i d͡z ɳ e
शिजणे	ɕ i d͡z ɳ ə
शिट्टी	ɕ i ʈ ʈ i
शिफारस	ɕ i pʰ a ɾ ə s
शिर्डी	ɕ i ɾ ɖ i
शिला	ɕ i l a
शिळे	ɕ i ɭ̆ e
शिळे	ɕ i ɭ̆ ə
शीर	ɕ i ɾ
शुक्रवार	ɕ u k ɾ ə ʋ a ɾ
शुद्ध	ɕ u d̪ d̪ʱ ə
शुश्रूषा	ɕ u ɕ ɾ u ʂ a
शेंडी	ɕ e ɳ ɖ i
शेकणे	ɕ e k ɳ e
शेकणे	ɕ e k ɳ ə
शेजारी	ɕ e d͡z a ɾ i
शेट	ɕ e ʈ
शेण	ɕ e ɳ
शेत	ɕ e t̪
शेतकरी	ɕ e t̪ ə k ɾ i
शेपटा	ɕ e p ʈ a
शेळी	ɕ e ɭ̆ i
शेवट	ɕ e ʋ ə ʈ
शेहेचाळीस	ɕ e ɦ e t͡ɕ a ɭ̆ i s
शैक्षणिक	ɕ ə i k ʂ ə ɳ i k
शोध	ɕ o d̪ʱ
शोभणे	ɕ o bʱ ɳ e
शोभणे	ɕ o bʱ ɳ ə
शोषण	ɕ o ʂ ə ɳ
शोषणे	ɕ o ʂ ɳ e
श्री	ɕ ɾ i
श्रीमंत	ɕ ɾ i m ə n t̪ ə
ष	ʂ ə
स	s ə
संकेतस्थळ	s ə ŋ k e t̪ ə s t̪ʰ ə ɭ̆
संकेतस्थळे	s ə ŋ k e t̪ ə s t̪ʰ ə ɭ̆ e
संकेतस्थळे	s ə ŋ k e t̪ ə s t̪ʰ ə ɭ̆ ə
संख्या	s ə ŋ kʰ j a
संगम	s ə ŋ ɡ ə m
संगीतकार	s ə ŋ ɡ i t̪ k a ɾ
संघ	s ə ŋ ɡʱ ə
संघटना	s ə ŋ ɡʱ ə ʈ n a
संदेश	s ə n d̪ e ɕ
संपणे	s ə m p ɳ e
संपणे	s ə m p ɳ ə
संभवणे	s ə m bʱ ə ʋ ɳ e
संभवणे	s ə m bʱ ə ʋ ɳ ə
संभाळणे	s ə m bʱ a ɭ̆ ɳ e
संभाळणे	s ə m bʱ a ɭ̆ ɳ ə
संवाद	s ə u ʋ a d̪
संस्कृत	s ə u s k ɾ u t̪
संहार	s ə u ɦ a ɾ
सकाळ	s ə k a ɭ̆
सक्त	s ə k t̪ ə
सगळे	s ə ɡ ɭ̆ e
सगळे	s ə ɡ ɭ̆ ə
सजवणे	s ə d͡z ə ʋ ɳ e
सजवणे	s ə d͡z ə ʋ ɳ ə
सजीव	s ə d͡ʑ i ʋ
सज्ज	s ə d͡ʑ d͡ʑ ə
सटकणे	s ə ʈ ə k ɳ e
सटकणे	s ə ʈ ə k ɳ ə
सडणे	s ə ɖ ɳ e
सडणे	s ə ɖ ɳ ə
सण	s ə ɳ
सतरा	s ə t̪ ɾ a
सतावणे	s ə t̪ a ʋ ɳ e
सतावणे	s ə t̪ a ʋ ɳ ə
सत्तावीस	s ə t̪ t̪ a ʋ i s
सत्तेचाळीस	s ə t̪ t̪ e t͡ɕ a ɭ̆ i s
सदतीस	s ə d̪ t̪ i s
सप्टेंबर	s ə p ʈ e m b ə ɾ
सफरचंद	s ə pʰ ə ɾ t͡ɕ ə n d̪ ə
सफरचंदे	s ə pʰ ə ɾ t͡ɕ ə n d̪ e
सफरचंदे	s ə pʰ ə ɾ t͡ɕ ə n d̪ ə
सफेद	s ə pʰ e d̪
सबब	s ə b ə b
सभा	s ə bʱ a
समजणे	s ə m ə d͡z ɳ e
समजणे	s ə m ə d͡z ɳ ə
समाज	s ə m a d͡ʑ
समाजवाद	s ə m a d͡ʑ ʋ a d̪
समृद्ध	s ə m ɾ u d̪ d̪ʱ ə
समोर	s ə m o ɾ
सम्मुख	s ə m m u kʰ
सरकणे	s ə ɾ ə k ɳ e
सरकणे	s ə ɾ ə k ɳ ə
सरकार	s ə ɾ k a ɾ
सरणे	s ə ɾ ɳ e
सरणे	s ə ɾ ɳ ə
सरहद्द	s ə ɾ ɦ ə d̪ d̪ ə
सराफ	s ə ɾ a pʰ
सरोवर	s ə ɾ o ʋ ə ɾ
सर्प	s ə ɾ p ə
सल	s ə l
सलणे	s ə l ɳ e
सलणे	s ə l ɳ ə
सलाम	s ə l a m
सल्लागार	s ə l l a ɡ a ɾ
सवत	s ə ʋ ə t̪
सवय	s ə ʋ ə j
सव्वीस	s ə ʋ ʋ i s
सव्हाना	s ə ʋʱ a n a
ससा	s ə s a
सहनशीलता	s ə ɦ n ə ɕ i l t̪ a
सहल	s ə ɦ ə l
सहा	s ə ɦ a
सांगणे	s a ŋ ɡ ɳ e
सांगणे	s a ŋ ɡ ɳ ə
सांज	s a n d͡z
सांडणे	s a ɳ ɖ ə ɳ e
सांडणे	s a ɳ ɖ ə ɳ ə
सांधणे	s a n d̪ʱ ə ɳ e
सांधणे	s a n d̪ʱ ə ɳ ə
सांबार	s a m b a ɾ
साखर	s a kʰ ə ɾ
साखळी	s a kʰ ɭ̆ i
साचणे	s a t͡s ɳ e
साचणे	s a t͡s ɳ ə
साठ	s a ʈʰ
साठणे	s a ʈʰ ɳ e
साठणे	s a ʈʰ ɳ ə
साडी	s a ɖ i
साडू	s a ɖ u
सात	s a t̪
साधणे	s a d̪ʱ ɳ e
साधणे	s a d̪ʱ ɳ ə
साधे	s a d̪ʱ e
साधे	s a d̪ʱ ə
साप	s a p
सामना	s a m n a
सामान	s a m a n
सामान्य	s a m a n j ə
सामावणे	s a m a ʋ ɳ e
सामावणे	s a m a ʋ ɳ ə
साम्यवाद	s a m j ə ʋ a d̪
साम्यवादी	s a m j ə ʋ a d̪ i
सायप्रस	s a j ə p ɾ ə s
सार	s a ɾ
सारणी	s a ɾ ɳ i
सारण्या	s a ɾ ə ɳ j a
साल	s a l
साली	s a l i
साळ	s a ɭ̆
सासू	s a s u
साहित्य	s a ɦ i t̪ j ə
सिंगापूर	s i ŋ ɡ a p u ɾ
सिंह	s i u ɦ ə
सुंदर	s u n d̪ ə ɾ
सुईण	s u i ɳ
सुकणे	s u k ɳ e
सुकणे	s u k ɳ ə
सुकवणे	s u k ə ʋ ɳ e
सुकवणे	s u k ə ʋ ɳ ə
सुचणे	s u t͡s ɳ e
सुचणे	s u t͡s ɳ ə
सुचवणे	s u t͡s ə ʋ ɳ e
सुचवणे	s u t͡s ə ʋ ɳ ə
सुजणे	s u d͡z ɳ e
सुजणे	s u d͡z ɳ ə
सुटणे	s u ʈ ɳ e
सुटणे	s u ʈ ɳ ə
सुटे	s u ʈ e
सुटे	s u ʈ ə
सुद्धा	s u d̪ d̪ʱ a
सुनावणे	s u n a ʋ ɳ e
सुनावणे	s u n a ʋ ɳ ə
सुपारी	s u p a ɾ i
सुभा	s u bʱ a
सुरू	s u ɾ u
सुस्ती	s u s t̪ i
सूड	s u ɖ
सूत	s u t̪
सूर्य	s u ɾ j ə
सूर्यकिरण	s u ɾ j ə k i ɾ ə ɳ
सूर्यमाला	s u ɾ j ə m a l a
सूर्यास्त	s u ɾ j a s t̪ ə
सूर्योदय	s u ɾ j o d̪ ə j
सेटिंग	s e ʈ i ŋ ɡ ə
सैल	s ə i l
सोंग	s o ŋ ɡ ə
सोडचे	s o ɖ t͡ɕ e
सोडचे	s o ɖ t͡ɕ ə
सोडणे	s o ɖ ɳ e
सोडणे	s o ɖ ɳ ə
सोडवणे	s o ɖ ə ʋ ɳ e
सोडवणे	s o ɖ ə ʋ ɳ ə
सोने	s o n e
सोने	s o n ə
सोनेरी	s o n e ɾ i
सोपवणे	s o p ə ʋ ɳ e
सोपवणे	s o p ə ʋ ɳ ə
सोपे	s o p e
सोमवार	s o m ʋ a ɾ
सोलापूर	s o l a p u ɾ
सोळा	s o ɭ̆ a
सोसणे	s o s ɳ e
सोसणे	s o s ɳ ə
सोहळा	s o ɦ ɭ̆ a
स्तन	s t̪ ə n
स्त्रीलिंग	s t̪ ɾ i l i ŋ ɡ ə
स्थळ	s t̪ʰ ə ɭ̆
स्थान	s t̪ʰ a n
स्थानक	s t̪ʰ a n ə k
स्थाने	s t̪ʰ a n e
स्थाने	s t̪ʰ a n ə
स्थिती	s t̪ʰ i t̪ i
स्थिर	s t̪ʰ i ɾ
स्पष्ट	s p ə ʂ ʈ ə
स्पष्टीकरण	s p ə ʂ ʈ i k ə ɾ ə ɳ
स्वच्छ	s ʋ ə t͡ɕ t͡ɕʰ ə
स्वच्छता	s ʋ ə t͡ɕ t͡ɕʰ ə t̪ a
स्वतः	s ʋ ə t̪ əʰ
स्वप्न	s ʋ ə p n ə
स्वप्ने	s ʋ ə p n e
स्वप्ने	s ʋ ə p n ə
स्वराज्य	s ʋ ə ɾ a d͡ʑ j ə
स्वस्त	s ʋ ə s t̪ ə
स्वातंत्र्य	s ʋ a t̪ ə n t̪ ɾ j ə
स्वार	s ʋ a ɾ
स्वीकारणे	s ʋ i k a ɾ ɳ e
स्वीकारणे	s ʋ i k a ɾ ɳ ə
ह	ɦ ə
हंस	ɦ ə u s ə
हक्क	ɦ ə k k ə
हगणे	ɦ ə ɡ ɳ e
हगणे	ɦ ə ɡ ɳ ə
हजार	ɦ ə d͡z a ɾ
हत्यार	ɦ ə t̪ j a ɾ
हद्द	ɦ ə d̪ d̪ ə
हरकत	ɦ ə ɾ k ə t̪
हरणे	ɦ ə ɾ ɳ e
हरणे	ɦ ə ɾ ɳ ə
हलवा	ɦ ə l ʋ a
हल्ला	ɦ ə l l a
हल्ली	ɦ ə l l i
हळू	ɦ ə ɭ̆ u
हवा	ɦ ə ʋ a
हसणे	ɦ ə s ɳ e
हसणे	ɦ ə s ɳ ə
हा	ɦ a
हाक	ɦ a k
हाकलणे	ɦ a k ə l ɳ e
हाकलणे	ɦ a k ə l ɳ ə
हाणणे	ɦ a ɳ ɳ e
हाणणे	ɦ a ɳ ɳ ə
हात	ɦ a t̪
हातोडा	ɦ a t̪ o ɖ a
हार	ɦ a ɾ
हाल	ɦ a l
हालणे	ɦ a l ɳ e
हालणे	ɦ a l ɳ ə
हिंग	ɦ i ŋ ɡ ə
हिंडणे	ɦ i ɳ ɖ ə ɳ e
हिंडणे	ɦ i ɳ ɖ ə ɳ ə
हिंदी	ɦ i n d̪ i
हिंदुस्थान	ɦ i n d̪ u s t̪ʰ a n
हिंदू	ɦ i n d̪ u
हिजडा	ɦ i d͡ʑ ɖ a
हिरा	ɦ i ɾ a
हिवाळा	ɦ i ʋ a ɭ̆ a
हिवाळी	ɦ i ʋ a ɭ̆ i
हिसकणे	ɦ i s ə k ɳ e
हिसकणे	ɦ i s ə k ɳ ə
हिसकावणे	ɦ i s k a ʋ ɳ e
हिसकावणे	ɦ i s k a ʋ ɳ ə
ही	ɦ i
हुतात्मा	ɦ u t̪ a t̪ m a
हुद्दा	ɦ u d̪ d̪ a
हुशार	ɦ u ɕ a ɾ
हृदय	ɦ ɾ u d̪ ə j
हृदये	ɦ ɾ u d̪ j e
हृदये	ɦ ɾ u d̪ j ə
हृद्गत	ɦ ɾ u d̪ ɡ ə t̪
हे	ɦ e
हेतू	ɦ e t̪ u
हेम	ɦ e m
हेर	ɦ e ɾ
हेरणे	ɦ e ɾ ɳ e
हेरणे	ɦ e ɾ ɳ ə
हेलगा	ɦ e l ɡ a
हेवा	ɦ e ʋ a
हैदराबाद	ɦ ə i d̪ ɾ a b a d̪
हैराण	ɦ ə i ɾ a ɳ
हो	ɦ o
होडी	ɦ o ɖ i
होणे	ɦ o ɳ e
होणे	ɦ o ɳ ə
होता	ɦ o t̪ a
होती	ɦ o t̪ i
होते	ɦ o t̪ e
होय	ɦ o j
होळी	ɦ o ɭ̆ i
हौस	ɦ ə u s
ॲ	æ
