Ё	j ɔ
А	a
Австрали	a f s tʰ r a ɮ
Азербайжан	a t͡s j ɵ r p ɛː t͡ɕ a ŋ
Ази	a t͡s
Албани	a ɮ p aˑ n
Александр	a ɮʲ ɵ kʰ s a n t r̥
Алжир	a ɮ t͡ɕ i r̥
Аллах	a ɮ ɮ a x
Алматы	a ɮ m a tʰ i
Алтай	a ɮ tʰ ɛː
Англи	æˑ ŋ ɡ a ɮ
Антарктид	a n tʰ a r̥ kʰ tʰ i t
Арвайхээр	a r w̜ ɛː x eː r̥
Аргентин	a r kʲ ɵ n tʰ i ŋ
Архангай	a r x a ŋ k ɛː
Афганистан	a f k a n i s tʰ a ŋ
Б	p
Багануур	p a ɣ a n ʊː r̥
Багахангай	p a ɣ a x a ŋ k ɛː
Балба	p a ɮ a p
Бангладеш	p a ŋ k ɮ a tʲ ɵ ɕ
Баянгол	p a j a ŋ k ɔ ɮ
Баянхонгор	p a j a ŋ x ɔ ŋ k ɔ r̥
Беларусь	pʲ ɵ ɮ a r ʊ sʲ
Бельги	p e ɮ i k
Битлз	p i tʰ ə ɮ t͡s
Бразил	p r ä t͜s iˑ ɮ
Бразил	p r ɛ t͜s iˑ ɮ
Будда	p ʊ t͉ t a
Булган	p ʊ ɮ k a ŋ
Буриад	p ʊ r i̯ aː t
Бутан	p ʊ tʰ a ŋ
Бээжинг	p eː t͡ɕ i ŋ k
Бээжингийн	p eː t͡ɕ i ŋ k iː ŋ
Бээжингийнх	p eː t͡ɕ i ŋ k iː ŋ x
Бээжингийнхэн	p eː t͡ɕ i ŋ k iː ŋ x e ŋ
Бээжингээр	p eː t͡ɕ i ŋ k eː r̥
Бээжингээс	p eː t͡ɕ i ŋ k eː s
Бээжингүй	p eː t͡ɕ i ŋ k u i̯
Бээжинд	p eː t͡ɕ i n t
Бээжинтэй	p eː t͡ɕ i n tʰ e i̯
Бөртийг	p ɵ r̥ tʰ iː k
Бөртийн	p ɵ r̥ tʰ iː ŋ
Бөртийнд	p ɵ r̥ tʰ iː n t
Бөртэ	p ɵ r̥ tʰ
Бөртэгүй	p ɵ r̥ tʰ e ɣ u i̯
Бөртэд	p ɵ r̥ tʰ e t
Бөртэтэй	p ɵ r̥ tʰ e tʰ e i̯
Бөртээр	p ɵ r̥ tʰ eː r̥
Бөртээс	p ɵ r̥ tʰ eː s
В	w̜
Варшав	w̜ a r ɕ a w̜
Википедиа	w̜ i kʰ i pʰʲ ɵ t i̯ aː
Вьетнам	w̜ j ɵ tʰ n a m
Г	ɡ
Г	ɢ
Герман	ɡ e r m aˑ ɴ̟
Голланд	k ɔ ɮ a n t
Грек	kʲ ɵ rʲ ɵ kʰ
Д	t
ДОХ	t ɔ x
Даланзадгад	t a ɮ a n t͡s a t k a t
Дани	t äˑ n
Дани	t ɛˑ n
Дархан	t a r x a ŋ
Доржгүй	t ɔ r t͡ɕ k u i̯
Доржид	t ɔ r t͡ɕ i t
Доржийг	t ɔ r t͡ɕ iː k
Доржийн	t ɔ r t͡ɕ iː ŋ
Доржийнд	t ɔ r t͡ɕ iː n t
Доржоор	t ɔ r t͡ɕ oː r̥
Доржоос	t ɔ r t͡ɕ oː s
Доржтой	t ɔ r t͡ɕ tʰ ɔ i̯
Е	j i ~ j ɵ
Евровидение	j ɵ w̜ r ɔ w̜ i tʲ ɵ n i j ɵ
Европ	j ɵ w r ɔˑ pʰ
Египет	j ɵ k i f tʰ
Ж	t ʃ
Желон	d͡ʒ e l ɔ ŋ
Женев	d ʒ ɛ n ɛ f
З	t͡s
Зуунмод	t͡s ʊː m m ɔ t
Зүүнхараа	t͡s uː ŋ x a r aː
И	i
Израиль	i t͡s r a i ɮʲ
Индонез	i n t ɔ nʲ ɵ t͡s
Ирак	i r a kʰ
Иран	i r a ŋ
Исланд	i s ɮ a n t
Испани	i s pʰ aˑ n
Й	i
К	kʰ
К	x
Казахстан	kʰ ä t͜s ä ɢ s tʰ äˑ n
Камбож	kʰ a m p ɔ t͡ɕ
Канад	kʰ a n a t
Кидан	kʰ i t a ŋ
Куба	kʰ ʊ β
Күнз	kʰ u n t͡s
Л	ɮ
Латви	ɮ äˑ tʰ ə w̜
Линукс	ɮ i n ʊ kʰ s
Лондон	ɮ ɔ n t ɔ ŋ
Лхама	ɬʰ a m a
Лхас	ɬʰ a s
М	m
Малайз	m a ɮ ɛː t͡s
Мандалговь	m a n t a ɮ k ɔ w̜ʲ
Манж	m a n t͡ɕ
Мексик	mʲ ɵ kʰ s i kʰ
Мисир	m i s i r̥
Москва	m ɔ s kʰ w̜ a
Мьянмар	m j a m m a r̥
Мөрөн	m ɵ r ɵ ŋ
Н	n
Н	ŋ
Налайх	n a ɮ ɛː x
Непал	nʲ ɵ pʰ a ɮ
Нидерланд	n i tʲ ɵ r ɮ a n t
О	ɔ
Обь	ɔ pʲ
Онтарио	ɔ n tʰ a r i̯ oː
Орос	ɔ r ʊ s
Орчон	ɔ r̥ t͡ɕʰ ɔ ŋ
П	pʰ
Перс	pʰʲ ɵ r s
Петр	pʰʲ ɵ tʰ r̥
Португал	pʰ ɔ r̥ tʰ ʊ k a ɮ
Пёнъян	pʰʲ ɔ n j a ŋ
Пёньян	pʰʲ ɔ n j a ŋ
Р	r
Ром	r ɔ m
С	s
Сажа	s a d͡ʑ
Сайншанд	s ɛː n ɕ a n t
Сибирь	s i β i rʲ
Сири	s iˑ r
Стамбул	s tʰ a m p ʊ ɮ
Сүхбаатар	s u x p aː tʰ a r̥
Сөүл	s ɵ u ɮ
Т	tʰ
Тав	tʰ a w̜
Тайланд	tʰ ɛː ɮ a n t
Твиттер	tʰ w̜ i tʰʲ ɵ r̥
Тирана	tʰ i r a n a
Тува	tʰ ʊ w̜ aˑ
Тулуй	tʰ ʊ ɮ ʊ i
Түрэг	tʰ u r e k
Төвшрүүлэх	tʰ ɵ w̜ ɕ r uː ɮ e x
Төвөд	tʰ u p ɘ t
У	ʊ
Узбекээр	ʊ t͡s pʲ ɵ kʰ eː r̥
Украин	ʊ kʰ r a i ŋ
Улаанбаатараар	ʊ ɮ aː m p aː tʰ a r aː r̥
Улаанбаатараас	ʊ ɮ aː m p aː tʰ a r aː s
Улаанбаатаргүй	ʊ ɮ aː m p aː tʰ a r k u i̯
Улаанбаатарт	ʊ ɮ aː m p aː tʰ a r̥ tʰ
Улаанбаатартай	ʊ ɮ aː m p aː tʰ a r̥ tʰ ɛː
Улаанбаатарыг	ʊ ɮ aː m p aː tʰ a r i k
Улаанбаатарын	ʊ ɮ aː m p aː tʰ a r i ŋ
Улаанбаатарынх	ʊ ɮ aː m p aː tʰ a r i ŋ x
Улаанбаатарынхан	ʊ ɮ aː m p aː tʰ a r i ŋ x a ŋ
Улаангом	ʊ ɮ aː ŋ k ɔ m
Улаанцав	ʊ ɮ a n t͡sʰ ə w
Улиастай	ʊ ɮ i̯ aː s tʰ ɛː
Ф	f
Ф	pʰ
Финланд	f i n ɮ a n t
Финлянд	f i n ɮʲ a n t
Франц	f r a n t͡sʰ
Х	x
ХДХВ	x eː t eː x eː w eː
Халимаг	x a ɮ i m a k
Халх	x a ɮ x
Хархорин	x a r x ɔ r i ŋ
Ховд	x ɔ w̜ t
Хонконг	x ɔ ŋ kʰ ɔ ŋ k
Хуацай	x u̯ a t͡sʰ ɛː
Хянган	xʲ a ŋ k a ŋ
Хөлөнбуйр	x ɵ ɮ ɵ m p ʊ i̯ r̥
Ц	t͡sʰ
Цахар	t͡sʰ a x a r̥
Цэдэнбал	t͡sʰ e t e m p a ɮ
Цэцэрлэг	t͡sʰ e t͡sʰ e r ɮ e k
Ч	t͡ʃʰ
Чингис	t͡ɕʰ i ŋ k i s
Чингисгүй	t͡ɕʰ i ŋ k i s k u i̯
Чингисгүйгээ	t͡ɕʰ i ŋ k i s k u i̯ ɣ eː
Чингисийг	t͡ɕʰ i ŋ k i s iː k
Чингисийгээ	t͡ɕʰ i ŋ k i s iː k eː
Чингисийн	t͡ɕʰ i ŋ k i s iː ŋ
Чингисийнд	t͡ɕʰ i ŋ k i s iː n t
Чингисийндээ	t͡ɕʰ i ŋ k i s iː n t eː
Чингисийнх	t͡ɕʰ i ŋ k i s iː ŋ x
Чингисийнхгүй	t͡ɕʰ i ŋ k i s iː ŋ x k u i̯
Чингисийнхгүйгээ	t͡ɕʰ i ŋ k i s iː ŋ x k u i̯ ɣ eː
Чингисийнхдээ	t͡ɕʰ i ŋ k i s iː ŋ x t eː
Чингисийнхийг	t͡ɕʰ i ŋ k i s iː ŋ x iː k
Чингисийнхийгээ	t͡ɕʰ i ŋ k i s iː ŋ x iː k eː
Чингисийнхтэй	t͡ɕʰ i ŋ k i s iː ŋ x tʰ e i̯
Чингисийнхтэйгээ	t͡ɕʰ i ŋ k i s iː ŋ x tʰ e i̯ ɣ eː
Чингисийнхэд	t͡ɕʰ i ŋ k i s iː ŋ x e t
Чингисийнхэн	t͡ɕʰ i ŋ k i s iː ŋ x e ŋ
Чингисийнхээ	t͡ɕʰ i ŋ k i s iː ŋ x eː
Чингисийнхээр	t͡ɕʰ i ŋ k i s iː ŋ x eː r̥
Чингисийнхээрээ	t͡ɕʰ i ŋ k i s iː ŋ x eː r eː
Чингисийнхээс	t͡ɕʰ i ŋ k i s iː ŋ x eː s
Чингисийнхээсээ	t͡ɕʰ i ŋ k i s iː ŋ x eː s eː
Чингист	t͡ɕʰ i ŋ k i s tʰ
Чингистэй	t͡ɕʰ i ŋ k i s tʰ e i̯
Чингистэйгээ	t͡ɕʰ i ŋ k i s tʰ e i̯ ɣ eː
Чингистээ	t͡ɕʰ i ŋ k i s tʰ eː
Чингисээ	t͡ɕʰ i ŋ k i s eː
Чингисээр	t͡ɕʰ i ŋ k i s eː r̥
Чингисээрээ	t͡ɕʰ i ŋ k i s eː r eː
Чингисээс	t͡ɕʰ i ŋ k i s eː s
Чингисээсээ	t͡ɕʰ i ŋ k i s eː s eː
Чойбалсан	t͡ɕʰ ɔ i̯ β a ɮ s a ŋ
Чойр	t͡ɕʰ ɔ i̯ r̥
Ш	ʃ
Шанхай	ɕ a ŋ x ɛː
Швед	ɕ w̜ʲ ɵ t
Швейцари	ʃ e̞ f t͜sʰ äˑ r
Шианган	ɕ i̯ aː ŋ k a ŋ
Шивэр	ɕ i w̜ e r̥
Шиньжян	ɕ i nʲ t͡ɕ j a ŋ
Щ	ʃ
Ы	i
Ь	ʲ
Э	e ~ i
Эрхүү	e r x uː
Ю	j u
Ю	j ʊ
Я	j a
а	a
аав	aː w̜
ааваар	aː w̜ aː r̥
ааваас	aː w̜ aː s
аавгүй	aː w̜ k u i̯
аавд	aː w̜ t
аавтай	aː w̜ tʰ ɛː
аавууд	aː w̜ ʊː t
аавуудаар	aː w̜ ʊː t aː r̥
аавуудаас	aː w̜ ʊː t aː s
аавуудад	aː w̜ ʊː t a t
аавуудгүй	aː w̜ ʊː t k u i̯
аавуудтай	aː w̜ ʊː t tʰ ɛː
аавуудыг	aː w̜ ʊː t i k
аавуудын	aː w̜ ʊː t i ŋ
аавуудынд	aː w̜ ʊː t i n t
аавыг	aː w̜ i k
аавын	aː w̜ i ŋ
аавынд	aː w̜ i n t
ааг	aː k
аагаар	aː k aː r̥
аагаас	aː k aː s
ааггүй	aː k u i̯
аагийг	aː k iː k
аагийн	aː k iː ŋ
аагт	aː k tʰ
аагтай	aː k tʰ ɛː
аагууд	aː k ʊː t
аагуудаар	aː k ʊː t aː r̥
аагуудаас	aː k ʊː t aː s
аагуудад	aː k ʊː t a t
аагуудгүй	aː k ʊː t k u i̯
аагуудтай	aː k ʊː t tʰ ɛː
аагуудыг	aː k ʊː t i k
аагуудын	aː k ʊː t i ŋ
аадар	aː d ə r
аадаргүй	aː t a r k u i̯
аадарт	aː t a r̥ tʰ
аадартай	aː t a r̥ tʰ ɛː
аадраар	aː t r aː r̥
аадраас	aː t r aː s
аадрыг	aː t r i k
аадрын	aː t r i ŋ
аалз	aː ɮ t͡s
аалзаар	aː ɮ t͡s aː r̥
аалзан	aː ɮ t͡s a ŋ
аалзанд	aː ɮ t͡s a n t
аалзгүй	aː ɮ t͡s k u i̯
аалзнаас	aː ɮ t͡s n aː s
аалзнууд	aː ɮ t͡s n ʊː t
аалзнуудаар	aː ɮ t͡s n ʊː t aː r̥
аалзнуудаас	aː ɮ t͡s n ʊː t aː s
аалзнуудад	aː ɮ t͡s n ʊː t a t
аалзнуудгүй	aː ɮ t͡s n ʊː t k u i̯
аалзнуудтай	aː ɮ t͡s n ʊː t tʰ ɛː
аалзнуудыг	aː ɮ t͡s n ʊː t i k
аалзнуудын	aː ɮ t͡s n ʊː t i ŋ
аалзны	aː ɮ t͡s n i
аалзтай	aː ɮ t͡s tʰ ɛː
ааруул	aː r ʊː ɮ
ааруулаар	aː r ʊː ɮ aː r̥
ааруулаас	aː r ʊː ɮ aː s
ааруулгүй	aː r ʊː ɮ k u i̯
ааруулд	aː r ʊː ɮ t
ааруултай	aː r ʊː ɮ tʰ ɛː
ааруулууд	aː r ʊː ɮ ʊː t
ааруулуудаар	aː r ʊː ɮ ʊː t aː r̥
ааруулуудаас	aː r ʊː ɮ ʊː t aː s
ааруулуудад	aː r ʊː ɮ ʊː t a t
ааруулуудгүй	aː r ʊː ɮ ʊː t k u i̯
ааруулуудтай	aː r ʊː ɮ ʊː t tʰ ɛː
ааруулуудыг	aː r ʊː ɮ ʊː t i k
ааруулуудын	aː r ʊː ɮ ʊː t i ŋ
ааруулыг	aː r ʊː ɮ i k
ааруулын	aː r ʊː ɮ i ŋ
ааш	aː ɕ
аашаар	aː ɕ aː r̥
аашгүй	aː ɕ k u i̯
аашийг	aː ɕ iː k
аашин	aː ɕ i ŋ
аашинд	aː ɕ i n t
аашнаас	aː ɕ n aː s
аашны	aː ɕ n i
ааштай	aː ɕ tʰ ɛː
абстракт	a p s tʰ r a kʰ tʰ
абстрактаар	a p s tʰ r a kʰ tʰ aː r̥
абстрактаас	a p s tʰ r a kʰ tʰ aː s
абстрактад	a p s tʰ r a kʰ tʰ a t
абстрактгүй	a p s tʰ r a kʰ tʰ k u i̯
абстракттай	a p s tʰ r a kʰ tʰ ɛː
абстрактууд	a p s tʰ r a kʰ tʰ ʊː t
абстрактуудаар	a p s tʰ r a kʰ tʰ ʊː t aː r̥
абстрактуудаас	a p s tʰ r a kʰ tʰ ʊː t aː s
абстрактуудад	a p s tʰ r a kʰ tʰ ʊː t a t
абстрактуудгүй	a p s tʰ r a kʰ tʰ ʊː t k u i̯
абстрактуудтай	a p s tʰ r a kʰ tʰ ʊː t tʰ ɛː
абстрактуудыг	a p s tʰ r a kʰ tʰ ʊː t i k
абстрактуудын	a p s tʰ r a kʰ tʰ ʊː t i ŋ
абстрактыг	a p s tʰ r a kʰ tʰ i k
абстрактын	a p s tʰ r a kʰ tʰ i ŋ
авайлах	a w̜ ɛː ɮ a x
авга	a w̜ k
авгаар	a w̜ k aː r̥
авгаас	a w̜ k aː s
авгагүй	a w̜ k a ɣ u i̯
авгад	a w̜ k a t
авгалдай	a w̜ k a ɮ t ɛː
авгалдайг	a w̜ k a ɮ t ɛː k
авгалдайгаар	a w̜ k a ɮ t ɛː k aː r̥
авгалдайгаас	a w̜ k a ɮ t ɛː k aː s
авгалдайгүй	a w̜ k a ɮ t ɛː k u i̯
авгалдайд	a w̜ k a ɮ t ɛː t
авгалдайн	a w̜ k a ɮ t ɛː ŋ
авгалдайнууд	a w̜ k a ɮ t ɛː n ʊː t
авгалдайнуудаар	a w̜ k a ɮ t ɛː n ʊː t aː r̥
авгалдайнуудаас	a w̜ k a ɮ t ɛː n ʊː t aː s
авгалдайнуудад	a w̜ k a ɮ t ɛː n ʊː t a t
авгалдайнуудгүй	a w̜ k a ɮ t ɛː n ʊː t k u i̯
авгалдайнуудтай	a w̜ k a ɮ t ɛː n ʊː t tʰ ɛː
авгалдайнуудыг	a w̜ k a ɮ t ɛː n ʊː t i k
авгалдайнуудын	a w̜ k a ɮ t ɛː n ʊː t i ŋ
авгалдайтай	a w̜ k a ɮ t ɛː tʰ ɛː
авгатай	a w̜ k a tʰ ɛː
авгууд	a w̜ k ʊː t
авгуудаар	a w̜ k ʊː t aː r̥
авгуудаас	a w̜ k ʊː t aː s
авгуудад	a w̜ k ʊː t a t
авгуудгүй	a w̜ k ʊː t k u i̯
авгуудтай	a w̜ k ʊː t tʰ ɛː
авгуудыг	a w̜ k ʊː t i k
авгуудын	a w̜ k ʊː t i ŋ
авгуудынд	a w̜ k ʊː t i n t
авгыг	a w̜ k i k
авгын	a w̜ k i ŋ
авгынд	a w̜ k i n t
авгынх	a w̜ k i ŋ x
авгынхан	a w̜ k i ŋ x a ŋ
авдар	a w̜ t a r̥
авдаргүй	a w̜ t a r k u i̯
авдарт	a w̜ t a r̥ tʰ
авдартай	a w̜ t a r̥ tʰ ɛː
авдраар	a w̜ t r aː r̥
авдраас	a w̜ t r aː s
авдрууд	a w̜ t r ʊː t
авдруудаар	a w̜ t r ʊː t aː r̥
авдруудаас	a w̜ t r ʊː t aː s
авдруудад	a w̜ t r ʊː t a t
авдруудгүй	a w̜ t r ʊː t k u i̯
авдруудтай	a w̜ t r ʊː t tʰ ɛː
авдруудыг	a w̜ t r ʊː t i k
авдруудын	a w̜ t r ʊː t i ŋ
авдрыг	a w̜ t r i k
авдрын	a w̜ t r i ŋ
авлигач	a w̜ ɮ i ɣ a t͡ɕʰ
авс	a w̜ s
авсаар	a w̜ s aː r̥
авсан	a w̜ s a ŋ
авсанд	a w̜ s a n t
авсгүй	a w̜ s k u i̯
авснаас	a w̜ s n aː s
авснууд	a w̜ s n ʊː t
авснуудаар	a w̜ s n ʊː t aː r̥
авснуудаас	a w̜ s n ʊː t aː s
авснуудад	a w̜ s n ʊː t a t
авснуудгүй	a w̜ s n ʊː t k u i̯
авснуудтай	a w̜ s n ʊː t tʰ ɛː
авснуудыг	a w̜ s n ʊː t i k
авснуудын	a w̜ s n ʊː t i ŋ
авсны	a w̜ s n i
австай	a w̜ s tʰ ɛː
авсыг	a w̜ s i k
автобус	a f tʰ ʊː s
автобус	a w̜ tʰ ɔ p ʊ s
автобусаар	a w̜ tʰ ɔ p ʊ s aː r̥
автобусан	a w̜ tʰ ɔ p ʊ s a ŋ
автобусанд	a w̜ tʰ ɔ p ʊ s a n t
автобусгүй	a w̜ tʰ ɔ p ʊ s k u i̯
автобуснаас	a w̜ tʰ ɔ p ʊ s n aː s
автобуснууд	a w̜ tʰ ɔ p ʊ s n ʊː t
автобуснуудаар	a w̜ tʰ ɔ p ʊ s n ʊː t aː r̥
автобуснуудаас	a w̜ tʰ ɔ p ʊ s n ʊː t aː s
автобуснуудад	a w̜ tʰ ɔ p ʊ s n ʊː t a t
автобуснуудгүй	a w̜ tʰ ɔ p ʊ s n ʊː t k u i̯
автобуснуудтай	a w̜ tʰ ɔ p ʊ s n ʊː t tʰ ɛː
автобуснуудыг	a w̜ tʰ ɔ p ʊ s n ʊː t i k
автобуснуудын	a w̜ tʰ ɔ p ʊ s n ʊː t i ŋ
автобусны	a w̜ tʰ ɔ p ʊ s n i
автобусных	a w̜ tʰ ɔ p ʊ s n i x
автобусныхан	a w̜ tʰ ɔ p ʊ s n i x a ŋ
автобустай	a w̜ tʰ ɔ p ʊ s tʰ ɛː
автобусыг	a w̜ tʰ ɔ p ʊ s i k
автокран	a w̜ tʰ ɔ kʰ r a ŋ
автокранаар	a w̜ tʰ ɔ kʰ r a n aː r̥
автокранаас	a w̜ tʰ ɔ kʰ r a n aː s
автокрангүй	a w̜ tʰ ɔ kʰ r a ŋ k u i̯
автокранд	a w̜ tʰ ɔ kʰ r a n t
автокрантай	a w̜ tʰ ɔ kʰ r a n tʰ ɛː
автокранууд	a w̜ tʰ ɔ kʰ r a n ʊː t
автокрануудаар	a w̜ tʰ ɔ kʰ r a n ʊː t aː r̥
автокрануудаас	a w̜ tʰ ɔ kʰ r a n ʊː t aː s
автокрануудад	a w̜ tʰ ɔ kʰ r a n ʊː t a t
автокрануудгүй	a w̜ tʰ ɔ kʰ r a n ʊː t k u i̯
автокрануудтай	a w̜ tʰ ɔ kʰ r a n ʊː t tʰ ɛː
автокрануудыг	a w̜ tʰ ɔ kʰ r a n ʊː t i k
автокрануудын	a w̜ tʰ ɔ kʰ r a n ʊː t i ŋ
автокраны	a w̜ tʰ ɔ kʰ r a n i
автокраныг	a w̜ tʰ ɔ kʰ r a n i k
автомашин	a w̜ tʰ ɔ m a ɕ i ŋ
автомашинаар	a w̜ tʰ ɔ m a ɕ i n aː r̥
автомашинаас	a w̜ tʰ ɔ m a ɕ i n aː s
автомашингүй	a w̜ tʰ ɔ m a ɕ i ŋ k u i̯
автомашинд	a w̜ tʰ ɔ m a ɕ i n t
автомашинтай	a w̜ tʰ ɔ m a ɕ i n tʰ ɛː
автомашинууд	a w̜ tʰ ɔ m a ɕ i n ʊː t
автомашинуудаар	a w̜ tʰ ɔ m a ɕ i n ʊː t aː r̥
автомашинуудаас	a w̜ tʰ ɔ m a ɕ i n ʊː t aː s
автомашинуудад	a w̜ tʰ ɔ m a ɕ i n ʊː t a t
автомашинуудгүй	a w̜ tʰ ɔ m a ɕ i n ʊː t k u i̯
автомашинуудтай	a w̜ tʰ ɔ m a ɕ i n ʊː t tʰ ɛː
автомашинуудыг	a w̜ tʰ ɔ m a ɕ i n ʊː t i k
автомашинуудын	a w̜ tʰ ɔ m a ɕ i n ʊː t i ŋ
автомашины	a w̜ tʰ ɔ m a ɕ i n i
автомашиныг	a w̜ tʰ ɔ m a ɕ i n i k
авъяасаар	a w̜ j aː s aː r̥
авъяасаас	a w̜ j aː s aː s
авъяасгүй	a w̜ j aː s k u i̯
авъяаст	a w̜ j aː s tʰ
авъяастай	a w̜ j aː s tʰ ɛː
авъяасыг	a w̜ j aː s i k
авъяасын	a w̜ j aː s i ŋ
авьяас	a w̜ j aː s
агаар	a ɢ aː r
агаараар	a ɣ aː r aː r̥
агаараас	a ɣ aː r aː s
агааргүй	a ɣ aː r k u i̯
агаарт	a ɣ aː r̥ tʰ
агаартай	a ɣ aː r̥ tʰ ɛː
агаарыг	a ɣ aː r i k
агаарын	a ɣ aː r i ŋ
агаарынх	a ɣ aː r i ŋ x
агаарынхан	a ɣ aː r i ŋ x a ŋ
агробиологи	a k r ɔ β i̯ oː ɮ ɔ ɣ
агшин	a k ɕ i ŋ
ад	a t
адал	a t ə ɮ
адгуус	a t k ʊː s
адгуусаар	a t k ʊː s aː r̥
адгуусан	a t k ʊː s a ŋ
адгуусанд	a t k ʊː s a n t
адгуусгүй	a t k ʊː s k u i̯
адгууснаас	a t k ʊː s n aː s
адгууснууд	a t k ʊː s n ʊː t
адгууснуудаар	a t k ʊː s n ʊː t aː r̥
адгууснуудаас	a t k ʊː s n ʊː t aː s
адгууснуудад	a t k ʊː s n ʊː t a t
адгууснуудгүй	a t k ʊː s n ʊː t k u i̯
адгууснуудтай	a t k ʊː s n ʊː t tʰ ɛː
адгууснуудыг	a t k ʊː s n ʊː t i k
адгууснуудын	a t k ʊː s n ʊː t i ŋ
адгуусны	a t k ʊː s n i
адгуустай	a t k ʊː s tʰ ɛː
адгуусыг	a t k ʊː s i k
адил	æ t ə ɮ
адуу	a t ʊː
адуус	a t ʊ s
ажил	a t͜ɕ ə ɮ
ажилгүйчүүд	a d͡ʑ i ɮ k u i̯ t͡ɕʰ uː t
ажилтан	a t͜ɕ ə ɮ tʰ ə ŋ
ажлынхаа	a t͡ɕ ɮ i ŋ x aː
аз	a t͡s
айл	æː ɮ
айлчлах	a i ɮ t͡ɕʰ ɮ ə x
аймаг	æː m ə k̠
аймшиг	a i m ʃ i ɡ
айраг	æː r ə k
алалцах	a ɮ a ɮ t͡sʰ a x
алба	a ɮ p
албадах	a ɮ p ə t ə x
албадлага	a ɮ p ə t ɮ ə ɢ
алга	a ɮ k
алган	a ɮ k a ŋ
алгебр	a ɮ kʲ ɵ p r̥
алдах	a ɮ t ə x
аллага	a ɮː a ɣ
алмааз	a ɮ m aː t͡s
алт	a ɮ tʰ
алтан	a ɮ tʰ a ŋ
алтгана	a ɮ tʰ ɢ ə n
алуурчдаар	a ɮ ʊː r̥ t͡ɕʰ t aː r̥
алуурчдаас	a ɮ ʊː r̥ t͡ɕʰ t aː s
алуурчдад	a ɮ ʊː r̥ t͡ɕʰ t a t
алуурчдыг	a ɮ ʊː r̥ t͡ɕʰ t i k
алуурчдын	a ɮ ʊː r̥ t͡ɕʰ t i ŋ
алуурчдынх	a ɮ ʊː r̥ t͡ɕʰ t i ŋ x
алуурчид	a ɮ ʊː r̥ t͡ɕʰ i t
алуурчидгүй	a ɮ ʊː r̥ t͡ɕʰ i t k u i̯
алуурчидтай	a ɮ ʊː r̥ t͡ɕʰ i t tʰ ɛː
алуурчин	a ɮ ʊː r̥ t͡ɕʰ i ŋ
алуурчингүй	a ɮ ʊː r̥ t͡ɕʰ i ŋ k u i̯
алуурчинд	a ɮ ʊː r̥ t͡ɕʰ i n t
алуурчинтай	a ɮ ʊː r̥ t͡ɕʰ i n tʰ ɛː
алуурчнаар	a ɮ ʊː r̥ t͡ɕʰ n aː r̥
алуурчнаас	a ɮ ʊː r̥ t͡ɕʰ n aː s
алуурчны	a ɮ ʊː r̥ t͡ɕʰ n i
алуурчныг	a ɮ ʊː r̥ t͡ɕʰ n i k
алуурчных	a ɮ ʊː r̥ t͡ɕʰ n i x
алуурчныхан	a ɮ ʊː r̥ t͡ɕʰ n i x a ŋ
алх	a ɮ x
алчуур	a ɮ t͡ʃ ʊː r
аль	æ ɮ
ам	a m
амбаар	a m p aː r
амгай	a m k ɛː
америкчуудын	a mʲ ɵ r i kʰ t͡ɕʰ ʊː t i ŋ
амжилт	a m t͡ɕ i ɮ tʰ
амжих	a m t͡ɕ ə x
амттан	a m tʰ a ŋ
амь	a mʲ
амьдрал	ɛ m t r ə ɮ
амьсгалах	a mʲ s ɢ ə ɮ ə x
амьтад	a mʲ tʰ a t
амьтадгүй	a mʲ tʰ a t k u i̯
амьтадтай	a mʲ tʰ a t tʰ ɛː
амьтангүй	a mʲ tʰ a ŋ k u i̯
амьтанд	a mʲ tʰ a n t
амьтантай	a mʲ tʰ a n tʰ ɛː
амьтдаар	a mʲ tʰ t aː r̥
амьтдаас	a mʲ tʰ t aː s
амьтдад	a mʲ tʰ t a t
амьтдыг	a mʲ tʰ t i k
амьтдын	a mʲ tʰ t i ŋ
амьтдынд	a mʲ tʰ t i n t
амьтнаар	a mʲ tʰ n aː r̥
амьтнаас	a mʲ tʰ n aː s
амьтны	a mʲ tʰ n i
амьтныг	a mʲ tʰ n i k
амьтныд	a mʲ tʰ n i t
амёб	a mʲ ɔ p
анааш	a n aː ɕ
анаашаар	a n aː ɕ aː r̥
анаашгүй	a n aː ɕ k u i̯
анаашийг	a n aː ɕ iː k
анаашин	a n aː ɕ i ŋ
анаашинд	a n aː ɕ i n t
анаашнаас	a n aː ɕ n aː s
анаашнууд	a n aː ɕ n ʊː t
анаашнуудаар	a n aː ɕ n ʊː t aː r̥
анаашнуудаас	a n aː ɕ n ʊː t aː s
анаашнуудад	a n aː ɕ n ʊː t a t
анаашнуудгүй	a n aː ɕ n ʊː t k u i̯
анаашнуудтай	a n aː ɕ n ʊː t tʰ ɛː
анаашнуудыг	a n aː ɕ n ʊː t i k
анаашнуудын	a n aː ɕ n ʊː t i ŋ
анаашны	a n aː ɕ n i
анааштай	a n aː ɕ tʰ ɛː
анги	a ŋ k
ангиа	a ŋ k i̯ aː
ангиар	a ŋ k i̯ aː r̥
ангиараа	a ŋ k i̯ aː r aː
ангиас	a ŋ k i̯ aː s
ангиасаа	a ŋ k i̯ aː s aː
ангигүй	a ŋ k i ɣ u i̯
ангигүйгээ	a ŋ k i ɣ u i̯ ɣ eː
ангид	a ŋ k i t
ангидаа	a ŋ k i t aː
ангийг	a ŋ k iː k
ангийгаа	a ŋ k iː k aː
ангийн	a ŋ k iː ŋ
ангийнхаа	a ŋ k iː ŋ x aː
ангийнхан	a ŋ k iː ŋ x a ŋ
ангитай	a ŋ k i tʰ ɛː
ангитайгаа	a ŋ k i tʰ ɛː k aː
ангиуд	a ŋ k i̯ ʊː t
ангиудаа	a ŋ k i̯ ʊː t aː
ангиудаар	a ŋ k i̯ ʊː t aː r̥
ангиудаараа	a ŋ k i̯ ʊː t aː r aː
ангиудаас	a ŋ k i̯ ʊː t aː s
ангиудаасаа	a ŋ k i̯ ʊː t aː s aː
ангиудад	a ŋ k i̯ ʊː t a t
ангиудгүй	a ŋ k i̯ ʊː t k u i̯
ангиудгүйгээ	a ŋ k i̯ ʊː t k u i̯ ɣ eː
ангиуддаа	a ŋ k i̯ ʊː t͉ t aː
ангиудтай	a ŋ k i̯ ʊː t tʰ ɛː
ангиудтайгаа	a ŋ k i̯ ʊː t tʰ ɛː k aː
ангиудыг	a ŋ k i̯ ʊː t i k
ангиудыгаа	a ŋ k i̯ ʊː t i ɣ aː
ангиудын	a ŋ k i̯ ʊː t i ŋ
ангиудынхаа	a ŋ k i̯ ʊː t i ŋ x aː
англи	a ŋ k i ɮ
англичууд	a ŋ k ɮ i t͡ɕʰ ʊː t
анекдот	a nʲ ɵ kʰ t ɔ tʰ
анх	a ŋ x
анхаарал	a ŋ x aː r a ɮ
анхилга	a ŋ x i ɮ k
анхилгаа	a ŋ x i ɮ k aː
анхилгаар	a ŋ x i ɮ k aː r̥
анхилгаараа	a ŋ x i ɮ k aː r aː
анхилгаас	a ŋ x i ɮ k aː s
анхилгаасаа	a ŋ x i ɮ k aː s aː
анхилгагүй	a ŋ x i ɮ k a ɣ u i̯
анхилгагүйгээ	a ŋ x i ɮ k a ɣ u i̯ ɣ eː
анхилгад	a ŋ x i ɮ k a t
анхилгадаа	a ŋ x i ɮ k a t aː
анхилгатай	a ŋ x i ɮ k a tʰ ɛː
анхилгатайгаа	a ŋ x i ɮ k a tʰ ɛː k aː
анхилгууд	a ŋ x i ɮ k ʊː t
анхилгуудаа	a ŋ x i ɮ k ʊː t aː
анхилгуудаар	a ŋ x i ɮ k ʊː t aː r̥
анхилгуудаараа	a ŋ x i ɮ k ʊː t aː r aː
анхилгуудаас	a ŋ x i ɮ k ʊː t aː s
анхилгуудаасаа	a ŋ x i ɮ k ʊː t aː s aː
анхилгуудад	a ŋ x i ɮ k ʊː t a t
анхилгуудгүй	a ŋ x i ɮ k ʊː t k u i̯
анхилгуудгүйгээ	a ŋ x i ɮ k ʊː t k u i̯ ɣ eː
анхилгууддаа	a ŋ x i ɮ k ʊː t͉ t aː
анхилгуудтай	a ŋ x i ɮ k ʊː t tʰ ɛː
анхилгуудтайгаа	a ŋ x i ɮ k ʊː t tʰ ɛː k aː
анхилгуудыг	a ŋ x i ɮ k ʊː t i k
анхилгуудыгаа	a ŋ x i ɮ k ʊː t i ɣ aː
анхилгуудын	a ŋ x i ɮ k ʊː t i ŋ
анхилгуудынхаа	a ŋ x i ɮ k ʊː t i ŋ x aː
анхилгыг	a ŋ x i ɮ k i k
анхилгыгаа	a ŋ x i ɮ k i ɣ aː
анхилгын	a ŋ x i ɮ k i ŋ
анхилгынхаа	a ŋ x i ɮ k i ŋ x aː
анчдаар	a n t͡ɕʰ t aː r̥
анчдаас	a n t͡ɕʰ t aː s
анчдад	a n t͡ɕʰ t a t
анчдыг	a n t͡ɕʰ t i k
анчдын	a n t͡ɕʰ t i ŋ
анчдынх	a n t͡ɕʰ t i ŋ x
анчид	a n t͡ɕʰ i t
анчидгүй	a n t͡ɕʰ i t k u i̯
анчидтай	a n t͡ɕʰ i t tʰ ɛː
анчин	a n t͡ɕʰ i ŋ
анчингүй	a n t͡ɕʰ i ŋ k u i̯
анчинд	a n t͡ɕʰ i n t
анчинтай	a n t͡ɕʰ i n tʰ ɛː
анчнаар	a n t͡ɕʰ n aː r̥
анчнаас	a n t͡ɕʰ n aː s
анчны	a n t͡ɕʰ n i
анчныг	a n t͡ɕʰ n i k
анчных	a n t͡ɕʰ n i x
анчныхан	a n t͡ɕʰ n i x a ŋ
апелсин	a pʰʲ ɵ ɮ s i ŋ
аппарат	a pʰ a r a tʰ
аптек	a pʰ tʰ e kʰ
араар	a r aː r̥
араас	a r aː s
аравдугаар	a r a w̜ t ʊ ɣ aː r̥
арал	a r ə ɮ
арбитраж	a r p i tʰ r a t͡ɕ
арвай	a r w a i
арга	a r k
аргүй	a r k u i̯
ард	a r t
ардчилах	a r t t͡ɕʰ i ɮ a x
артай	a r̥ tʰ ɛː
архиваар	a r x i w̜ aː r̥
архиваас	a r x i w̜ aː s
архивгүй	a r x i w̜ k u i̯
архивт	a r x i w̜ tʰ
архивтай	a r x i w̜ tʰ ɛː
архивууд	a r x i w̜ ʊː t
архивуудаар	a r x i w̜ ʊː t aː r̥
архивуудаас	a r x i w̜ ʊː t aː s
архивуудад	a r x i w̜ ʊː t a t
архивуудгүй	a r x i w̜ ʊː t k u i̯
архивуудтай	a r x i w̜ ʊː t tʰ ɛː
архивуудыг	a r x i w̜ ʊː t i k
архивуудын	a r x i w̜ ʊː t i ŋ
архивыг	a r x i w̜ i k
архивын	a r x i w̜ i ŋ
архичин	ɛ r x t͜ɕʰ ə ŋ
архичны	a r x i t͡ɕʰ n i
арц	a r̥ t͡sʰ
арыг	a r i k
арын	a r i ŋ
арынх	a r i ŋ x
арынхан	a r i ŋ x a ŋ
арьс	a rʲ s
арьстан	a rʲ s tʰ a ŋ
арьстны	a rʲ s tʰ n i
асуух	a s ʊ x
атаа	a tʰ a
атаархах	a tʰ a r x ə x
аугаа	a ʊ̯ ɣ aː
африкаанс	a f r i kʰ aː n s
ахлагч	a x ɮ a k t͡ɕʰ
ахмад	a x m a t
ац	a t͡sʰ
ачаа	ä t͡ʃʰ äː
ачих	a t͡ɕʰ i x
ая	a j
аяган	a j a ɣ a ŋ
б	p
ба	p a
баавар	p aː w̜ ə r
баавгай	p aː w̜ k ɛː
баасан	p aː s a ŋ
баатар	p aː tʰ a r̥
баах	p aː x
баг	p a k
бага	p a ɢ
багааж	p a ɣ aː t͡ɕ
багаж	p a ɢ t͡ɕ
баглаа	p a k ɮ aː
багс	p a ɡ s
бадмаараг	p a t m aː r a k
байгалиа	p ɛː k a ɮ i̯ aː
байгалиар	p ɛː k a ɮ i̯ aː r̥
байгалиараа	p ɛː k a ɮ i̯ aː r aː
байгалиас	p ɛː k a ɮ i̯ aː s
байгалиасаа	p ɛː k a ɮ i̯ aː s aː
байгалийг	p ɛː k a ɮ iː k
байгалийгаа	p ɛː k a ɮ iː k aː
байгалийн	p ɛː k a ɮ iː ŋ
байгалийнх	p ɛː k a ɮ iː ŋ x
байгалийнхаа	p ɛː k a ɮ iː ŋ x aː
байгалийнхан	p ɛː k a ɮ iː ŋ x a ŋ
байгальгүй	p ɛː k a ɮʲ k u i̯
байгальгүйгээ	p ɛː k a ɮʲ k u i̯ ɣ eː
байгальд	p ɛː k a ɮʲ t
байгальдаа	p ɛː k a ɮʲ t aː
байгальтай	p ɛː k a ɮʲ tʰ ɛː
байгальтайгаа	p ɛː k a ɮʲ tʰ ɛː k aː
байгууллага	p ɛː k ʊː ɮː a ɣ
байгууллагаар	p ɛː k ʊː ɮː a ɣ aː r̥
байгууллагаас	p ɛː k ʊː ɮː a ɣ aː s
байгууллагагүй	p ɛː k ʊː ɮː a ɣ a k u i̯
байгууллагад	p ɛː k ʊː ɮː a ɣ a t
байгууллагатай	p ɛː k ʊː ɮː a ɣ a tʰ ɛː
байгууллагууд	p ɛː k ʊː ɮː a ɣ ʊː t
байгууллагуудаар	p ɛː k ʊː ɮː a ɣ ʊː t aː r̥
байгууллагуудаас	p ɛː k ʊː ɮː a ɣ ʊː t aː s
байгууллагуудад	p ɛː k ʊː ɮː a ɣ ʊː t a t
байгууллагуудгүй	p ɛː k ʊː ɮː a ɣ ʊː t k u i̯
байгууллагуудтай	p ɛː k ʊː ɮː a ɣ ʊː t tʰ ɛː
байгууллагуудыг	p ɛː k ʊː ɮː a ɣ ʊː t i k
байгууллагуудын	p ɛː k ʊː ɮː a ɣ ʊː t i ŋ
байгууллагуудынх	p ɛː k ʊː ɮː a ɣ ʊː t i ŋ x
байгууллагуудынхан	p ɛː k ʊː ɮː a ɣ ʊː t i ŋ x a ŋ
байгууллагыг	p ɛː k ʊː ɮː a ɣ i k
байгууллагын	p ɛː k ʊː ɮː a ɣ i ŋ
байгууллагынх	p ɛː k ʊː ɮː a ɣ i ŋ x
байгууллагынхан	p ɛː k ʊː ɮː a ɣ i ŋ x a ŋ
байдал	p ɛː t a ɮ
байлдагч	p ɛː ɮ t a k t͡ɕʰ
баймж	p ɛː m t͡ɕ
байна	p æː n
байр	p ɛː r̥
байраа	p ɛː r aː
байраар	p ɛː r aː r̥
байраараа	p ɛː r aː r aː
байран	p ɛː r a ŋ
байранд	p ɛː r a n t
байрандаа	p ɛː r a n t aː
байргүй	p ɛː r k u i̯
байргүйгээ	p ɛː r k u i̯ ɣ eː
байрнаас	p ɛː r n aː s
байрнаасаа	p ɛː r n aː s aː
байрнууд	p ɛː r n ʊː t
байрнуудаа	p ɛː r n ʊː t aː
байрнуудаар	p ɛː r n ʊː t aː r̥
байрнуудаараа	p ɛː r n ʊː t aː r aː
байрнуудаас	p ɛː r n ʊː t aː s
байрнуудаасаа	p ɛː r n ʊː t aː s aː
байрнуудад	p ɛː r n ʊː t a t
байрнуудгүй	p ɛː r n ʊː t k u i̯
байрнуудгүйгээ	p ɛː r n ʊː t k u i̯ ɣ eː
байрнууддаа	p ɛː r n ʊː t͉ t aː
байрнуудтай	p ɛː r n ʊː t tʰ ɛː
байрнуудтайгаа	p ɛː r n ʊː t tʰ ɛː k aː
байрнуудыг	p ɛː r n ʊː t i k
байрнуудыгаа	p ɛː r n ʊː t i ɣ aː
байрнуудын	p ɛː r n ʊː t i ŋ
байрнуудынх	p ɛː r n ʊː t i ŋ x
байрнуудынхаа	p ɛː r n ʊː t i ŋ x aː
байрнуудынхан	p ɛː r n ʊː t i ŋ x a ŋ
байрны	p ɛː r n i
байрных	p ɛː r n i x
байрныхаа	p ɛː r n i x aː
байрныхан	p ɛː r n i x a ŋ
байртай	p ɛː r̥ tʰ ɛː
байртайгаа	p ɛː r̥ tʰ ɛː k aː
байрыг	p ɛː r i k
байрыгаа	p ɛː r i ɣ aː
байх	p æː χ
байц	p a i t͡sʰ
байцаа	p ɛː t͡sʰ aː
байцаатай	p ɛː t͡sʰ aː tʰ ɛː
бакалавр	p a kʰ a ɮ a w̜ r̥
баклава	p a kʰ ɮ a w̜ a
балар	p a ɮ a r̥
балархай	p a ɮ a r x ɛː
балет	p a ɮʲ ɵ tʰ
бандан	p a n t a ŋ
банжо	p a n t͡ɕ ɔ
банзал	p a n t͡s a ɮ
банк	p a ŋ kʰ
бар	p a r
бараг	p a r a k
барамнас	p a r a m n a s
барга	p ä r ə q
барилга	p a rʲ ɮ a ɢ
барилдах	p a r i ɮ t a x
барих	p a rʲ ə x
баруун	p a r ʊː n
баруунтан	p ä r ʊː n tʰ ə ŋ
бассейн	b a s e j ŋ
батарей	p a tʰ a rʲ ɵ i̯
батга	p a tʰ k
батган	p a tʰ k a ŋ
батраш	p a tʰ r a ɕ
бахиал	p a x i̯ aː ɮ
баяд	p ä j t ə
баялаг	p a j ɮ ə k̠
баян	p a j ə ŋ̠
баянаар	p a j a n aː r̥
баянаас	p a j a n aː s
баянгүй	p a j a ŋ k u i̯
баянд	p a j a n t
баянтай	p a j a n tʰ ɛː
баяны	p a j a n i
баяныг	p a j a n i k
баяр	p a j r
баяртай	p a j ə̠ r tʰ æː
баячуудын	p a j a t͡ɕʰ ʊː t i ŋ
бид	p i t
бийр	p iː r
бич	p i t͡ɕʰ
бичгийн	p i t͡ɕʰ k iː ŋ
бичлэг	p i t͡ʃʰ ɮ e ɡ
бичээч	p i t͡ɕʰ eː t͡ɕʰ
блог	p ɮ ɔ k
блүтүүт	p ɮ u tʰ uː tʰ
богино	p ɔ ɡʲ ə n
бодибилдинг	p ɔ t i p i ɮ t i ŋ k
бодис	p œ t ʊ s
бодох	p ɔ t ɔ x
бодьсадва	p ɔ tʲ s a t w̜
бойжих	p ɔ i t͡ɕ ə x
бойпор	p ɔ i̯ pʰ ɔ r̥
боломж	p ɔ ɮ ə m t͡ɕ
болон	p ɔ ɮ ɔ ŋ
болор	p ɔ ɮ ʊ r
болох	p ɔ ɮ ə x
болохоор	p ɔ ɮ χ ɔː r
больниц	p ɔ ɮʲ nʲ ə t͡sʰ
боов	p ɔː w
боодог	p oː t ɔ k
боол	p oː ɮ
боомт	p oː m tʰ
боорцог	p ɔː r t͡sʰ ə ɡ
боох	p oː x
боохой	p oː x ɔ i̯
боошиг	p oː ɕ i k
борной	p ɔ r n ɔ i
бороо	p ɔ r oː
борш	p ɔ r ɕ
борщ	p ɔ r ɕ
бослого	p ɔ s ɮ ə ɢ
босох	p ɔ s ə x
боть	p œ tʰ
бохь	p ɔ xʲ
бригад	p r i ɣ a t
британичууд	p r i tʰ a n i t͡ɕʰ ʊː t
буга	p ʊ ɢ
буддаа	p ʊ t͉ t aː
буддаар	p ʊ t͉ t aː r̥
буддаараа	p ʊ t͉ t aː r aː
буддаас	p ʊ t͉ t aː s
буддаасаа	p ʊ t͉ t aː s aː
буддагүй	p ʊ t͉ t a ɣ u i̯
буддагүйгээ	p ʊ t͉ t a ɣ u i̯ ɣ eː
буддад	p ʊ t͉ t a t
буддадаа	p ʊ t͉ t a t aː
буддатай	p ʊ t͉ t a tʰ ɛː
буддатайгаа	p ʊ t͉ t a tʰ ɛː k aː
буддизм	p ʊ t͉ t i t͡s m
буддыг	p ʊ t͉ t i k
буддыгаа	p ʊ t͉ t i ɣ aː
буддын	p ʊ t͉ t i ŋ
буддынх	p ʊ t͉ t i ŋ x
буддынхаа	p ʊ t͉ t i ŋ x aː
буддынхан	p ʊ t͉ t i ŋ x a ŋ
буйдан	p ʊ i̯ t a ŋ
буйл	p ʊ i ɮ
булаалгах	p ʊ ɮ aː ɮ k a x
булаах	p ʊ ɮ aː x
булаацалдах	p ʊ ɮ aː t͡sʰ a ɮ t a x
булга	p ʊ ɮ ə ɢ
булган	p ʊ ɮ k a ŋ
булчирхай	p ʊ ɮ t͡ɕʰ ə r x a i
бульдозер	p ʊ ɮʲ t ɔ t͡s j ɵ r̥
бульдозерчин	p ʊ ɮʲ t ɔ t͡s j ɵ r̥ t͡ɕʰ i ŋ
бум	p ʊ m
бумба	p ʊ m p
бургасаар	p ʊ r k a s aː r̥
бургасан	p ʊ r k a s a ŋ
бургасанд	p ʊ r k a s a n t
бургасгүй	p ʊ r k a s k u i̯
бургаснаас	p ʊ r k a s n aː s
бургаснууд	p ʊ r k a s n ʊː t
бургаснуудаар	p ʊ r k a s n ʊː t aː r̥
бургаснуудаас	p ʊ r k a s n ʊː t aː s
бургаснуудад	p ʊ r k a s n ʊː t a t
бургаснуудгүй	p ʊ r k a s n ʊː t k u i̯
бургаснуудтай	p ʊ r k a s n ʊː t tʰ ɛː
бургаснуудыг	p ʊ r k a s n ʊː t i k
бургаснуудын	p ʊ r k a s n ʊː t i ŋ
бургаснуудынх	p ʊ r k a s n ʊː t i ŋ x
бургаснуудынхан	p ʊ r k a s n ʊː t i ŋ x a ŋ
бургасны	p ʊ r k a s n i
бургасных	p ʊ r k a s n i x
бургасныхан	p ʊ r k a s n i x a ŋ
бургастай	p ʊ r k a s tʰ ɛː
бургасыг	p ʊ r k a s i k
бурхан	p ʊ r x a ŋ
буудал	p ʊː t a ɮ
бууз	p ʊː t͡s
бууралтах	p ʊː r ə ɮ tʰ ə x
бух	p ʊ x
буян	p ʊ j ə ŋ
бэ	p e
бэйкери	p e i̯ kʰʲ ɵ r i
бэлтгэл	p e ɮ tʰ ɡ e ɮ
бэлэг	p i ɮ i ɡ
бэх	p e x
бямба	pʲ a m p
бярга	pʲ a r k
бяруу	pʲ a r ʊ
бясалгал	pʲ a s ə ɮ ɢ ə ɮ
бясалгах	pʲ a s ə ɮ ɢ ə x
бүжигчин	p u t͡ɕ ə ɡ t͡ɕʰ ə ŋ
бүйлс	p u i ɮ s
бүр	p u r
бүрхэвч	p u r x e w̜ t͡ɕʰ
бүрхүүл	p u r x u ɮ
бүс	p u s
бүсгүйчүүдэд	p u s k u i̯ t͡ɕʰ uː t e t
бүтээвэр	p u tʰ eː w̜ e r̥
бүх	p u x
бүхний	p u x n iː
бүхнээр	p u x n eː r̥
бүхнээс	p u x n eː s
бүхэн	p u x ə ŋ
бүхэнд	p u x e n t
бүхэнтэй	p u x e n tʰ e i̯
бөгс	p ɵ k s
бөгөөд	p ɵ ɣ ɵː t
бөднө	p o t ə n
бөс	p ɵ s
бөхчүүд	p ɵ x t͡ɕʰ uː t
бөхчүүдийн	p ɵ x t͡ɕʰ uː t iː ŋ
бөө	p ɵː
бөөг	p ɵː k
бөөгийн	p ɵː k iː ŋ
бөөгийнх	p ɵː k iː ŋ x
бөөгийнхөн	p ɵː k iː ŋ x ɵ ŋ
бөөгүй	p ɵː k u i̯
бөөгөөр	p ɵː k ɵː r̥
бөөгөөс	p ɵː k ɵː s
бөөд	p ɵː t
бөөлжих	p oː ɮ t͡ɕ ə x
бөөс	p oː s
бөөтэй	p ɵː tʰ e i̯
в	w̜
ваар	w̜ aː r̥
вавилончууд	w̜ a w̜ i ɮ ɔ n t͡ɕʰ ʊː t
вакцин	w̜ a kʰ t͡sʰ i ŋ
валют	w̜ a ɮʲ ʊ tʰ
ван	w a ŋ̠
веб	w̜ʲ ɵ p
видео	w̜ i tʲ ɵ
вий	w̜ iː
вирус	w̜ i r ʊ s
вирусгүй	w̜ i r ʊ s k u i̯
вирусийг	w̜ i r ʊ s iː k
вирусийн	w̜ i r ʊ s iː ŋ
вируст	w̜ i r ʊ s tʰ
вирустэй	w̜ i r ʊ s tʰ e i̯
вирусээр	w̜ i r ʊ s eː r̥
вирусээс	w̜ i r ʊ s eː s
вирусүүд	w̜ i r ʊ s uː t
вирусүүдгүй	w̜ i r ʊ s uː t k u i̯
вирусүүдийг	w̜ i r ʊ s uː t iː k
вирусүүдийн	w̜ i r ʊ s uː t iː ŋ
вирусүүдтэй	w̜ i r ʊ s uː t tʰ e i̯
вирусүүдэд	w̜ i r ʊ s uː t e t
вирусүүдээр	w̜ i r ʊ s uː t eː r̥
вирусүүдээс	w̜ i r ʊ s uː t eː s
вэ	w̜ e
г	k
г	ɡ
г	ɢ
гаанс	ɢ aː n s
гавал	ɢ a w ə ɮ
гадил	ɢ a tʲ ə ɮ
гадна	ɢ a t ə n
газарч	k a t͡s a r̥ t͡ɕʰ
гайхал	ɢ a i x a ɮ
гайхалгүй	k ɛː x a ɮ k u i̯
гайхалд	k ɛː x a ɮ t
гайхалтай	k ɛː x a ɮ tʰ ɛː
гайхамшиг	ɢ a i x a m ʃ i ɡ
гайхамшигтай	ɢ a i x a m ʃ i ɡ tʰ a i
гайхах	ɢ a i x a x
гайхлаар	k ɛː x ɮ aː r̥
гайхлаас	k ɛː x ɮ aː s
гайхлууд	k ɛː x ɮ ʊː t
гайхлуудаар	k ɛː x ɮ ʊː t aː r̥
гайхлуудаас	k ɛː x ɮ ʊː t aː s
гайхлуудад	k ɛː x ɮ ʊː t a t
гайхлуудгүй	k ɛː x ɮ ʊː t k u i̯
гайхлуудтай	k ɛː x ɮ ʊː t tʰ ɛː
гайхлуудыг	k ɛː x ɮ ʊː t i k
гайхлуудын	k ɛː x ɮ ʊː t i ŋ
гайхлыг	k ɛː x ɮ i k
гайхлын	k ɛː x ɮ i ŋ
гал	ɢ a ɮ
галдах	ɢ a ɮ t ə x
галиг	k a ɮ i k
галигаар	k a ɮ i ɣ aː r̥
галигаас	k a ɮ i ɣ aː s
галиггүй	k a ɮ i ɣ u i̯
галигийг	k a ɮ i ɣ iː k
галигийн	k a ɮ i ɣ iː ŋ
галигт	k a ɮ i k tʰ
галигтай	k a ɮ i k tʰ ɛː
галигууд	k a ɮ i ɣ ʊː t
галигуудаар	k a ɮ i ɣ ʊː t aː r̥
галигуудаас	k a ɮ i ɣ ʊː t aː s
галигуудад	k a ɮ i ɣ ʊː t a t
галигуудгүй	k a ɮ i ɣ ʊː t k u i̯
галигуудтай	k a ɮ i ɣ ʊː t tʰ ɛː
галигуудыг	k a ɮ i ɣ ʊː t i k
галигуудын	k a ɮ i ɣ ʊː t i ŋ
галт	ɢ a ɮ tʰ
галуу	ɢ a ɮ ʊː
гамбургер	k a m p ʊ r kʲ ɵ r̥
ган	ɢ a ŋ
ганжин	ɢ a n t͡ɕ ə ŋ
ганц	ɢ a n t͡sʰ
гар	ɢ a r
гараас	k a r aː s
гарааш	k a r aː ɕ
гараг	k a r a k
гараж	k a r a t͡ɕ
гарал	k a r a ɮ
гарах	ɢ a r ə x
гараш	k a r a ɕ
гариг	k a r i k
гарт	ɢ ä r tʰ
гарчиг	ɢ a r t͡ɕʰ ə ɡ
гатлах	ɢ a tʰ ɮ ə x
гахай	ɢ a χ æː
гектар	kʲ ɵ kʰ tʰ a r̥
гелий	kʲ ɵ ɮ iː
герман	ɡ e r m aˑ ŋ
гийгэх	ɡ iː ɡ ĕ x
гийгүүлэгч	k iː k uː ɮ e k t͡ɕʰ
гийгүүлэх	ɡ iː ɡ uː ɮ ĕ x
гитар	k i tʰ a r̥
гитараа	k i tʰ a r aː
гитараар	k i tʰ a r aː r̥
гитараараа	k i tʰ a r aː r aː
гитараас	k i tʰ a r aː s
гитараасаа	k i tʰ a r aː s aː
гитаргүй	k i tʰ a r k u i̯
гитаргүйгээ	k i tʰ a r k u i̯ ɣ eː
гитарт	k i tʰ a r̥ tʰ
гитартаа	k i tʰ a r̥ tʰ aː
гитартай	k i tʰ a r̥ tʰ ɛː
гитартайгаа	k i tʰ a r̥ tʰ ɛː k aː
гитарууд	k i tʰ a r ʊː t
гитаруудаа	k i tʰ a r ʊː t aː
гитаруудаар	k i tʰ a r ʊː t aː r̥
гитаруудаараа	k i tʰ a r ʊː t aː r aː
гитаруудаас	k i tʰ a r ʊː t aː s
гитаруудаасаа	k i tʰ a r ʊː t aː s aː
гитаруудад	k i tʰ a r ʊː t a t
гитаруудгүй	k i tʰ a r ʊː t k u i̯
гитаруудгүйгээ	k i tʰ a r ʊː t k u i̯ ɣ eː
гитарууддаа	k i tʰ a r ʊː t͉ t aː
гитаруудтай	k i tʰ a r ʊː t tʰ ɛː
гитаруудтайгаа	k i tʰ a r ʊː t tʰ ɛː k aː
гитаруудыг	k i tʰ a r ʊː t i k
гитаруудыгаа	k i tʰ a r ʊː t i ɣ aː
гитаруудын	k i tʰ a r ʊː t i ŋ
гитаруудынх	k i tʰ a r ʊː t i ŋ x
гитаруудынхаа	k i tʰ a r ʊː t i ŋ x aː
гитаруудынхан	k i tʰ a r ʊː t i ŋ x a ŋ
гитарыг	k i tʰ a r i k
гитарыгаа	k i tʰ a r i ɣ aː
гитарын	k i tʰ a r i ŋ
гитарынх	k i tʰ a r i ŋ x
гитарынхаа	k i tʰ a r i ŋ x aː
гитарынхан	k i tʰ a r i ŋ x a ŋ
гич	k i t͡ɕʰ
гоймон	ɢ ɔ i m ə ŋ
гол	ɢ ɔ ɮ
гольф	k ɔ ɮʲ f
гольфчин	k ɔ ɮʲ f t͡ɕʰ i ŋ
гомдоох	ɢ ɔ m t ɔː x
гомдох	ɢ ɔ m t ɔ x
граж	k r a t͡ɕ
грек	k rʲ ɵ kʰ
грекгүй	k rʲ ɵ kʰ k u i̯
грекгүйгээ	k rʲ ɵ kʰ k u i̯ ɣ eː
грекийг	k rʲ ɵ kʰ iː k
грекийгээ	k rʲ ɵ kʰ iː k eː
грекийн	k rʲ ɵ kʰ iː ŋ
грекийнх	k rʲ ɵ kʰ iː ŋ x
грекийнхэн	k rʲ ɵ kʰ iː ŋ x e ŋ
грекийнхээ	k rʲ ɵ kʰ iː ŋ x eː
грект	k rʲ ɵ kʰ tʰ
гректэй	k rʲ ɵ kʰ tʰ e i̯
гректэйгээ	k rʲ ɵ kʰ tʰ e i̯ ɣ eː
гректээ	k rʲ ɵ kʰ tʰ eː
грекчүүд	k rʲ ɵ kʰ t͡ɕʰ uː t
грекээ	k rʲ ɵ kʰ eː
грекээр	k rʲ ɵ kʰ eː r̥
грекээрээ	k rʲ ɵ kʰ eː r eː
грекээс	k rʲ ɵ kʰ eː s
грекээсээ	k rʲ ɵ kʰ eː s eː
грекүүд	k rʲ ɵ kʰ uː t
грекүүдгүй	k rʲ ɵ kʰ uː t k u i̯
грекүүдгүйгээ	k rʲ ɵ kʰ uː t k u i̯ ɣ eː
грекүүддээ	k rʲ ɵ kʰ uː t͉ t eː
грекүүдийг	k rʲ ɵ kʰ uː t iː k
грекүүдийгээ	k rʲ ɵ kʰ uː t iː k eː
грекүүдийн	k rʲ ɵ kʰ uː t iː ŋ
грекүүдийнх	k rʲ ɵ kʰ uː t iː ŋ x
грекүүдийнхэн	k rʲ ɵ kʰ uː t iː ŋ x e ŋ
грекүүдийнхээ	k rʲ ɵ kʰ uː t iː ŋ x eː
грекүүдтэй	k rʲ ɵ kʰ uː t tʰ e i̯
грекүүдтэйгээ	k rʲ ɵ kʰ uː t tʰ e i̯ ɣ eː
грекүүдэд	k rʲ ɵ kʰ uː t e t
грекүүдээ	k rʲ ɵ kʰ uː t eː
грекүүдээр	k rʲ ɵ kʰ uː t eː r̥
грекүүдээрээ	k rʲ ɵ kʰ uː t eː r eː
грекүүдээс	k rʲ ɵ kʰ uː t eː s
грекүүдээсээ	k rʲ ɵ kʰ uː t eː s eː
групп	k r ʊ pʰ
гуай	k u̯ ɛː
гуайг	k u̯ ɛː k
гуайгаар	k u̯ ɛː k aː r̥
гуайгаас	k u̯ ɛː k aː s
гуайгүй	k u̯ ɛː k u i̯
гуайд	k u̯ ɛː t
гуайн	k u̯ ɛː ŋ
гуайнд	k u̯ ɛː n t
гуайнууд	k u̯ ɛː n ʊː t
гуайнуудаар	k u̯ ɛː n ʊː t aː r̥
гуайнуудаас	k u̯ ɛː n ʊː t aː s
гуайнуудад	k u̯ ɛː n ʊː t a t
гуайнуудгүй	k u̯ ɛː n ʊː t k u i̯
гуайнуудтай	k u̯ ɛː n ʊː t tʰ ɛː
гуайнуудыг	k u̯ ɛː n ʊː t i k
гуайнуудын	k u̯ ɛː n ʊː t i ŋ
гуайнуудынд	k u̯ ɛː n ʊː t i n t
гуайтай	k u̯ ɛː tʰ ɛː
гудамж	ɢ ʊ t ə m t͡ɕ
гуйх	ɢ ʊ i x
гулууз	ɢ ʊ ɮ ʊ t͡s
гурав	ɢ ʊ r ə w
гуравдугаар	k ʊ r a w̜ t ʊ ɣ aː r̥
гурамсан	k ʊ r a m s a ŋ
гурил	ɢ ʊ rʲ ə ɮ
гутаах	ɢ ʊ tʰ a x
гутал	ɢ ʊ tʰ ə ɮ
гууль	ɢ ʊː ɮʲ
гуя	k ʊ j
гэ	k e
гэгээнтэн	k e ɣ eː n tʰ e ŋ
гэдэс	k e t e s
гэлэн	ɡ i ɮ ə ŋ
гэлэнмаа	ɡ i ɮ ə m m a
гэмших	ɡ i m ʃ ə x
гэр	ɡ e r
гэргий	ɡ e r ɡ iː
гэргүй	k e r k u i̯
гэргүйгээ	k e r k u i̯ ɣ eː
гэрийг	k e r iː k
гэрийгээ	k e r iː k eː
гэрийн	k e r iː ŋ
гэрийнх	k e r iː ŋ x
гэрийнхээ	k e r iː ŋ x eː
гэрт	k e r̥ tʰ
гэртэй	k e r̥ tʰ e i̯
гэртэйгээ	k e r̥ tʰ e i̯ ɣ eː
гэртээс	k e r̥ tʰ eː s
гэртээсээ	k e r̥ tʰ eː s eː
гэрэл	k e r e ɮ
гэрээ	k e r eː
гэрээр	k e r eː r̥
гэрээрээ	k e r eː r eː
гэрээс	k e r eː s
гэрээсээ	k e r eː s eː
гэрүүд	k e r uː t
гэрүүдгүй	k e r uː t k u i̯
гэрүүдгүйгээ	k e r uː t k u i̯ ɣ eː
гэрүүддээ	k e r uː t͉ t eː
гэрүүдийг	k e r uː t iː k
гэрүүдийгээ	k e r uː t iː k eː
гэрүүдийн	k e r uː t iː ŋ
гэрүүдийнх	k e r uː t iː ŋ x
гэрүүдийнхэн	k e r uː t iː ŋ x e ŋ
гэрүүдийнхээ	k e r uː t iː ŋ x eː
гэрүүдтэй	k e r uː t tʰ e i̯
гэрүүдтэйгээ	k e r uː t tʰ e i̯ ɣ eː
гэрүүдэд	k e r uː t e t
гэрүүдээ	k e r uː t eː
гэрүүдээр	k e r uː t eː r̥
гэрүүдээрээ	k e r uː t eː r eː
гэрүүдээс	k e r uː t eː s
гэрүүдээсээ	k e r uː t eː s eː
гэхчлэн	k e x t͡ɕʰ ɮ e ŋ
гүзээлзгэнэ	k u t͡s eː ɮ t͡s k e n
гүн	ɡ u ŋ
гүнж	k u n t͡ɕ
гүнжгүй	k u n t͡ɕ k u i̯
гүнжгүйгээ	k u n t͡ɕ k u i̯ ɣ eː
гүнждийг	k u n t͡ɕ t iː k
гүнждийгээ	k u n t͡ɕ t iː k eː
гүнждийн	k u n t͡ɕ t iː ŋ
гүнждийнх	k u n t͡ɕ t iː ŋ x
гүнждийнхэн	k u n t͡ɕ t iː ŋ x e ŋ
гүнждийнхээ	k u n t͡ɕ t iː ŋ x eː
гүнждэд	k u n t͡ɕ t e t
гүнждэдээ	k u n t͡ɕ t e t eː
гүнждээ	k u n t͡ɕ t eː
гүнждээр	k u n t͡ɕ t eː r̥
гүнждээрээ	k u n t͡ɕ t eː r eː
гүнждээс	k u n t͡ɕ t eː s
гүнждээсээ	k u n t͡ɕ t eː s eː
гүнжид	k u n t͡ɕ i t
гүнжидгүй	k u n t͡ɕ i t k u i̯
гүнжидгүйгээ	k u n t͡ɕ i t k u i̯ ɣ eː
гүнжидтэй	k u n t͡ɕ i t tʰ e i̯
гүнжидтэйгээ	k u n t͡ɕ i t tʰ e i̯ ɣ eː
гүнжийг	k u n t͡ɕ iː k
гүнжийгээ	k u n t͡ɕ iː k eː
гүнжийн	k u n t͡ɕ iː ŋ
гүнжийнх	k u n t͡ɕ iː ŋ x
гүнжийнхэн	k u n t͡ɕ iː ŋ x e ŋ
гүнжийнхээ	k u n t͡ɕ iː ŋ x eː
гүнжтэй	k u n t͡ɕ tʰ e i̯
гүнжтэйгээ	k u n t͡ɕ tʰ e i̯ ɣ eː
гүнжээ	k u n t͡ɕ eː
гүнжээр	k u n t͡ɕ eː r̥
гүнжээрээ	k u n t͡ɕ eː r eː
гүнжээс	k u n t͡ɕ eː s
гүнжээсээ	k u n t͡ɕ eː s eː
гүнжүүд	k u n t͡ɕ uː t
гүнжүүдгүй	k u n t͡ɕ uː t k u i̯
гүнжүүдгүйгээ	k u n t͡ɕ uː t k u i̯ ɣ eː
гүнжүүддээ	k u n t͡ɕ uː t͉ t eː
гүнжүүдийг	k u n t͡ɕ uː t iː k
гүнжүүдийгээ	k u n t͡ɕ uː t iː k eː
гүнжүүдийн	k u n t͡ɕ uː t iː ŋ
гүнжүүдийнх	k u n t͡ɕ uː t iː ŋ x
гүнжүүдийнхэн	k u n t͡ɕ uː t iː ŋ x e ŋ
гүнжүүдийнхээ	k u n t͡ɕ uː t iː ŋ x eː
гүнжүүдтэй	k u n t͡ɕ uː t tʰ e i̯
гүнжүүдтэйгээ	k u n t͡ɕ uː t tʰ e i̯ ɣ eː
гүнжүүдэд	k u n t͡ɕ uː t e t
гүнжүүдээ	k u n t͡ɕ uː t eː
гүнжүүдээр	k u n t͡ɕ uː t eː r̥
гүнжүүдээрээ	k u n t͡ɕ uː t eː r eː
гүнжүүдээс	k u n t͡ɕ uː t eː s
гүнжүүдээсээ	k u n t͡ɕ uː t eː s eː
гүрвэл	k u r w̜ e ɮ
гүрэн	ɡ u r e ŋ
гүүр	ɡ uː r
д	t
даатгал	t aː tʰ ɢ a ɮ
даатгах	t aː tʰ ɢ a x
давс	t a w s
давхар	t a w̜ x ə r
дайгдах	t a i ɡ t ə x
дайн	t a i ŋ
дайралт	t ɛː r a ɮ tʰ
дайсан	t ɛː s a ŋ
дайх	t a i x
дал	t a ɮ
далавч	t a ɮ a w̜ t͡ɕʰ
далбаа	t a ɮ p a
дамжуулагч	t a m t͡ɕ ʊː ɮ a k t͡ɕʰ
дамнах	t a m n ə x
дампуурал	t a m pʰ ʊː r a ɮ
дампуурах	t a m pʰ ʊː r a x
данс	t a n s
дарангуйлагч	t a r a ŋ k ʊ i̯ ɮ a k t͡ɕʰ
дарма	t a r m
дарс	t a r s
дарь	t ɛ r
дасах	t a s ə x
дасгал	t a s ɢ ə ɮ
дахин	t a x i ŋ
дахин	t a xʲ ə ŋ
дахь	t a xʲ
дельта	tʲ ɵ ɮʲ tʰ
дийлэгч	t iː ɮ e k t͡ɕʰ
диктатур	t i kʰ tʰ a tʰ ʊ r̥
динозавр	t i n ɔ t͡s a w̜ r̥
динозавраар	t i n ɔ t͡s a w̜ r aː r̥
динозавраас	t i n ɔ t͡s a w̜ r aː s
динозавргүй	t i n ɔ t͡s a w̜ r k u i̯
динозаврт	t i n ɔ t͡s a w̜ r̥ tʰ
динозавртай	t i n ɔ t͡s a w̜ r̥ tʰ ɛː
динозаврууд	t i n ɔ t͡s a w̜ r ʊː t
динозавруудаар	t i n ɔ t͡s a w̜ r ʊː t aː r̥
динозавруудаас	t i n ɔ t͡s a w̜ r ʊː t aː s
динозавруудад	t i n ɔ t͡s a w̜ r ʊː t a t
динозавруудгүй	t i n ɔ t͡s a w̜ r ʊː t k u i̯
динозавруудтай	t i n ɔ t͡s a w̜ r ʊː t tʰ ɛː
динозавруудыг	t i n ɔ t͡s a w̜ r ʊː t i k
динозавруудын	t i n ɔ t͡s a w̜ r ʊː t i ŋ
динозаврыг	t i n ɔ t͡s a w̜ r i k
динозаврын	t i n ɔ t͡s a w̜ r i ŋ
дипломатч	t i pʰ ɮ ɔ m a tʰ t͡ɕʰ
довжоо	t ɔ w̜ t͡ɕ ɔ
догма	t ɔ k m
догшин	t ɔ ɡ ʃ ə ŋ
долоо	t ɔ ɮ oː
долоодугаар	t ɔ ɮ oː t ʊ ɣ aː r̥
долоох	t ɔ ɮ ɔ x
доо	t oː
доромжлох	t ɔ r ɔ m t͡ɕ ɮ ɔ x
дотор	t ɔ tʰ ə r
дохих	t ɔ xʲ ə x
дугаар	t ʊ ɣ aː r̥
дугуйлан	t ʊ ɣ ʊ i̯ ɮ a ŋ
дудран	t ʊ t r ə ŋ
дун	t ʊ ŋ
дундаж	t ʊ n t a t͡ɕ
дур	t ʊ r̥
дурдах	t ʊ r t ə x
дуудлага	t ʊː t ɮ ə ɢ
дуулга	d u ɮ ɢ a
дуулгавар	t ʊː ɮ ɢ ə w ə r
дуурь	t ʊː rʲ
дуусгах	t ʊː s ɢ ə x
дуучин	t ʊː t͡ɕʰ ə ŋ
дэ	t e
дэвтэр	t e w̜ tʰ e r̥
дэвшигч	t e w̜ ɕ i k t͡ɕʰ
дэвшил	t e w̜ ɕ i ɮ
дэвшилт	t i w ʃ ə ɮ tʰ
дэвших	t i w ʃ ə x
дэл	t i ɮ
дэлгүүр	t e ɮ k uː r̥
дэлгүүрт	t e ɮ k uː r̥ tʰ
дэлхий	t e ɬʰ iː
дэлэн	t e ɮ ə ŋ
дэлэнч	t e ɮ e n t͡ɕʰ
дэлүү	t e ɮ u
дэнлүү	t e n ɮ u
дэргэд	t e r k e t
дэрс	t e r s
дэслэгч	t e s ɮ e k t͡ɕʰ
дэх	t e x
дээ	t eː
дээл	t eː ɮ
дээр	t eː r
дүнгэр	t u ŋ ɡ ə r
дүнчүүр	t u n t͡ɕʰ uː r̥
дүпү	t u pʰ
дүрс	t u r s
дүү	t uː
дүүрэг	t uː r e k
дөрвөд	t ɵ r w̜ u t
дөрвөл	t ɵ r w̜ u ɮ
дөрөв	t ɵ r u w̜
дөрөвдүгээр	t ɵ r ɵ w̜ t u ɣ eː r̥
дөө	t ɵː
е	j ɵ
европчууд	j ɵ w r ɔˑ pʰ t͡ʃʰ ʊː t
ер	j ɵ r̥
ерөнхийлөгч	j o r ə ŋ x i ɮ ə ɡ t͡ɕʰ
ерөнхийлөх	j ɵ r ɵ ŋ x iː ɮ ɵ x
ерөөх	j ɵ r ɵː x
ес	j ɵ s
есдүгээр	j ɵ s t u ɣ eː r̥
еэвэн	j eː w ə ŋ
ж	t͡ɕ
жаал	t͡ɕ aː ɮ
жавтий	t͡ɕ a w̜ tʰ iː
жад	t͡ɕ a t
жар	t͡ɕ a r̥
жаргалтай	t͡ɕ a r k a ɮ tʰ ɛː
жигнэмэг	t͡ɕ i ɡ n ə m ə ɡ
жигүүр	t͡ɕ i ɣ uː r̥
жижиглэн	t͡ɕ i t͡ɕ i k ɮ e ŋ
жижүүр	t͡ɕ i t͡ɕ u r
жилгүй	t͡ɕ i ɮ k u i̯
жилд	t͡ɕ i ɮ t
жилийг	t͡ɕ i ɮ iː k
жилийнх	t͡ɕ i ɮ iː ŋ x
жилийнхэн	t͡ɕ i ɮ iː ŋ x e ŋ
жилтэй	t͡ɕ i ɮ tʰ e i̯
жилээр	t͡ɕ i ɮ eː r̥
жилээс	t͡ɕ i ɮ eː s
жилүүд	t͡ɕ i ɮ uː t
жилүүдгүй	t͡ɕ i ɮ uː t k u i̯
жилүүдийг	t͡ɕ i ɮ uː t iː k
жилүүдийн	t͡ɕ i ɮ uː t iː ŋ
жилүүдийнх	t͡ɕ i ɮ uː t iː ŋ x
жилүүдийнхэн	t͡ɕ i ɮ uː t iː ŋ x e ŋ
жилүүдтэй	t͡ɕ i ɮ uː t tʰ e i̯
жилүүдэд	t͡ɕ i ɮ uː t e t
жилүүдээр	t͡ɕ i ɮ uː t eː r̥
жилүүдээс	t͡ɕ i ɮ uː t eː s
жимс	t͡ɕ i m s
жинхэнэ	t͡ɕ i ŋ x e n
жишээ	t͡ɕ i ɕ eː
жишээг	t͡ɕ i ɕ eː k
жишээгээр	t͡ɕ i ɕ eː k eː r̥
жишээгүй	t͡ɕ i ɕ eː k u i̯
жишээн	t͡ɕ i ɕ eː ŋ
жишээнд	t͡ɕ i ɕ eː n t
жишээний	t͡ɕ i ɕ eː n iː
жишээнийх	t͡ɕ i ɕ eː n iː x
жишээнээс	t͡ɕ i ɕ eː n eː s
жишээнүүд	t͡ɕ i ɕ eː n uː t
жишээнүүдгүй	t͡ɕ i ɕ eː n uː t k u i̯
жишээнүүдийг	t͡ɕ i ɕ eː n uː t iː k
жишээнүүдийн	t͡ɕ i ɕ eː n uː t iː ŋ
жишээнүүдийнх	t͡ɕ i ɕ eː n uː t iː ŋ x
жишээнүүдтэй	t͡ɕ i ɕ eː n uː t tʰ e i̯
жишээнүүдэд	t͡ɕ i ɕ eː n uː t e t
жишээнүүдээр	t͡ɕ i ɕ eː n uː t eː r̥
жишээнүүдээс	t͡ɕ i ɕ eː n uː t eː s
жишээтэй	t͡ɕ i ɕ eː tʰ e i̯
жор	t͡ɕ ɔ r
жорлон	t͡ɕ ɔ r ɮ ə ŋ
жунгаа	t͡ʃ ʊ ŋ ɢ aː
журамлах	t͡ɕ ʊ r a m ɮ a x
жуулчин	t͡ɕ ʊː ɮ t͡ɕʰ i ŋ
жууцай	t͡ɕ ʊː t͡sʰ ɛː
жууцайг	t͡ɕ ʊː t͡sʰ ɛː k
жууцайгаар	t͡ɕ ʊː t͡sʰ ɛː k aː r̥
жууцайгүй	t͡ɕ ʊː t͡sʰ ɛː k u i̯
жууцайн	t͡ɕ ʊː t͡sʰ ɛː ŋ
жууцайнаас	t͡ɕ ʊː t͡sʰ ɛː n aː s
жууцайнд	t͡ɕ ʊː t͡sʰ ɛː n t
жууцайнууд	t͡ɕ ʊː t͡sʰ ɛː n ʊː t
жууцайнуудаар	t͡ɕ ʊː t͡sʰ ɛː n ʊː t aː r̥
жууцайнуудаас	t͡ɕ ʊː t͡sʰ ɛː n ʊː t aː s
жууцайнуудад	t͡ɕ ʊː t͡sʰ ɛː n ʊː t a t
жууцайнуудгүй	t͡ɕ ʊː t͡sʰ ɛː n ʊː t k u i̯
жууцайнуудтай	t͡ɕ ʊː t͡sʰ ɛː n ʊː t tʰ ɛː
жууцайнуудыг	t͡ɕ ʊː t͡sʰ ɛː n ʊː t i k
жууцайнуудын	t͡ɕ ʊː t͡sʰ ɛː n ʊː t i ŋ
жууцайны	t͡ɕ ʊː t͡sʰ ɛː n i
жууцайтай	t͡ɕ ʊː t͡sʰ ɛː tʰ ɛː
жэ	t͡ɕ e
жүдо	t͡ɕ u t
з	t͡s
заазуур	t͡s aː t͡s ʊː r̥
заалдлага	t͡s aː ɮ t ɮ a ɣ
заан	t͜s aː ɴ̟
заарь	t͡s aː r
заах	t͡s aː x
заваан	t͡s a w̜ aː ŋ
завгүй	t͡s a w̜ k u i̯
завод	t͜s ä w̜ ɔˑ t
завь	t͡s a wʲ
заг	t͡s a ɡ
загас	t͡s a ɢ ə s
зайдуу	t͡s a i t ʊ
залах	t͡s a ɮ ə x
залбирал	t͡s a ɮ p i r a ɮ
залбирах	t͡s a ɮ p i r a x
залгавар	t͡s a ɮ k a w̜ a r̥
залгамал	t͡s a ɮ ɢ ə m ə ɮ
залгах	t͡s a ɮ ɢ ə x
залгуур	t͡s a ɮ ɢ ʊ r
залуу	t͡s a ɮ ʊ
залуур	t͡s a ɮ ʊ r
залуучуудад	t͡s a ɮ ʊː t͡ɕʰ ʊː t a t
залуучуудын	t͡s a ɮ ʊː t͡ɕʰ ʊː t i ŋ
зам	t͡s a m
замбага	t͡s a m p ə ɢ
зан	t͡s a ŋ
занах	t͡s a n ə x
зангилаа	t͡s a ŋ ɡʲ ə ɮ a
зангуу	t͡s a ŋ ɢ ʊ
зандах	t͡s a n t ə x
зардаг	t͡s a r t ə ɡ
зарим	t͡s a rʲ ə m
заримдаа	t͡s a rʲ ə m t a
зарлал	t͡s a r ɮ a ɮ
зарц	t͡s a r̥ t͡sʰ
засрал	t͡s a s r a ɮ
засуул	t͡s a s ʊː ɮ
зах	t͡s a x
захиа	t͡s a x j a
захчин	t͜s a χ t͜ɕʰ ə ŋ
зовлон	t͡s ɔ w ɮ ə ŋ
зогсох	t͡s ɔ ɡ s ə x
золбин	t͡s ɔ ɮʲ pʲ ə ŋ
золгох	t͡s ɔ ɮ ɢ ə x
зонтик	t͜s ɔˑ n tʰ ʊ̈ kʰ
зориг	t͡s ɔ rʲ ə ɡ
зориглох	t͡s ɔ rʲ ə ɡ ɮ ə x
зоригоор	t͡s ɔ rʲ ə ɡ ɔ r
зоригт	t͡s ɔ rʲ ə ɡ tʰ
зорилго	t͡s ɔ rʲ ə ɮ ə ɢ
зорилт	t͡s ɔ rʲ ə ɮ tʰ
зоримгой	t͡s ɔ rʲ ə m ɢ ɔ i
зоримог	t͡s ɔ rʲ ə m ə ɡ
зориуд	t͡s ɔ rʲ ʊ t
зориулах	t͡s ɔ rʲ ʊ ɮ ə x
зохиол	t͜s œ x ɔː ɮ
зочин	t͡s ɔ t͡ɕʰ i ŋ
зугтах	t͡s ʊ ɡ tʰ ə x
зузаан	t͡s ʊ t͡s a ŋ
зул	t͡s ʊ ɮ
зулзага	t͡s ʊ ɮ t͡s ə ɢ
зун	t͡s ʊ ŋ
зураас	t͡s ʊ r aː s
зураач	t͡s ʊ r aː t͡ɕʰ
зураг	t͡s ʊ r a ɡ
зурагт	t͡s ʊ r a k tʰ
зурагчин	t͜s ʊ r x̠ t͜ɕʰ ə ŋ
зурвас	t͡s ʊ r w ə s
зургаадугаар	t͡s ʊ r k aː t ʊ ɣ aː r̥
зурхай	t͡s ʊ r x ɛː
зутан	t͡s ʊ tʰ a ŋ
зууж	t͡s ʊː t͡ɕ
зуух	t͡s ʊː x
зэ	t͡s e
зэвсэг	t͡s i w s ə ɡ
зэрлэг	t͡s e r ɮ ə ɡ
зэс	t͡s i s
зээ	t͡s eː
зээлбэр	t s eː ɮ p ɪ̆ r
зээр	t͡s eː r
зээргэнэ	t͡s eː r ɡ ə n
зүг	t͡s u k
зүй	t͡s u i
зүйр	t͡s u i r
зүйрлэл	t͡s u i r ɮ ə ɮ
зүйрлэх	t͡s u i r ɮ ə x
зүс	t͡s u s
зүү	t͡s uː
зүүд	t͡s uː t
зүүдлэх	t͡s uː t ɮ ə x
зүүн	d͡ʒ uː n
зүүнтэн	t͜s uː n tʰ ə ŋ
зөвлөгөө	t͡s o w ɮ ə ɡ o
зөвшөөрөл	t͡s ɵ w ʃ oː r ɵ ɮ
зөвшөөрөх	t͡s ɵ w ʃ oː r ɵ x
зөгий	t͡s ɵ ɣ iː
зөгийг	t͡s ɵ ɣ iː k
зөгийгүй	t͡s ɵ ɣ iː k u i̯
зөгийгөөр	t͡s ɵ ɣ iː k ɵː r̥
зөгийгөөс	t͡s ɵ ɣ iː k ɵː s
зөгийд	t͡s ɵ ɣ iː t
зөгийн	t͡s ɵ ɣ iː ŋ
зөгийнүүд	t͡s ɵ ɣ iː n uː t
зөгийнүүдгүй	t͡s ɵ ɣ iː n uː t k u i̯
зөгийнүүдийг	t͡s ɵ ɣ iː n uː t iː k
зөгийнүүдийн	t͡s ɵ ɣ iː n uː t iː ŋ
зөгийнүүдтэй	t͡s ɵ ɣ iː n uː t tʰ e i̯
зөгийнүүдэд	t͡s ɵ ɣ iː n uː t e t
зөгийнүүдээр	t͡s ɵ ɣ iː n uː t eː r̥
зөгийнүүдээс	t͡s ɵ ɣ iː n uː t eː s
зөгийтэй	t͡s ɵ ɣ iː tʰ e i̯
зөөлөн	t͡s ɵː ɮ ɵ ŋ
и	i
ивээл	i w eː ɮ
идэх	i t ə x
израйльчууд	i t͡s r ɛː ɮʲ t͡ɕʰ ʊː t
ил	i ɮ
илд	i ɮ t
илжгийг	i ɮ t͡ɕ k iː k
илжгэн	i ɮ t͡ɕ k e ŋ
илжгэнд	i ɮ t͡ɕ k e n t
илжгээр	i ɮ t͡ɕ k eː r̥
илжиг	i ɮ t͡ɕ i k
илжиггүй	i ɮ t͡ɕ i ɣ u i̯
илжигний	i ɮ t͡ɕ i k n iː
илжигнийх	i ɮ t͡ɕ i k n iː x
илжигнийхэн	i ɮ t͡ɕ i k n iː x e ŋ
илжигнээс	i ɮ t͡ɕ i k n eː s
илжигнүүд	i ɮ t͡ɕ i k n uː t
илжигнүүдгүй	i ɮ t͡ɕ i k n uː t k u i̯
илжигнүүдийг	i ɮ t͡ɕ i k n uː t iː k
илжигнүүдийн	i ɮ t͡ɕ i k n uː t iː ŋ
илжигнүүдийнх	i ɮ t͡ɕ i k n uː t iː ŋ x
илжигнүүдийнхэн	i ɮ t͡ɕ i k n uː t iː ŋ x e ŋ
илжигнүүдтэй	i ɮ t͡ɕ i k n uː t tʰ e i̯
илжигнүүдэд	i ɮ t͡ɕ i k n uː t e t
илжигнүүдээр	i ɮ t͡ɕ i k n uː t eː r̥
илжигнүүдээс	i ɮ t͡ɕ i k n uː t eː s
илжигтэй	i ɮ t͡ɕ i k tʰ e i̯
иллэг	i ɮː e k
илтгэх	i ɮ tʰ ɡ ə x
илхэн	i ɮ x ə ŋ
имрэх	i m r ə x
индүү	i n t uː
инээмсэглэх	i n eː m s e k ɮ e x
иод	i̯ oː t
ирвэс	i r w ə s
ирц	i r t͡sʰ
ирээдүй	i r e t u i
ислам	i s ɮ a m
испаничууд	i s pʰ a n i t͡ɕʰ ʊː t
ихгүй	i x k u i̯
ихэр	i x ə r
й	i
ка	kʰ a
какао	kʰ a kʰ ɒː
календарь	k a ɮ e n d a rʲ
канжи	kʰ a n t͡ɕ
каталог	kʰ a tʰ a ɮ ɔ k
каучук	kʰ a w t͡ʃʰ ʊˑ kʰ
кидан	kʰ i t a ŋ
киданчууд	kʰ i t a n t͡ɕʰ ʊː t
километр	kʰ i ɮ ɔ mʲ ɵ tʰ r̥
кино	kʰ i n ɔˑ
киногоор	kʰ i n ɔ ɣ oː r̥
киногүй	kʰ i n ɔ ɣ u i̯
кинон	kʰ i n ɔ ŋ
кинонд	kʰ i n ɔ n t
киноноос	kʰ i n ɔ n oː s
кинонууд	kʰ i n ɔ n ʊː t
кинонуудаар	kʰ i n ɔ n ʊː t aː r̥
кинонуудаас	kʰ i n ɔ n ʊː t aː s
кинонуудад	kʰ i n ɔ n ʊː t a t
кинонуудгүй	kʰ i n ɔ n ʊː t k u i̯
кинонуудтай	kʰ i n ɔ n ʊː t tʰ ɛː
кинонуудыг	kʰ i n ɔ n ʊː t i k
кинонуудын	kʰ i n ɔ n ʊː t i ŋ
киноных	kʰ i n ɔ n i x
киноныхон	kʰ i n ɔ n i x ɔ ŋ
кинотеатр	kʰ i n ɔ tʰʲ ɵ a tʰ r̥
кинотой	kʰ i n ɔ tʰ ɔ i̯
командлагч	kʰ ɔ m a n t ɮ a k t͡ɕʰ
комиссар	kʰ ɔ m i sː a r̥
коммунизм	kʰ ɔ m ʊ n iˑ s ʊ m
коммунизм	kʰ ɔ m ʊ n iˑ t͜s ʊ m
коммунист	kʰ ɔ mː ʊ n i s tʰ
компани	kʰ ɔ m pʰ a n
компьютер	kʰ ɔ m pʰ j ʊ tʰʲ ɵ r̥
констракшн	kʰ ɔ n s tʰ r a kʰ ɕ ŋ
консул	kʰ ɔ n s ʊ ɮ
кураш	kʰ ʊ r a ɕ
күүки	kʰ uː kʰ
л	ɪ ɮ
л	ɮ
лал	ɮ a ɮ
лаларгүй	ɮ a ɮ a r k u i̯
лаларт	ɮ a ɮ a r̥ tʰ
лалартай	ɮ a ɮ a r̥ tʰ ɛː
лалраар	ɮ a ɮ r aː r̥
лалраас	ɮ a ɮ r aː s
лалрууд	ɮ a ɮ r ʊː t
лалруудаар	ɮ a ɮ r ʊː t aː r̥
лалруудаас	ɮ a ɮ r ʊː t aː s
лалруудад	ɮ a ɮ r ʊː t a t
лалруудгүй	ɮ a ɮ r ʊː t k u i̯
лалруудтай	ɮ a ɮ r ʊː t tʰ ɛː
лалруудыг	ɮ a ɮ r ʊː t i k
лалруудын	ɮ a ɮ r ʊː t i ŋ
лалруудынх	ɮ a ɮ r ʊː t i ŋ x
лалруудынхан	ɮ a ɮ r ʊː t i ŋ x a ŋ
лалрыг	ɮ a ɮ r i k
лалрын	ɮ a ɮ r i ŋ
лалрынх	ɮ a ɮ r i ŋ x
лалрынхан	ɮ a ɮ r i ŋ x a ŋ
лантуу	ɮ a n tʰ ʊː
лийр	ɮ iː r
лифт	ɮ i f tʰ
лобби	ɮ ɔ b i
лонх	ɮ ɔ n x
луйвар	ɮ ʊ̙ i w̜ a r
лууван	ɮ ʊː w̜ ə ŋ
лууг	ɮ ʊː k
луугаа	ɮ ʊː k aː
луугаар	ɮ ʊː k aː r̥
луугаараа	ɮ ʊː k aː r aː
луугүй	ɮ ʊː k u i̯
луугүйгээ	ɮ ʊː k u i̯ ɣ eː
луун	ɮ ʊː ŋ
луунаас	ɮ ʊː n aː s
луунаасаа	ɮ ʊː n aː s aː
луунд	ɮ ʊː n t
луундаа	ɮ ʊː n t aː
луунууд	ɮ ʊː n ʊː t
луунуудаа	ɮ ʊː n ʊː t aː
луунуудаар	ɮ ʊː n ʊː t aː r̥
луунуудаараа	ɮ ʊː n ʊː t aː r aː
луунуудаас	ɮ ʊː n ʊː t aː s
луунуудаасаа	ɮ ʊː n ʊː t aː s aː
луунуудад	ɮ ʊː n ʊː t a t
луунуудгүй	ɮ ʊː n ʊː t k u i̯
луунуудгүйгээ	ɮ ʊː n ʊː t k u i̯ ɣ eː
луунууддаа	ɮ ʊː n ʊː t͉ t aː
луунуудтай	ɮ ʊː n ʊː t tʰ ɛː
луунуудтайгаа	ɮ ʊː n ʊː t tʰ ɛː k aː
луунуудыг	ɮ ʊː n ʊː t i k
луунуудыгаа	ɮ ʊː n ʊː t i ɣ aː
луунуудын	ɮ ʊː n ʊː t i ŋ
луунуудынх	ɮ ʊː n ʊː t i ŋ x
луунуудынхаа	ɮ ʊː n ʊː t i ŋ x aː
луунуудынхан	ɮ ʊː n ʊː t i ŋ x a ŋ
лууны	ɮ ʊː n i
лууных	ɮ ʊː n i x
лууныхаа	ɮ ʊː n i x aː
лууныхан	ɮ ʊː n i x a ŋ
луутай	ɮ ʊː tʰ ɛː
луутайгаа	ɮ ʊː tʰ ɛː k aː
лхагва	ɬ a w ə ɡ
лүү	ɮ uː
м	m
маажих	m aː t͡ɕ ə x
маань	m æː n
магистр	m a k i s tʰ r̥
магма	m a k m
магтаал	m a x t a ɮ
магтаал	m a ɡ tʰ a ɮ
магтах	m a x t ă
мад	m a t
мажоритар	m a d͡ʑ ɔ r i tʰ a r̥
мал	m a ɮ
малгай	m a ɮ ɢ a i
маллах	m a ɮ ɮ ə x
малчин	m a ɮ t͡ɕʰ ə ŋ
манай	m a n æː
манан	m a n ə ŋ
мануул	m a n ʊ ɮ
маргад	m a r k a t
маргах	m a r ɢ a x
марк	m ä r k
маркетинг	m a r̥ kʰʲ ɵ tʰ i ŋ k
массаж	m a s s a t͡ɕ
мастурбац	m a s tʰ ʊ r p a t͡sʰ
математик	m a tʰʲ ɵ m a tʰ i kʰ
математикч	m a tʰʲ ɵ m a tʰ i kʰ t͡ɕʰ
мах	m a x
махбод	m a x p ɔ t
махийх	m a xʲ i x
махчин	m a x t͡ɕʰ ə ŋ
маш	m a ʃ
машин	m a ɕ i ŋ
машинд	m a ɕ i n t
металл	mʲ ɵ tʰ a ɮ
металлурги	mʲ ɵ tʰ a ɮ ɮ ʊ r k
метр	mʲ ɵ tʰ r̥
миний	m i n iː
минь	m i n
могой	m ɔ ɣ ɔ i̯
модны	m ɔ t n iː
модоч	m ɔ t ə t͡ɕʰ
мойл	m ɔ i ɮ
молтогчин	m ɔ ɮ tʰ ə ɣ t͡ɕ ə n
монгол	m ɔ ɴ ɢ ʊ ɮ
монголч	m ɔ ɴ ɢ ʊ ɮ t͡ʃʰ
моргейж	m ɔ r kʲ ɵ i̯ t͡ɕ
морийг	m ɔ r iː k
морийгоо	m ɔ r iː k oː
морилох	m ɔ rʲ ɮ ə x
морин	m ɔ r i ŋ
моринд	m ɔ r i n t
мориндоо	m ɔ r i n t oː
мориндоос	m ɔ r i n t oː s
мориндоосоо	m ɔ r i n t oː s oː
мориноос	m ɔ r i n oː s
мориноосоо	m ɔ r i n oː s oː
морины	m ɔ r i n i
мориных	m ɔ r i n i x
мориныхгүй	m ɔ r i n i x k u i̯
мориныхгүйгээ	m ɔ r i n i x k u i̯ ɣ eː
мориныхдоо	m ɔ r i n i x t oː
мориныход	m ɔ r i n i x ɔ t
мориныхоо	m ɔ r i n i x oː
мориныхоор	m ɔ r i n i x oː r̥
мориныхоороо	m ɔ r i n i x oː r oː
мориныхоос	m ɔ r i n i x oː s
мориныхоосоо	m ɔ r i n i x oː s oː
мориныхтой	m ɔ r i n i x tʰ ɔ i̯
мориныхтойгоо	m ɔ r i n i x tʰ ɔ i̯ ɣ oː
мориныхыг	m ɔ r i n i x i k
мориныхыгоо	m ɔ r i n i x i ɣ oː
морио	m ɔ r i̯ oː
мориор	m ɔ r i̯ oː r̥
мориороо	m ɔ r i̯ oː r oː
морь	m œ r
морьгүй	m ɔ rʲ k u i̯
морьгүйгээ	m ɔ rʲ k u i̯ ɣ eː
морьтой	m ɔ rʲ tʰ ɔ i̯
морьтойгоо	m ɔ rʲ tʰ ɔ i̯ ɣ oː
морьхон	m œ r χ ʊ ŋ̠
мотор	m ɔ tʰ ɔ r̥
мотоцикл	m ɔ tʰ ɔ t͡sʰ i kʰ ɮ
мохоо	m ɔ x ɔ
мохох	m ɔ x ə x
муж	m ʊ t͡ɕ
музей	m ʊ t͜s eː
мусульман	m ʊ s ʊ ɮʲ m a ŋ
мушгирах	m ʊ ʃ ɡʲ ə r ə x
мэдэрхэх	m i t ə r x ə x
мэдэх	m i t ə x
мэдээ	m e t eː
мэдээлэл	m i t e ɮ ə ɮ
мэлхий	m i ɮ x i
мэнгэ	m e ŋ k
мэндлэх	m e n t ɮ e x
мэндчилгээ	m i n t t͡ʃʰ i ɮ ɡ eː
мэргэжил	m i r ə ɡ t͡ɕ ə ɮ
мэргэжилтэн	m i r ə ɡ t͡ɕ ə ɮ tʰ ə ŋ
мэргэн	m e r ɡ e ŋ
мэс	m i s
мэсэс	m e s e s
мэт	m i tʰ
мэхээр	m i x e r
мээм	m eː m
мягмар	m i ɡ m ə̠ r
мянга	mʲ ä ɴ q
мөгөөрс	m ɵ ɣ ɵː r s
мөн	m o ŋ
мөнгө	m o ŋ ɡ
мөндөрлөх	m ɵ n t ɵ r ɮ ə x
мөнх	m o ŋ x
мөр	m o r
мөрдөгч	m ɵ r t ɵ ɡ t͡ʃʰ
мөрдөх	m ɵ r t ɵ x
мөрөвч	m o r ə w t͡ɕʰ
мөрөөдөл	m o r o t ə ɮ
мөс	m o s
мөс	m ɘ s
мөсөн	m ɵ s ɵ ŋ
мөчир	m o t͡ɕʰ ə r
н	n
н	ŋ
наалдах	n aː ɮ t a x
навч	n a w̜ t͡ɕʰ
навчин	n a w̜ t͡ɕʰ i ŋ
надад	n a t ə t
най	n ɛː
найдах	n æː t ə̠ χ
найз	n a i t͡s
наймалж	n ɛː m a ɮ t͡ɕ
наймдугаар	n ɛː m t ʊ ɣ aː r̥
найрамдахчуудын	n ɛː r a m t a x t͡ɕʰ ʊː t i ŋ
найрах	n ɛː r a x
найтаах	n a i tʰ a x
нам	n a m
намар	n a m a r̥
намтар	n a m tʰ ə r
нар	n ɐ ɾ
нарды	n a r t i
нарийн	n a rʲ i ŋ
начин	n ɑ t͡ɕ i n
ная	n ä j ä
наяд	n a j a t
нийгэм	n iː k e m
нийтгэх	n iː tʰ ɡ e x
нийх	n iː x
нил	n i ɮ
нирунчууд	n i r ʊ n t͡ɕʰ ʊː t
нисгэгч	n i s ɡ e ɡ t͡ʃʰ
нисгэх	n i s ɡ e x
нислэг	n i s ɮ e k
новш	n ɔ w̜ ɕ
ногоон	n ɔ ɢ ɔː ŋ
ном	n ɔ m
номгүй	n ɔ m k u i̯
номд	n ɔ m t
номны	n ɔ m n i
номоор	n ɔ m oː r̥
номоос	n ɔ m oː s
номтой	n ɔ m tʰ ɔ i̯
номууд	n ɔ m ʊː t
номуудаар	n ɔ m ʊː t aː r̥
номуудаас	n ɔ m ʊː t aː s
номуудад	n ɔ m ʊː t a t
номуудгүй	n ɔ m ʊː t k u i̯
номуудтай	n ɔ m ʊː t tʰ ɛː
номуудыг	n ɔ m ʊː t i k
номуудын	n ɔ m ʊː t i ŋ
номуудынх	n ɔ m ʊː t i ŋ x
номуудынхан	n ɔ m ʊː t i ŋ x a ŋ
номхон	n ɔ m x ɔ ŋ
номыг	n ɔ m i k
номын	n ɔ m i ŋ
номынх	n ɔ m i ŋ x
номынхон	n ɔ m i ŋ x ɔ ŋ
нохой	n ɔ x ɔ i
ноёд	n ɔ j ɔ t
ноёдгүй	n ɔ j ɔ t k u i̯
ноёдод	n ɔ j ɔ t ɔ t
ноёдоор	n ɔ j ɔ t oː r̥
ноёдоос	n ɔ j ɔ t oː s
ноёдтой	n ɔ j ɔ t tʰ ɔ i̯
ноёдыг	n ɔ j ɔ t i k
ноёдын	n ɔ j ɔ t i ŋ
ноёдынд	n ɔ j ɔ t i n t
ноёдынх	n ɔ j ɔ t i ŋ x
ноёдынхон	n ɔ j ɔ t i ŋ x ɔ ŋ
ноён	n ɔ j ɔ ŋ
ноёнгүй	n ɔ j ɔ ŋ k u i̯
ноёнд	n ɔ j ɔ n t
ноёноор	n ɔ j ɔ n oː r̥
ноёноос	n ɔ j ɔ n oː s
ноёнтой	n ɔ j ɔ n tʰ ɔ i̯
ноёны	n ɔ j ɔ n i
ноёныг	n ɔ j ɔ n i k
ноёныд	n ɔ j ɔ n i t
ноёных	n ɔ j ɔ n i x
ноёныхон	n ɔ j ɔ n i x ɔ ŋ
нугалам	n ʊ ɢ ɮ ə m
нурам	n ʊ r ə m
нус	n ʊ s
нутаг	n ʊ tʰ ä ɢ
нууц	n ʊː t͡s
нь	n
нь	ə n
нэг	n e ɡ
нэгдсэн	n e ɡ t s e n
нэгдүгээр	n e k t u ɣ eː r̥
нэмэр	n i m ə r
нэмэх	n i m ə x
нэр	n e r̥
нэргүй	n e r k u i̯
нэргүйгээ	n e r k u i̯ ɣ eː
нэрд	n e r t
нэрдээ	n e r t eː
нэрийг	n e r iː k
нэрийгээ	n e r iː k eː
нэрийн	n e r iː ŋ
нэрийнх	n e r iː ŋ x
нэрийнхэн	n e r iː ŋ x e ŋ
нэрийнхээ	n e r iː ŋ x eː
нэрлэх	n e r ɮ e x
нэрс	n e r s
нэрсгүй	n e r s k u i̯
нэрсгүйгээ	n e r s k u i̯ ɣ eː
нэрсдээ	n e r s t eː
нэрсийг	n e r s iː k
нэрсийгээ	n e r s iː k eː
нэрсийн	n e r s iː ŋ
нэрсийнх	n e r s iː ŋ x
нэрсийнхэн	n e r s iː ŋ x e ŋ
нэрсийнхээ	n e r s iː ŋ x eː
нэрсний	n e r s n iː
нэрснийх	n e r s n iː x
нэрснийхэн	n e r s n iː x e ŋ
нэрснийхээ	n e r s n iː x eː
нэрснээс	n e r s n eː s
нэрснээсээ	n e r s n eː s eː
нэрснүүд	n e r s n uː t
нэрснүүдгүй	n e r s n uː t k u i̯
нэрснүүдгүйгээ	n e r s n uː t k u i̯ ɣ eː
нэрснүүддээ	n e r s n uː t͉ t eː
нэрснүүдийг	n e r s n uː t iː k
нэрснүүдийгээ	n e r s n uː t iː k eː
нэрснүүдийн	n e r s n uː t iː ŋ
нэрснүүдийнх	n e r s n uː t iː ŋ x
нэрснүүдийнхэн	n e r s n uː t iː ŋ x e ŋ
нэрснүүдийнхээ	n e r s n uː t iː ŋ x eː
нэрснүүдтэй	n e r s n uː t tʰ e i̯
нэрснүүдтэйгээ	n e r s n uː t tʰ e i̯ ɣ eː
нэрснүүдэд	n e r s n uː t e t
нэрснүүдээ	n e r s n uː t eː
нэрснүүдээр	n e r s n uː t eː r̥
нэрснүүдээрээ	n e r s n uː t eː r eː
нэрснүүдээс	n e r s n uː t eː s
нэрснүүдээсээ	n e r s n uː t eː s eː
нэрстэй	n e r s tʰ e i̯
нэрстэйгээ	n e r s tʰ e i̯ ɣ eː
нэрсэд	n e r s e t
нэрсэн	n e r s e ŋ
нэрсэнд	n e r s e n t
нэрсэндээ	n e r s e n t eː
нэрсээ	n e r s eː
нэрсээр	n e r s eː r̥
нэрсээрээ	n e r s eː r eː
нэрсээс	n e r s eː s
нэрсээсээ	n e r s eː s eː
нэртэй	n e r̥ tʰ e i̯
нэртэйгээ	n e r̥ tʰ e i̯ ɣ eː
нэрээ	n e r eː
нэрээр	n e r eː r̥
нэрээрээ	n e r eː r eː
нэрээс	n e r eː s
нэрээсээ	n e r eː s eː
нэхмэл	n i x m ə ɮ
нээлттэй	n eː ɮ tʰ tʰ e
нээх	n eː x
нялх	nʲ a ɮ x
ням	nʲ a m
нүдүүр	n u t u r
нүүдэлчин	n uː t e ɮ t͡ɕʰ i ŋ
нөгөө	n ɵ ɡ oː
нөлөө	n o ɮ o
нөхцөл	n o x t͡sʰ ə ɮ
нөхөр	n ɵ x u r
нөхөөс	n ɵ x ɵː s
нөөц	n oː t͡sʰ
нөөцлөх	n oː t͡sʰ ɮ ə x
о	ɔ
объект	ɔ p j ɵ kʰ tʰ
обьект	ɔ p j ɵ kʰ tʰ
овог	ɔ w ʊ k̠
овоо	ɔ w̜ oː
овъёос	ɔ w̜ j ɔː s
овъёосгүй	ɔ w̜ j ɔː s k u i̯
овъёосноос	ɔ w̜ j ɔː s n oː s
овъёоснууд	ɔ w̜ j ɔː s n ʊː t
овъёоснуудаар	ɔ w̜ j ɔː s n ʊː t aː r̥
овъёоснуудаас	ɔ w̜ j ɔː s n ʊː t aː s
овъёоснуудад	ɔ w̜ j ɔː s n ʊː t a t
овъёоснуудгүй	ɔ w̜ j ɔː s n ʊː t k u i̯
овъёоснуудтай	ɔ w̜ j ɔː s n ʊː t tʰ ɛː
овъёоснуудыг	ɔ w̜ j ɔː s n ʊː t i k
овъёоснуудын	ɔ w̜ j ɔː s n ʊː t i ŋ
овъёосны	ɔ w̜ j ɔː s n i
овъёосон	ɔ w̜ j ɔː s ɔ ŋ
овъёосонд	ɔ w̜ j ɔː s ɔ n t
овъёосоор	ɔ w̜ j ɔː s oː r̥
овъёостой	ɔ w̜ j ɔː s tʰ ɔ i̯
овъёосыг	ɔ w̜ j ɔː s i k
овьёос	ɔ w̜ j ɔː s
огих	ɔ ɡʲ ə x
оготор	ɔ ɢ tʰ ə r
огурцы	o ɡ ə r t͡sʰ i
од	ɔ t
одоо	ɔ t ɔ
озох	ɔ t͡s ɔ x
ой	ɔ͜i
ойлголт	ɔ i̯ ɮ k ɔ ɮ tʰ
ойлгох	ɔ i ɮ ɢ ə x
оймс	o i m s
ойрад	œː r t
олох	ɔ ɮ ɔ x
омог	ɔ m ə ɡ
он	ɔ ŋ
онгоц	ɔ ŋ k ɔ t͡sʰ
онигоо	ɔ n i ɣ oː
оноо	ɔ n ɔ
онь	ɔ nʲ
оньс	ɔ nʲ s
оо	oː
оочир	ɔː t͡ɕʰ ə r
ор	ɔ r
орвон	ɔ r w̜ ɔ ŋ
ордон	ɔ r t ɔ ŋ
орлого	ɔ r ɮ ɔ ɣ
орлогожих	ɔ r ɮ ɔ ɣ ɔ d͡ʑ i x
орой	ɔ r ɔ i
оройвч	ɔ r ɔ i w t͡ɕʰ
ором	ɔ r ə m
орон	ɔ r ə ŋ
орос	ɔ r ʊ s
орхоодой	ɔ r x ɔː t ɔ i
орчим	ɔ r t͡ɕʰ ə m
орчлон	ɔ r̥ t͡ɕʰ ɮ ɔ ŋ
орчон	ɔ r̥ t͡ɕʰ ɔ ŋ
орчуулагч	ɔ r̥ t͡ɕʰ ʊː ɮ a k t͡ɕʰ
орчуулах	ɔ r̥ t͡ɕʰ ʊː ɮ a x
орчуулга	ɔ r̥ t͡ɕʰ ʊː ɮ k
орших	ɔ r ɕ i x
оточ	ɔ tʰ ɔ t͡ɕʰ
оффис	ɔ f i s
охин	œ χ ə ŋ
очих	ɔ t͡ɕʰ ə x
оюутан	ɔ j ʊ tʰ ə ŋ
оёдол	ɔ j t ə ɮ
оёх	ɔ j ʊ χ
п	pʰ
паб	pʰ a p
пальтог	pʰ a ɮʲ tʰ ɔ k
пальтогоор	pʰ a ɮʲ tʰ ɔ ɣ oː r̥
пальтогүй	pʰ a ɮʲ tʰ ɔ ɣ u i̯
пальтон	pʰ a ɮʲ tʰ ɔ ŋ
пальтонд	pʰ a ɮʲ tʰ ɔ n t
пальтоноос	pʰ a ɮʲ tʰ ɔ n oː s
пальтонууд	pʰ a ɮʲ tʰ ɔ n ʊː t
пальтонуудаар	pʰ a ɮʲ tʰ ɔ n ʊː t aː r̥
пальтонуудаас	pʰ a ɮʲ tʰ ɔ n ʊː t aː s
пальтонуудад	pʰ a ɮʲ tʰ ɔ n ʊː t a t
пальтонуудгүй	pʰ a ɮʲ tʰ ɔ n ʊː t k u i̯
пальтонуудтай	pʰ a ɮʲ tʰ ɔ n ʊː t tʰ ɛː
пальтонуудыг	pʰ a ɮʲ tʰ ɔ n ʊː t i k
пальтонуудын	pʰ a ɮʲ tʰ ɔ n ʊː t i ŋ
пальтонуудынх	pʰ a ɮʲ tʰ ɔ n ʊː t i ŋ x
пальтонуудынхан	pʰ a ɮʲ tʰ ɔ n ʊː t i ŋ x a ŋ
пальтоны	pʰ a ɮʲ tʰ ɔ n i
пальтоных	pʰ a ɮʲ tʰ ɔ n i x
пальтоныхон	pʰ a ɮʲ tʰ ɔ n i x ɔ ŋ
пальтотой	pʰ a ɮʲ tʰ ɔ tʰ ɔ i̯
парламент	pʰ a r ɮ a mʲ ɵ n tʰ
паспорт	pʰ a s pʰ ə r tʰ
пигүүж	pʰ i ɡ u t͡ɕ
пид	pʰ i t
пиджак	pʰ i t t͡ɕ a kʰ
пиджакаар	pʰ i t t͡ɕ a kʰ aː r̥
пиджакаас	pʰ i t t͡ɕ a kʰ aː s
пиджакгүй	pʰ i t t͡ɕ a kʰ k u i̯
пиджакийг	pʰ i t t͡ɕ a kʰ iː k
пиджакийн	pʰ i t t͡ɕ a kʰ iː ŋ
пиджакийнх	pʰ i t t͡ɕ a kʰ iː ŋ x
пиджакийнхан	pʰ i t t͡ɕ a kʰ iː ŋ x a ŋ
пиджакт	pʰ i t t͡ɕ a kʰ tʰ
пиджактай	pʰ i t t͡ɕ a kʰ tʰ ɛː
пиджакууд	pʰ i t t͡ɕ a kʰ ʊː t
пиджакуудаар	pʰ i t t͡ɕ a kʰ ʊː t aː r̥
пиджакуудаас	pʰ i t t͡ɕ a kʰ ʊː t aː s
пиджакуудад	pʰ i t t͡ɕ a kʰ ʊː t a t
пиджакуудгүй	pʰ i t t͡ɕ a kʰ ʊː t k u i̯
пиджакуудтай	pʰ i t t͡ɕ a kʰ ʊː t tʰ ɛː
пиджакуудыг	pʰ i t t͡ɕ a kʰ ʊː t i k
пиджакуудын	pʰ i t t͡ɕ a kʰ ʊː t i ŋ
пиджакуудынх	pʰ i t t͡ɕ a kʰ ʊː t i ŋ x
пиджакуудынхан	pʰ i t t͡ɕ a kʰ ʊː t i ŋ x a ŋ
пийшин	pʰ iː ʃ ə ŋ
пиццаг	pʰ i t͡sʰ a k
пиццагаар	pʰ i t͡sʰ a ɣ aː r̥
пиццагүй	pʰ i t͡sʰ a ɣ u i̯
пиццан	pʰ i t͡sʰ a ŋ
пиццанаас	pʰ i t͡sʰ a n aː s
пиццанд	pʰ i t͡sʰ a n t
пиццанууд	pʰ i t͡sʰ a n ʊː t
пиццануудаар	pʰ i t͡sʰ a n ʊː t aː r̥
пиццануудаас	pʰ i t͡sʰ a n ʊː t aː s
пиццануудад	pʰ i t͡sʰ a n ʊː t a t
пиццануудгүй	pʰ i t͡sʰ a n ʊː t k u i̯
пиццануудтай	pʰ i t͡sʰ a n ʊː t tʰ ɛː
пиццануудыг	pʰ i t͡sʰ a n ʊː t i k
пиццануудын	pʰ i t͡sʰ a n ʊː t i ŋ
пиццануудынх	pʰ i t͡sʰ a n ʊː t i ŋ x
пиццануудынхан	pʰ i t͡sʰ a n ʊː t i ŋ x a ŋ
пиццаны	pʰ i t͡sʰ a n i
пиццаных	pʰ i t͡sʰ a n i x
пиццаныхан	pʰ i t͡sʰ a n i x a ŋ
пиццатай	pʰ i t͡sʰ a tʰ ɛː
плазм	pʰ ɮ a t͡s m
подвоолк	pʰ ɔ t w̜ oː ɮ kʰ
помещик	pʰ ɔ mʲ ɵ ɕ i kʰ
програм	pʰ r ɔ k r a m
пулемёт	pʰ u ɮ mʲ ɔˑ tʰ
пуужин	pʰ ʊː t͡ɕ ə ŋ
пэ	pʰ e
р	r
р	r̥
радий	r a t iː
радиус	r a t i̯ ʊː s
размер	r a t͡s mʲ ɵ r̥
реактор	rʲ ɵ a kʰ tʰ ɔ r̥
резин	e r t͡s eː ŋ
резин	rʲ ɵ t͡s i ŋ
ресторанаар	rʲ ɵ s tʰ ɔ r a n aː r̥
ресторанаас	rʲ ɵ s tʰ ɔ r a n aː s
ресторангүй	rʲ ɵ s tʰ ɔ r a ŋ k u i̯
ресторанд	rʲ ɵ s tʰ ɔ r a n t
ресторантай	rʲ ɵ s tʰ ɔ r a n tʰ ɛː
ресторанууд	rʲ ɵ s tʰ ɔ r a n ʊː t
ресторануудаар	rʲ ɵ s tʰ ɔ r a n ʊː t aː r̥
ресторануудаас	rʲ ɵ s tʰ ɔ r a n ʊː t aː s
ресторануудад	rʲ ɵ s tʰ ɔ r a n ʊː t a t
ресторануудгүй	rʲ ɵ s tʰ ɔ r a n ʊː t k u i̯
ресторануудтай	rʲ ɵ s tʰ ɔ r a n ʊː t tʰ ɛː
ресторануудыг	rʲ ɵ s tʰ ɔ r a n ʊː t i k
ресторануудын	rʲ ɵ s tʰ ɔ r a n ʊː t i ŋ
ресторануудынх	rʲ ɵ s tʰ ɔ r a n ʊː t i ŋ x
ресторануудынхан	rʲ ɵ s tʰ ɔ r a n ʊː t i ŋ x a ŋ
рестораны	rʲ ɵ s tʰ ɔ r a n i
рестораныг	rʲ ɵ s tʰ ɔ r a n i k
рестораных	rʲ ɵ s tʰ ɔ r a n i x
рестораныхан	rʲ ɵ s tʰ ɔ r a n i x a ŋ
ромчууд	r ɔ m t͡ɕʰ ʊː t
рубль	r ʊ p ɮʲ
руу	r ʊː
рүү	r uː
с	s
саатал	s aː tʰ ə ɮ
саваа	s a w a
саван	s a w̜ a ŋ
савар	s a w ə r
савхаар	s a w̜ x aː r̥
савхыг	s a w̜ x i k
сайн	s æː ɴ̟
сайхан	s ɛː x a ŋ
сал	s a ɮ
салса	s a ɮ s
салфетка	s a ɮ fʲ ɵ tʰ kʰ
сам	s a m
самбар	s a m p ə r
сампин	s a m pʰ i ŋ
сан	s a ŋ
санах	s a n ə x
сансар	s a n s ə r
сар	s ɐ ɾ
сарлаг	s a r ɮ ə ɡ
сармис	s a r mʲ ə s
сартуул	s a r tʰ ʊː ɮ
сая	s ä j ä
секс	s j ɵ kʰ s
сексгүй	s j ɵ kʰ s k u i̯
секси	s j ɵ kʰ s
сексийг	s j ɵ kʰ s iː k
сексийн	s j ɵ kʰ s iː ŋ
сексийнх	s j ɵ kʰ s iː ŋ x
сексийнхэн	s j ɵ kʰ s iː ŋ x e ŋ
секст	s j ɵ kʰ s tʰ
секстэй	s j ɵ kʰ s tʰ e i̯
сексээр	s j ɵ kʰ s eː r̥
сексээс	s j ɵ kʰ s eː s
сексүүд	s j ɵ kʰ s uː t
сексүүдгүй	s j ɵ kʰ s uː t k u i̯
сексүүдийг	s j ɵ kʰ s uː t iː k
сексүүдийн	s j ɵ kʰ s uː t iː ŋ
сексүүдтэй	s j ɵ kʰ s uː t tʰ e i̯
сексүүдэд	s j ɵ kʰ s uː t e t
сексүүдээр	s j ɵ kʰ s uː t eː r̥
сексүүдээс	s j ɵ kʰ s uː t eː s
симфони	s i m f ɔˑ n
сойз	s ɔ i t͡s
солгой	s ɔ ɮ ɢ ɔ i
солих	s ɔ ɮʲ ə x
солонго	s ɔ ɮ ʊ ɴ ɢ
солонго	s ʊ l ɘ ŋ
сом	s ɔ m
сонгох	s ɔ ŋ ɢ ə x
сонгууль	s ɔ ŋ ɢ ʊ ɮʲ
сонин	s œ n ə ŋ
сонирхол	s ɔ nʲ ə r x ə ɮ
сонсох	s ɔ n s ə x
сорих	s ɔ rʲ ə x
сормуус	s ɔ r m ʊː s
соруул	s ɔ r ʊ ɮ
соруулах	s ɔ r ʊ ɮ ə x
социализм	s ɔ t͡sʰ i̯ aː ɮ i t͡s m
соёл	s ɔ j ʊ ɮ
соёо	s ɔ j ɔː
соёолон	s ɔ j ɔː ɮ ɔ ŋ
спорт	s pʰ ɔ r̥ tʰ
сувдын	s ʊ w̜ t i ŋ
судар	s ʊ t ə r
сул	s o ɬ
сум	s ʊ m
сумо	s ʊ m ɔ
сур	s ʊ r̥
сурагч	s ʊ r a ɡ t͡ʃʰ
суралцах	s ʊ r a ɮ t͡sʰ a x
сурах	s ʊ r ə x
сурвалж	s ʊ r w ə ɮ t͡ɕ
сургах	s ʊ r k a x
суулгах	s ʊː ɮ ɢ a x
суурь	s ʊː rʲ
суух	s ʊː x
сэжиг	s i t͡ɕ ə ɡ
сэлэх	s e ɮ ə x
сэндвич	s e n t w̜ i t͡ɕʰ
сэрэх	s e r ə x
сэрээх	s e r eː x
сэтгүүл	s e tʰ ɡ u ɮ
сээр	s eː r̥
сүмо	s u m ɔ
сүмс	s u m s
сүнс	s u n s
сүрчиг	s u r t͡ʃʰ i k
сүрэг	s u r ə ɡ
сүх	s u x
сүү	s uː
сүүдэр	s uː t ə r
сүүмэг	s uː m e k
т	tʰ
та	tʰ a
таах	tʰ aː x
тав	tʰ a w̜
тавдугаар	tʰ a w̜ t ʊ ɣ aː r̥
тавигдаагүй	tʰ a w̜ i k t aː k u i̯
тавин	tʰ ɛ w̜ ə ŋ
тавих	tʰ a wʲ ə x
тавхай	tʰ a w x a i
тавь	tʰ a w̜ʲ
тагнуулч	tʰ a k n ʊː ɮ t͡ɕʰ
тайван	tʰ æː w ə̠ ŋ̠
тайга	tʰ ɛː k
тайлбар	tʰ ɛː ɮ p a r̥
такси	tʰ a kʰ s i
талбай	tʰ a ɮ p ɛː
талх	tʰ a ɮ x
тамах	tʰ a m ə x
тамга	tʰ a m ə ɢ
танц	tʰ a n t͡sʰ
тараг	tʰ a r a k
тарвага	tʰ a r w ə ɢ
тархах	tʰ a r x ə x
тархи	tʰ a rʲ xʲ
тас	tʰ a s
таслал	tʰ a s ɮ a ɮ
татаар	tʰ ä tʰ äː r
тахиа	tʰ a x i̯ aː
тахиаг	tʰ a x i̯ aː k
тахиагаар	tʰ a x i̯ aː k aː r̥
тахиагүй	tʰ a x i̯ aː k u i̯
тахиан	tʰ a x i̯ aː ŋ
тахианаас	tʰ a x i̯ aː n aː s
тахианд	tʰ a x i̯ aː n t
тахианууд	tʰ a x i̯ aː n ʊː t
тахиануудаар	tʰ a x i̯ aː n ʊː t aː r̥
тахиануудаас	tʰ a x i̯ aː n ʊː t aː s
тахиануудад	tʰ a x i̯ aː n ʊː t a t
тахиануудгүй	tʰ a x i̯ aː n ʊː t k u i̯
тахиануудтай	tʰ a x i̯ aː n ʊː t tʰ ɛː
тахиануудыг	tʰ a x i̯ aː n ʊː t i k
тахиануудын	tʰ a x i̯ aː n ʊː t i ŋ
тахиануудынх	tʰ a x i̯ aː n ʊː t i ŋ x
тахиануудынхан	tʰ a x i̯ aː n ʊː t i ŋ x a ŋ
тахианы	tʰ a x i̯ aː n i
тахианых	tʰ a x i̯ aː n i x
тахианыхан	tʰ a x i̯ aː n i x a ŋ
тахиар	tʰ a x i̯ aː r̥
тахиараа	tʰ a x i̯ aː r aː
тахиас	tʰ a x i̯ aː s
тахиасаа	tʰ a x i̯ aː s aː
тахиатай	tʰ a x i̯ aː tʰ ɛː
тахид	tʰ a x i t
тахидаа	tʰ a x i t aː
тахийг	tʰ a x iː k
тахийгаа	tʰ a x iː k aː
тахийн	tʰ a x iː ŋ
тахийнх	tʰ a x iː ŋ x
тахийнхаа	tʰ a x iː ŋ x aː
тахийнхан	tʰ a x iː ŋ x a ŋ
тахитай	tʰ a x i tʰ ɛː
тахитайгаа	tʰ a x i tʰ ɛː k aː
тахиуд	tʰ a x i̯ ʊː t
тахиудаа	tʰ a x i̯ ʊː t aː
тахиудаар	tʰ a x i̯ ʊː t aː r̥
тахиудаараа	tʰ a x i̯ ʊː t aː r aː
тахиудаас	tʰ a x i̯ ʊː t aː s
тахиудаасаа	tʰ a x i̯ ʊː t aː s aː
тахиудад	tʰ a x i̯ ʊː t a t
тахиудгүй	tʰ a x i̯ ʊː t k u i̯
тахиудгүйгээ	tʰ a x i̯ ʊː t k u i̯ ɣ eː
тахиуддаа	tʰ a x i̯ ʊː t͉ t aː
тахиудтай	tʰ a x i̯ ʊː t tʰ ɛː
тахиудтайгаа	tʰ a x i̯ ʊː t tʰ ɛː k aː
тахиудыг	tʰ a x i̯ ʊː t i k
тахиудыгаа	tʰ a x i̯ ʊː t i ɣ aː
тахиудын	tʰ a x i̯ ʊː t i ŋ
тахиудынх	tʰ a x i̯ ʊː t i ŋ x
тахиудынхаа	tʰ a x i̯ ʊː t i ŋ x aː
тахиудынхан	tʰ a x i̯ ʊː t i ŋ x a ŋ
тахь	tʰ a xʲ
тахьгүй	tʰ a xʲ k u i̯
тахьгүйгээ	tʰ a xʲ k u i̯ ɣ eː
таяг	tʰ a j ə ɡ
тб	tʰ e r p ʊ m
текст	tʰʲ ɵ kʰ s tʰ
телевиз	tʰʲ ɵ ɮʲ ɵ w̜ i t͡s
телефон	tʰʲ ɵ ɮʲ ɵ f ɔ ŋ
тив	tʰ i w̜
товч	tʰ ɔ w t͡ɕʰ
тоглоом	tʰ ɔ k ɮ oː m
тогооч	tʰ ɔ ɢ ɔː t͡ʃʰ
тогос	tʰ ɔ ɢ ə s
тогтвор	tʰ ɔ k tʰ w̜ ɔ r̥
тогтоол	tʰ ɔ ɡ tʰ ɔ ɮ
тогтоомж	tʰ ɔ ɡ tʰ ɔ m t͡ɕ
тогтоох	tʰ ɔ ɡ tʰ ɔ x
тойруу	tʰ ɔ i r ʊ
толгой	tʰ ɔ ɮ ɢ ɔ i
толь	tʰ ɔ l i
том	tʰ ɔ m
томох	tʰ ɔ m ə x
томсох	tʰ ɔ m s ə x
томьёо	tʰ ɔ m j ɔː
тонн	tʰ ɔ nː
тоншуул	tʰ ɔ ŋ ʃ ʊ ɮ
тоор	tʰ ɔː r
тоормос	tʰ oː r m ɔ s
тоосго	tʰ oː s k
тоосгон	tʰ oː s k ɔ ŋ
тор	tʰ ɔ r̥
торго	tʰ ɔ r ə ɢ
тос	tʰ ɔ s
тосгон	tʰ ɔ s k ɔ ŋ
тоть	tʰ œ tʰ
трактор	tʰ r a kʰ tʰ ə r̥
трамвай	tʰ r a m w̜ ɛː
трансформатор	tʰ r a n s f ɔ r m a tʰ ɔ r̥
троллейбус	tʰ r ɔ ɮːʲ ɵ i̯ β ʊ s
тува	tʰ ʊ w̜ äˑ
туг	tʰ ʊ k
тунадас	tʰ ʊ n t ə s
тунамал	tʰ ʊ n a m a ɮ
туршлага	tʰ ʊ r ʃ ɮ ə ɢ
тусгаарлагч	tʰ ʊ s k aː r ɮ a k t͡ɕʰ
тусламж	tʰ ʊ s ɮ ə m t͡ɕ
туулай	tʰ ʊː ɮ a i
тухай	tʰ ʊ x a i
тухайд	tʰ ʊ x a i t
тухайн	tʰ ʊ χ æː ɴ̟
тэ	tʰ e
тэвнэ	tʰ i w ə n
тэвчих	tʰ e w̜ t͡ɕʰ i x
тэвчээр	tʰ e w̜ t͡ɕʰ eː r̥
тэвэр	tʰ i w ə r
тэд	tʰ e tʰ
тэмдэг	tʰ e m t e k
тэмцэгч	tʰ e m t͡sʰ e ɡ t͡ʃʰ
тэмцэх	tʰ e m t͡sʰ e x
тэмцээн	tʰ e m t͡sʰ eː ŋ
тэмээ	tʰ e m eː
тэмээг	tʰ e m eː k
тэмээгээр	tʰ e m eː k eː r̥
тэмээгүй	tʰ e m eː k u i̯
тэмээн	tʰ e m eː ŋ
тэмээнд	tʰ e m eː n t
тэмээний	tʰ e m eː n iː
тэмээнийх	tʰ e m eː n iː x
тэмээнийхэн	tʰ e m eː n iː x e ŋ
тэмээнээс	tʰ e m eː n eː s
тэмээнүүд	tʰ e m eː n uː t
тэмээнүүдгүй	tʰ e m eː n uː t k u i̯
тэмээнүүдийг	tʰ e m eː n uː t iː k
тэмээнүүдийн	tʰ e m eː n uː t iː ŋ
тэмээнүүдийнх	tʰ e m eː n uː t iː ŋ x
тэмээнүүдийнхэн	tʰ e m eː n uː t iː ŋ x e ŋ
тэмээнүүдтэй	tʰ e m eː n uː t tʰ e i̯
тэмээнүүдэд	tʰ e m eː n uː t e t
тэмээнүүдээр	tʰ e m eː n uː t eː r̥
тэмээнүүдээс	tʰ e m eː n uː t eː s
тэмээтэй	tʰ e m eː tʰ e i̯
тэнгисгүй	tʰ e ŋ k i s k u i̯
тэнгисийг	tʰ e ŋ k i s iː k
тэнгисийн	tʰ e ŋ k i s iː ŋ
тэнгисийнх	tʰ e ŋ k i s iː ŋ x
тэнгисийнхэн	tʰ e ŋ k i s iː ŋ x e ŋ
тэнгист	tʰ e ŋ k i s tʰ
тэнгистэй	tʰ e ŋ k i s tʰ e i̯
тэнгисээр	tʰ e ŋ k i s eː r̥
тэнгисээс	tʰ e ŋ k i s eː s
тэнгисүүд	tʰ e ŋ k i s uː t
тэнгисүүдгүй	tʰ e ŋ k i s uː t k u i̯
тэнгисүүдийг	tʰ e ŋ k i s uː t iː k
тэнгисүүдийн	tʰ e ŋ k i s uː t iː ŋ
тэнгисүүдийнх	tʰ e ŋ k i s uː t iː ŋ x
тэнгисүүдийнхэн	tʰ e ŋ k i s uː t iː ŋ x e ŋ
тэнгисүүдтэй	tʰ e ŋ k i s uː t tʰ e i̯
тэнгисүүдэд	tʰ e ŋ k i s uː t e t
тэнгисүүдээр	tʰ e ŋ k i s uː t eː r̥
тэнгисүүдээс	tʰ e ŋ k i s uː t eː s
тэнгэр	tʰ e ŋ ɡ e r
тэнгэр	tʰ ɘ ŋ ɘ ɾ
тэнгэс	tʰ i ŋ ɡ ə s
тэр	tʰ e r
тэрбум	tʰ e r p ʊ m
тэргийг	tʰ e r k iː k
тэргэн	tʰ e r k e ŋ
тэргэнд	tʰ e r k e n t
тэргээр	tʰ e r k eː r̥
тэрс	tʰ i r s
тэрэг	tʰ e r e k
тэрэггүй	tʰ e r e ɣ u i̯
тэрэгний	tʰ e r e k n iː
тэрэгнийх	tʰ e r e k n iː x
тэрэгнийхэн	tʰ e r e k n iː x e ŋ
тэрэгнээс	tʰ e r e k n eː s
тэрэгнүүд	tʰ e r e k n uː t
тэрэгнүүдгүй	tʰ e r e k n uː t k u i̯
тэрэгнүүдийг	tʰ e r e k n uː t iː k
тэрэгнүүдийн	tʰ e r e k n uː t iː ŋ
тэрэгнүүдийнх	tʰ e r e k n uː t iː ŋ x
тэрэгнүүдийнхэн	tʰ e r e k n uː t iː ŋ x e ŋ
тэрэгнүүдтэй	tʰ e r e k n uː t tʰ e i̯
тэрэгнүүдэд	tʰ e r e k n uː t e t
тэрэгнүүдээр	tʰ e r e k n uː t eː r̥
тэрэгнүүдээс	tʰ e r e k n uː t eː s
тэрэгтэй	tʰ e r e k tʰ e i̯
тэс	tʰ i s
тээрэм	tʰ eː r e m
тээрэмчин	tʰ eː r e m t͡ʃʰ i ŋ
түймэр	tʰ u i m ə r
түлхэх	t u ɮ x ə x
түлэгдэлт	tʰ u ɮ ə ɡ t ə ɮ tʰ
түм	tʰ u m
түмэд	tʰ u m e t
түрүүч	tʰ u r uː t͡ɕʰ
түүнийх	tʰ uː n iː x
түүх	tʰ uː x
төгрөг	tʰ ɵ k r ɵ k
төгрөггүй	tʰ ɵ k r ɵ ɣ u i̯
төгрөгийг	tʰ ɵ k r ɵ ɣ iː k
төгрөгийн	tʰ ɵ k r ɵ ɣ iː ŋ
төгрөгт	tʰ ɵ k r ɵ k tʰ
төгрөгтэй	tʰ ɵ k r ɵ k tʰ e i̯
төгрөгүүд	tʰ ɵ k r ɵ ɣ uː t
төгрөгүүдгүй	tʰ ɵ k r ɵ ɣ uː t k u i̯
төгрөгүүдийг	tʰ ɵ k r ɵ ɣ uː t iː k
төгрөгүүдийн	tʰ ɵ k r ɵ ɣ uː t iː ŋ
төгрөгүүдтэй	tʰ ɵ k r ɵ ɣ uː t tʰ e i̯
төгрөгүүдэд	tʰ ɵ k r ɵ ɣ uː t e t
төгрөгүүдээр	tʰ ɵ k r ɵ ɣ uː t eː r̥
төгрөгүүдээс	tʰ ɵ k r ɵ ɣ uː t eː s
төгрөгөөр	tʰ ɵ k r ɵ ɣ ɵː r̥
төгрөгөөс	tʰ ɵ k r ɵ ɣ ɵː s
төлөвлөгөө	tʰ ɵ ɮ ɵ w̜ ɮ ɵ ɡ oː
төмпөн	tʰ ɵ m pʰ ɵ ŋ
төмөрсөг	tʰ ɵ m ɵ r s ɵ k
төр	tʰ ɵ r
төрсөн	tʰ ɵ r s u ŋ
төрөл	tʰ ɵ r ɵ ɮ
төстэй	tʰ o s tʰ e
төсөвлөх	tʰ o s ə w ɮ ə x
у	ʊ
уг	ʊ ɡ
удаа	ʊ t a
удган	ʊ t ɢ ə ŋ
удирдамж	ʊ t i r t a m t͡ɕ
удирдлага	ʊ tʲ ə r t ɮ ə ɢ
улаан	ʊ ɮ aː ŋ
уламжлалт	ʊ ɮ ə m t͡ɕ ɮ ə ɮ tʰ
улиас	ʊ ɮʲ a s
улс	ʊ l ʊ s
улсаар	ʊ ɮ s aː r̥
улсаас	ʊ ɮ s aː s
улсад	ʊ ɮ s a t
улсгүй	ʊ ɮ s k u i̯
улстай	ʊ ɮ s tʰ ɛː
улсууд	ʊ ɮ s ʊː t
улсуудаар	ʊ ɮ s ʊː t aː r̥
улсуудаас	ʊ ɮ s ʊː t aː s
улсуудад	ʊ ɮ s ʊː t a t
улсуудгүй	ʊ ɮ s ʊː t k u i̯
улсуудтай	ʊ ɮ s ʊː t tʰ ɛː
улсуудыг	ʊ ɮ s ʊː t i k
улсуудын	ʊ ɮ s ʊː t i ŋ
улсыг	ʊ ɮ s i k
унах	ʊ n ə x
унгарчууд	ʊ ŋ k a r̥ t͡ɕʰ ʊː t
унгах	ʊ ŋ k a x
унтах	ʊ n tʰ a x
унтраах	ʊ n tʰ r aː x
унтрах	ʊ n tʰ r a x
унших	ʊ n ʃ ə x
урвагч	ʊ r w̜ a ɡ t͡ʃʰ
урвах	ʊ r w ə x
урлаг	ʊ r ɮ a k
уруул	ʊ r ʊ ɮ
урчууд	ʊ r̥ t͡ɕʰ ʊː t
урчуудын	ʊ r̥ t͡ɕʰ ʊː t i ŋ
ус	ʊ s
ус	ʊ s ʊ
усаа	ʊ s aː
усаар	ʊ s aː r̥
усаараа	ʊ s aː r aː
усан	ʊ s a ŋ
усанд	ʊ s a n t
усандаа	ʊ s a n t aː
усандаас	ʊ s a n t aː s
усандаасаа	ʊ s a n t aː s aː
усгүй	ʊ s k u i̯
усгүйгээ	ʊ s k u i̯ ɣ eː
уснаас	ʊ s n aː s
уснаасаа	ʊ s n aː s aː
уснууд	ʊ s n ʊː t
уснуудаа	ʊ s n ʊː t aː
уснуудаар	ʊ s n ʊː t aː r̥
уснуудаас	ʊ s n ʊː t aː s
уснуудад	ʊ s n ʊː t a t
уснуудгүй	ʊ s n ʊː t k u i̯
уснуудтай	ʊ s n ʊː t tʰ ɛː
уснуудыг	ʊ s n ʊː t i k
уснуудын	ʊ s n ʊː t i ŋ
уснуудынх	ʊ s n ʊː t i ŋ x
уснуудынхан	ʊ s n ʊː t i ŋ x a ŋ
усны	ʊ s n i
усных	ʊ s n i x
усныхаа	ʊ s n i x aː
усныхан	ʊ s n i x a ŋ
устай	ʊ s tʰ ɛː
устайгаа	ʊ s tʰ ɛː k aː
устөрөгч	ʊ s tʰ ɵ r ɵ k t͡ɕʰ
усыг	ʊ s i k
усыгаа	ʊ s i ɣ aː
утаа	ʊ tʰ a
утас	ʊ tʰ ə s
утга	ʊ tʰ ə ɢ
уу	ʊː
уул	ʊː l a
уулс	ʊː ɮ s
уур	ʊː r
уурга	ʊː r k
уурхай	ʊː r x a i
уух	ʊː χ
уучлаарай	ʊː t͡ɕʰ ɮ aː r ɛː
уушги	ʊː ʃ ə ɡʲ
учраас	ʊ t͡ɕʰ r aː s
уярах	ʊ j r ə x
ф	f
ф	pʰ
файл	f ɛː ɮ
факс	f a kʰ s
факсдах	f a kʰ s t a x
фашизм	f a ɕ i t͡s m
ферм	fʲ ɵ r m
философи	f i ɮ ɔ s ɔ f
фильм	f i ɮʲ m
фото	f ɔ tʰ
фотог	f ɔ tʰ ɔ k
фотогийн	f ɔ tʰ ɔ ɣ iː ŋ
фотогоор	f ɔ tʰ ɔ ɣ oː r̥
фотогоос	f ɔ tʰ ɔ ɣ oː s
фотогүй	f ɔ tʰ ɔ ɣ u i̯
фотод	f ɔ tʰ ɔ t
фототой	f ɔ tʰ ɔ tʰ ɔ i̯
франц	f r äˑ n t͜sʰ
францчууд	f r a n t͡sʰ t͡ɕʰ ʊː t
фронт	f r ɔˑ n tʰ
фронт	pʰ r ɔˑ n tʰ
функц	f ʊ ŋ kʰ t͡sʰ
футболк	f ʊ tʰ p ɔ ɮ kʰ
х	x
ха	x a
хаад	x aː t
хаадаа	x aː t aː
хаадаар	x aː t aː r̥
хаадаараа	x aː t aː r aː
хаадаас	x aː t aː s
хаадаасаа	x aː t aː s aː
хаадад	x aː t a t
хаадгүй	x aː t k u i̯
хаадгүйгээ	x aː t k u i̯ ɣ eː
хааддаа	x aː t͉ t aː
хаадтай	x aː t tʰ ɛː
хаадтайгаа	x aː t tʰ ɛː k aː
хаадыг	x aː t i k
хаадыгаа	x aː t i ɣ aː
хаадын	x aː t i ŋ
хаадынд	x aː t i n t
хаадындаа	x aː t i n t aː
хаадынх	x aː t i ŋ x
хаадынхаа	x aː t i ŋ x aː
хаадынхан	x aː t i ŋ x a ŋ
хаалга	x aː ɮ ə ɢ
хаалт	x aː ɮ tʰ
хаанаа	x aː n aː
хаанаар	x aː n aː r̥
хаанаараа	x aː n aː r aː
хаанаасаа	x aː n aː s aː
хаангүй	x aː ŋ k u i̯
хаангүйгээ	x aː ŋ k u i̯ ɣ eː
хаанд	x aː n t
хаандаа	x aː n t aː
хаантай	x aː n tʰ ɛː
хаантайгаа	x aː n tʰ ɛː k aː
хааны	x aː n i
хааныг	x aː n i k
хааныгаа	x aː n i ɣ aː
хааныд	x aː n i t
хааныдаа	x aː n i t aː
хааных	x aː n i x
хааныхаа	x aː n i x aː
хааныхан	x aː n i x a ŋ
хаах	x aː x
хавар	x a w̜ ə r̥
хавирга	x a wʲ r ə ɢ
хависгана	x a w̜ i s k a n
хавч	x a w t͡ɕʰ
хавчих	x a w t͡ɕʰ ə x
хаг	x a ɡ
хага	x a ɢ
хагарах	x a ɢ r ə x
хагас	x a ɣ a s
хад	x a t
хадаас	x a t aː s
хадаг	x a t ə ɡ
хадуур	x a t ʊ r
хазаар	x a t͡s a r
хазах	x a t͡s ə x
хайлмаг	x a i ɮ m ə ɡ
хайнаг	x a i n ə ɡ
хайр	χ æː r
хайрлах	x a i r ɮ ə x
хайх	x ɛː x
хайч	χ æː t͡ʃʰ
хайчлах	χ æː t͡ʃʰ ɮ ə χ
халаад	x a ɮ a t
халдах	x a ɮ t a x
халдваргүй	χ a ɮ t w ə̠ r ɡ ʉ͜i
халдваргүйжил	x a ɮ t w̜ a r k u i̯ d͡ʑ i ɮ
халдваргүйжих	x a ɮ t w̜ a r k u i̯ d͡ʑ i x
халдваргүйжүүлэгч	x a ɮ t w̜ a r k u i̯ d͡ʑ uː ɮ e k t͡ɕʰ
халдваргүйжүүлэл	x a ɮ t w̜ a r k u i̯ d͡ʑ uː ɮ e ɮ
халдварт	χ a ɮ t w ə̠ r tʰ
халим	x a ɮ i m
халуун	x a ɮ ʊː ŋ
хамба	x a m p
хамбургер	x a m p ʊ r kʲ ɵ r̥
хамгаалах	x a m k aː ɮ a x
хамт	x a m tʰ
хамтрах	x a m tʰ r a x
хан	χ ä ŋ
хана	χ ä n
ханан	x a n a ŋ
ханз	x a n t͡s
ханзан	x a n t͡s a ŋ
ханхай	x a ŋ x ɛː
ханхайг	x a ŋ x ɛː k
ханхайгаар	x a ŋ x ɛː k aː r̥
ханхайгаас	x a ŋ x ɛː k aː s
ханхайгүй	x a ŋ x ɛː k u i̯
ханхайд	x a ŋ x ɛː t
ханхайн	x a ŋ x ɛː ŋ
ханхайнууд	x a ŋ x ɛː n ʊː t
ханхайнуудаар	x a ŋ x ɛː n ʊː t aː r̥
ханхайнуудаас	x a ŋ x ɛː n ʊː t aː s
ханхайнуудад	x a ŋ x ɛː n ʊː t a t
ханхайнуудгүй	x a ŋ x ɛː n ʊː t k u i̯
ханхайнуудтай	x a ŋ x ɛː n ʊː t tʰ ɛː
ханхайнуудыг	x a ŋ x ɛː n ʊː t i k
ханхайнуудын	x a ŋ x ɛː n ʊː t i ŋ
ханхайнуудынх	x a ŋ x ɛː n ʊː t i ŋ x
ханхайнуудынхан	x a ŋ x ɛː n ʊː t i ŋ x a ŋ
ханхайнх	x a ŋ x ɛː ŋ x
ханхайнхан	x a ŋ x ɛː ŋ x a ŋ
ханхайтай	x a ŋ x ɛː tʰ ɛː
ханш	x a n ɕ
хараацай	x a r aː t͡sʰ a ɪ
харайх	x a r ɛː x
харандаа	x a r ə n t a
харах	x a r a x
харваа	x a r w a
харваач	x a r w a t͡ɕʰ
харгана	x a r ɢ ə n
харин	x a rʲ ə ŋ
хариуцах	x a r i̯ ʊː t͡sʰ a x
хариуцлага	x a r i̯ ʊː t͡sʰ ɮ a ɢ
харьяа	x a rʲ j aː
харьяалах	x a r j aː ɮ a x
хас	χ a s
хасаг	x ɐ s ɐ k
хатмал	x a tʰ m ə ɮ
хахууль	x a x ʊ ɮʲ
хачиртай	x a t͡ɕʰ i r̥ tʰ ɛː
хашилт	χ ä ʃ ĭ ɮ tʰ
хаялах	x a j ɮ ə x
хаях	x a j ə x
хиа	x i̯ aː
хиам	xʲ aː m
хижээл	x i t͡ɕ e ɮ
хий	x iː
хиймэл	x iː m ə ɮ
хил	x i ɮ
хими	x iː m
хирс	x i r s
хог	x ɔ k
хойг	x ɔ i̯ k
хойд	χ œː tʰ
хоймсон	x ɔ i̯ m s ɔ ŋ
хойно	x ɔ i n
хол	χ ɔ ɬ
холбоо	χ ɔ ɮ p ɔː
холтос	x ɔ ɮ tʰ ə s
холтосгүй	x ɔ ɮ tʰ ɔ s k u i̯
холтосгүйгээ	x ɔ ɮ tʰ ɔ s k u i̯ ɣ eː
холтосноос	x ɔ ɮ tʰ ɔ s n oː s
холтосноосоо	x ɔ ɮ tʰ ɔ s n oː s oː
холтоснууд	x ɔ ɮ tʰ ɔ s n ʊː t
холтоснуудаа	x ɔ ɮ tʰ ɔ s n ʊː t aː
холтоснуудаар	x ɔ ɮ tʰ ɔ s n ʊː t aː r̥
холтоснуудаараа	x ɔ ɮ tʰ ɔ s n ʊː t aː r aː
холтоснуудаас	x ɔ ɮ tʰ ɔ s n ʊː t aː s
холтоснуудаасаа	x ɔ ɮ tʰ ɔ s n ʊː t aː s aː
холтоснуудад	x ɔ ɮ tʰ ɔ s n ʊː t a t
холтоснуудгүй	x ɔ ɮ tʰ ɔ s n ʊː t k u i̯
холтоснуудгүйгээ	x ɔ ɮ tʰ ɔ s n ʊː t k u i̯ ɣ eː
холтоснууддаа	x ɔ ɮ tʰ ɔ s n ʊː t͉ t aː
холтоснуудтай	x ɔ ɮ tʰ ɔ s n ʊː t tʰ ɛː
холтоснуудтайгаа	x ɔ ɮ tʰ ɔ s n ʊː t tʰ ɛː k aː
холтоснуудыг	x ɔ ɮ tʰ ɔ s n ʊː t i k
холтоснуудыгаа	x ɔ ɮ tʰ ɔ s n ʊː t i ɣ aː
холтоснуудын	x ɔ ɮ tʰ ɔ s n ʊː t i ŋ
холтоснуудынх	x ɔ ɮ tʰ ɔ s n ʊː t i ŋ x
холтоснуудынхаа	x ɔ ɮ tʰ ɔ s n ʊː t i ŋ x aː
холтоснуудынхан	x ɔ ɮ tʰ ɔ s n ʊː t i ŋ x a ŋ
холтосны	x ɔ ɮ tʰ ɔ s n i
холтосных	x ɔ ɮ tʰ ɔ s n i x
холтосныхон	x ɔ ɮ tʰ ɔ s n i x ɔ ŋ
холтосныхоо	x ɔ ɮ tʰ ɔ s n i x oː
холтостой	x ɔ ɮ tʰ ɔ s tʰ ɔ i̯
холтостойгоо	x ɔ ɮ tʰ ɔ s tʰ ɔ i̯ ɣ oː
холтсон	x ɔ ɮ tʰ s ɔ ŋ
холтсонд	x ɔ ɮ tʰ s ɔ n t
холтсондоо	x ɔ ɮ tʰ s ɔ n t oː
холтсоо	x ɔ ɮ tʰ s oː
холтсоор	x ɔ ɮ tʰ s oː r̥
холтсоороо	x ɔ ɮ tʰ s oː r oː
холтсыг	x ɔ ɮ tʰ s i k
холтсыгоо	x ɔ ɮ tʰ s i ɣ oː
хонох	x ɔ n ɔ x
хонуурь	x ɔ n ʊː rʲ
хонь	x ɔ nʲ
хоньчин	x ɔ nʲ t͡ʃʰ i ŋ
хоо	x oː
хоол	x ɔː ɮ
хорвоо	x ɔ r w ɔ
хордох	x ɔ r t ə x
хорсох	x ɔ r s ə x
хорхой	x ɔ r x ɔ i̯
хос	x ɔ s
хот	x ɔ tʰ
хотон	χ ɔ tʰ o ŋ
хотууд	x ɔ tʰ ʊː t
хотын	x ɔ tʰ i ŋ
хошного	x ɔ ʃ n ə ɢ
хошууч	x ɔ ɕ ʊː t͡ɕʰ
хоёр	χ ɔ j ʊ r
хоёрдогч	x ɔ j ɔ r t ɔ k t͡ɕʰ
хоёрдугаар	x ɔ j ɔ r t ʊ ɣ aː r̥
хуанли	x ʊ a ŋ ɮ i
хуваарь	x ʊ w̜ aː rʲ
хуванцар	x ʊ w̜ ə n t͡s ə r
хувилбар	x ʊ wʲ ə ɮ p ə r
хувсьгал	x ʊ w̜ sʲ k a ɮ
хувцас	x ʊ w t͡sʰ ə s
хувь	x ʊ wʲ
хугацаа	x ʊ ɢ t͡sʰ a
худ	x ʊ t
худал	x ʊ t ə ɮ
худалдах	x ʊ t ə ɮ t ə x
худалч	x ʊ t ə ɮ t͡ɕʰ
хударга	x ʊ t r ə ɢ
хужаа	x ʊ d͡ʑ aː
хуй	x ʊ i
хуйцаа	x ʊ i̯ t͡sʰ aː
хулгайлах	x ʊ ɮ k ɛː ɮ a x
хулгана	x ʊ ɮ ɢ ə n
хулуу	x ʊ ɮ ʊː
хулхи	x ʊ ɮ xʲ
хумс	x ʊ m s
хун	x ʊ n
хураамж	x ʊ r aː m t͡ɕ
хураангуй	x ʊ r aː ŋ k ʊ i̯
хурал	x ʊ r ə ɮ
хурандаа	x ʊ r a n t aː
хурга	x ʊ r ə ɢ
хурган	x ʊ r k a ŋ
хурим	x ʊ rʲ ə m
хурма	x ʊ r m
хуруу	x ʊ r ʊ
хуруувч	x ʊ r ʊ w t͡ɕʰ
хурхирах	x ʊ rʲ xʲ ə r ə x
хусах	x ʊ s ə x
хутга	x ʊ tʰ ə ɢ
хутгалдах	x ʊ t ɢ a ɮ t a x
хуудас	x ʊː t a s
хууль	x ʊː ɮʲ
хуульч	x ʊː ɬʲ t͡ʃʰ
хуульчлах	x ʊː ɬʲ t͡ʃʰ ɬ a x
хуур	x ʊː r̥
хуурах	x ʊː r ə x
хуурга	x ʊː r ə ɢ
хуушуур	x ʊː ʃ ʊ r
хэбид	x e β i t
хэвэл	x e v e ɮ
хэдэрлэх	x e t ə r ɮ ə x
хэзээ	x e t͡s eː
хэл	x e ɮ
хэл	x ə l
хэлэлцэх	x i ɮ ə ɮ t͡sʰ ə x
хэлэх	x i ɮ ə x
хэм	x e m
хэмжээ	x i m t͡ɕ e
хэн	x e ŋ
хэрэг	k e r e ɡ
хэрэг	x i r ə ɡ
хэрэглэгдэх	x i r ə ɡ ɮ ə ɡ t ə
хэрэглэгдэхүүн	x e r e k ɮ e k t e x uː ŋ
хэрэглэл	x i r ə ɡ ɮ ə ɮ
хэрэглэх	k e r e ɡ l e x ʉ
хэрэглэх	x i r ə ɡ ɮ ə x
хэрэглээ	x i r ə ɡ ɮ e
хэрэглүүр	x i r ə ɡ ɮ u r
хэрэгтэй	x i r ə ɡ tʰ e
хэрэлдэх	x e r e ɮ t e x
хэрүүл	x i r u ɮ
хэтэвч	x e tʰ ə w t͡ɕʰ
хэхрэх	x e x r e x
хээр	x eː r
хязаалан	xʲ a t͡s aː ɮ a ŋ
хялгас	xʲ a ɮ ʁ a s
хяргах	xʲ a r ɢ ə x
хярс	xʲ a r s
хяруу	xʲ a r ʊː
хүзүү	x u t͡s u
хүлэх	x u ɮ ə x
хүмүүн	x u m uː ŋ
хүмүүнгүй	x u m uː ŋ k u i̯
хүмүүнгүйгээ	x u m uː ŋ k u i̯ ɣ eː
хүмүүнд	x u m uː n t
хүмүүндээ	x u m uː n t eː
хүмүүний	x u m uː n iː
хүмүүнийг	x u m uː n iː k
хүмүүнийгээ	x u m uː n iː k eː
хүмүүнийх	x u m uː n iː x
хүмүүнийхэн	x u m uː n iː x e ŋ
хүмүүнийхээ	x u m uː n iː x eː
хүмүүнтэй	x u m uː n tʰ e i̯
хүмүүнтэйгээ	x u m uː n tʰ e i̯ ɣ eː
хүмүүнээ	x u m uː n eː
хүмүүнээр	x u m uː n eː r̥
хүмүүнээрээ	x u m uː n eː r eː
хүмүүнээс	x u m uː n eː s
хүмүүнээсээ	x u m uː n eː s eː
хүмүүс	x u m uː s
хүмүүсгүй	x u m uː s k u i̯
хүмүүсгүйгээ	x u m uː s k u i̯ ɣ eː
хүмүүсийг	x u m uː s iː k
хүмүүсийгээ	x u m uː s iː k eː
хүмүүсийн	x u m uː s iː ŋ
хүмүүсийнх	x u m uː s iː ŋ x
хүмүүсийнхэн	x u m uː s iː ŋ x e ŋ
хүмүүсийнхээ	x u m uː s iː ŋ x eː
хүмүүст	x u m uː s tʰ
хүмүүстэй	x u m uː s tʰ e i̯
хүмүүстэйгээ	x u m uː s tʰ e i̯ ɣ eː
хүмүүстээ	x u m uː s tʰ eː
хүмүүсээ	x u m uː s eː
хүмүүсээр	x u m uː s eː r̥
хүмүүсээрээ	x u m uː s eː r eː
хүмүүсээс	x u m uː s eː s
хүмүүсээсээ	x u m uː s eː s eː
хүнгүй	x u ŋ k u i̯
хүнгүйгээ	x u ŋ k u i̯ ɣ eː
хүнд	x u n t
хүндрэл	x u n t r e ɮ
хүндээ	x u n t eː
хүний	x u n iː
хүнийг	x u n iː k
хүнийгээ	x u n iː k eː
хүнийх	x u n iː x
хүнийхэн	x u n iː x e ŋ
хүнийхээ	x u n iː x eː
хүнс	x u n s
хүнтэй	x u n tʰ e i̯
хүнтэйгээ	x u n tʰ e i̯ ɣ eː
хүнцэл	x u n t͡sʰ e ɮ
хүнээ	x u n eː
хүнээр	x u n eː r̥
хүнээрээ	x u n eː r eː
хүнээс	x u n eː s
хүнээсээ	x u n eː s eː
хүрз	x u r t s
хүрхрээ	x u r x r e
хүрэл	x u r ə ɮ
хүрэлзгэнэ	x u r ə ɮ t͡s ɡ ə n
хүрэлцэх	x u r e ɮ t͡sʰ e x
хүсэх	x u s ə x
хүч	x u t͡ɕʰ
хүчилтөрөгч	x u t͡ʃʰ ɪ ɮ tʰ ɵ r ɵ ɡ t͡ʃʰ
хүү	x uː
хүүгэд	x uː x ə t
хүүхэд	x uː x ə t
хүүхэлдэй	x uː x ə ɮ t e
хөвгүүд	x ɵ w̜ k uː t
хөвгүүдгүй	x ɵ w̜ k uː t k u i̯
хөвгүүдгүйгээ	x ɵ w̜ k uː t k u i̯ ɣ eː
хөвгүүддээ	x ɵ w̜ k uː t͉ t eː
хөвгүүдийг	x ɵ w̜ k uː t iː k
хөвгүүдийгээ	x ɵ w̜ k uː t iː k eː
хөвгүүдийн	x ɵ w̜ k uː t iː ŋ
хөвгүүдийнх	x ɵ w̜ k uː t iː ŋ x
хөвгүүдийнхэн	x ɵ w̜ k uː t iː ŋ x e ŋ
хөвгүүдийнхээ	x ɵ w̜ k uː t iː ŋ x eː
хөвгүүдтэй	x ɵ w̜ k uː t tʰ e i̯
хөвгүүдтэйгээ	x ɵ w̜ k uː t tʰ e i̯ ɣ eː
хөвгүүдэд	x ɵ w̜ k uː t e t
хөвгүүдээ	x ɵ w̜ k uː t eː
хөвгүүдээр	x ɵ w̜ k uː t eː r̥
хөвгүүдээрээ	x ɵ w̜ k uː t eː r eː
хөвгүүдээс	x ɵ w̜ k uː t eː s
хөвгүүдээсээ	x ɵ w̜ k uː t eː s eː
хөвгүүн	x ɵ w̜ k uː ŋ
хөвгүүнгүй	x ɵ w̜ k uː ŋ k u i̯
хөвгүүнгүйгээ	x ɵ w̜ k uː ŋ k u i̯ ɣ eː
хөвгүүнд	x ɵ w̜ k uː n t
хөвгүүндээ	x ɵ w̜ k uː n t eː
хөвгүүний	x ɵ w̜ k uː n iː
хөвгүүнийг	x ɵ w̜ k uː n iː k
хөвгүүнийгээ	x ɵ w̜ k uː n iː k eː
хөвгүүнийх	x ɵ w̜ k uː n iː x
хөвгүүнийхэн	x ɵ w̜ k uː n iː x e ŋ
хөвгүүнийхээ	x ɵ w̜ k uː n iː x eː
хөвгүүнтэй	x ɵ w̜ k uː n tʰ e i̯
хөвгүүнтэйгээ	x ɵ w̜ k uː n tʰ e i̯ ɣ eː
хөвгүүнээ	x ɵ w̜ k uː n eː
хөвгүүнээр	x ɵ w̜ k uː n eː r̥
хөвгүүнээрээ	x ɵ w̜ k uː n eː r eː
хөвгүүнээс	x ɵ w̜ k uː n eː s
хөвгүүнээсээ	x ɵ w̜ k uː n eː s eː
хөвүүн	x ɵ w̜ ɡ uː ŋ
хөгжим	x ɵ k t͡ɕ i m
хөгжимчин	x o ɡ t͡ɕ ə m t͡ɕʰ ə ŋ
хөдлөх	x o t ɮ ə x
хөдөлмөр	x ɵ t ɵ ɮ m ɵ r
хөлдөх	x ɵ ɮ t ɵ x
хөлдөөгч	x o ɮ t o ɡ t͡ɕʰ
хөлдөөх	x ɵ ɮ t ɵː x
хөмрүүлэх	x o m r u ɮ ə x
хөмрөх	x o m r ə x
хөмүүн	x ɵ m uː ŋ
хөндий	x o n t i
хөнжил	x ɵ n t͡ɕ ə ɮ
хөнөг	x o n ə ɡ
хөргүүр	x ɵ r k uː r̥
хөргөгч	x ɵ r k ɵ k t͡ɕʰ
хөрс	x o r s
хөрш	x o r ʃ
хөрөө	x o r o
хөх	x ɵ x
хөхүүр	x o x u r
хөхөн	x ɵ x ɵ ŋ
хөхөх	x ɵ x ɵ x
хөших	x ɵ ɕ i x
хөөе	x ɵː j
хөөмий	x ɵː m iː
хөөрөг	x oː r ə ɡ
ц	t͡sʰ
цаасан	t͡sʰ aː s ə ŋ
цавуу	t͡sʰ a w ʊ
цаг	t͜sʰ ä k̠
цагаан	t͡s a ɢ aː ŋ
цаглабар	t͡sʰ a k ɮ a β a r̥
цадиг	t͡sʰ a tʲ ə ɡ
цайг	t͡sʰ ɛː k
цайгаар	t͡sʰ ɛː k aː r̥
цайгүй	t͡sʰ ɛː k u i̯
цайллага	t͡sʰ a i ɮ ɮ ə ɢ
цайн	t͡sʰ ɛː ŋ
цайнаас	t͡sʰ ɛː n aː s
цайнд	t͡sʰ ɛː n t
цайнууд	t͡sʰ ɛː n ʊː t
цайнуудаар	t͡sʰ ɛː n ʊː t aː r̥
цайнуудаас	t͡sʰ ɛː n ʊː t aː s
цайнуудад	t͡sʰ ɛː n ʊː t a t
цайнуудгүй	t͡sʰ ɛː n ʊː t k u i̯
цайнуудтай	t͡sʰ ɛː n ʊː t tʰ ɛː
цайнуудыг	t͡sʰ ɛː n ʊː t i k
цайнуудын	t͡sʰ ɛː n ʊː t i ŋ
цайнуудынх	t͡sʰ ɛː n ʊː t i ŋ x
цайнуудынхан	t͡sʰ ɛː n ʊː t i ŋ x a ŋ
цайр	t͡sʰ a i r
цайтай	t͡sʰ ɛː tʰ ɛː
цамц	t͡sʰ a m t͡sʰ
цангаа	t͡sʰ a ŋ ɢ a
цангах	t͡sʰ a ŋ ɢ ə x
царс	t͡sʰ a r s
цас	t͡sʰ a s
цас	t͡ʃʰ ɐ s
цахилгаан	t͡sʰ a x i ɮ k aː ŋ
цахилгаанжуулалт	t͡sʰ a x i ɮ k aː n t͡ɕ ʊː ɮ a ɮ tʰ
цахилгаанжуулах	t͡sʰ a x i ɮ k aː n t͡ɕ ʊː ɮ a x
цахим	t͡sʰ a x i m
цилиндр	t͡sʰ i ɮ i n t r̥
цирк	t͡sʰ i r̥ kʰ
цогц	t͡sʰ ɔ ɡ t͡sʰ
цогцос	t͡sʰ ɔ ɡ t͡sʰ ə s
цонх	t͡sʰ ɔ ŋ x
цохих	t͡sʰ ɔ xʲ ə x
цуйван	t͡sʰ ʊ i w ə ŋ
цус	t͡sʰ ʊ s
цэ	t͡sʰ e
цэвэрлэх	t͡sʰ e w ə r ɮ ə x
цэг	t͡sʰ e k
цэдэнбализм	t͡sʰ e t e m p a ɮ i t͡s m
цэнэглэх	t͡sʰ e n e k ɮ e x
цэцэг	t͡ʃʰ i t͡ʃʰ ɘ k
цээжлэх	t͡sʰ eː t͡ʃ ɮ e x
цүүц	t͡sʰ uː t͡sʰ
цөл	t͡sʰ o ɮ
цөлхөөв	t͡sʰ ɵ ɬʰ ɵː w̜
цөцгий	t͡sʰ o t͡sʰ ɡ i
цөөн	t͡sʰ oː ŋ
ч	t͡ɕʰ
чавга	t͡ɕʰ a w̜ k
чавхдас	t͡ɕʰ a w x t ə s
чагнаал	t͡ɕʰ a ɡ n a ɮ
чадвар	t͡ɕʰ a t w̜ a r̥
чанар	t͡ɕʰ a n ə r
чанарлаг	t͡ɕʰ a n ə r ɮ ə ɡ
чанасан	t͡ɕʰ a n a s a ŋ
чангаанз	t͡ɕʰ a ŋ k aː n t͡s
чек	t͡ɕʰ j ɵ kʰ
чи	t͡ɕʰ i
чидун	t͡ɕʰ i t ʊ ŋ
чийг	t͡ɕʰ iː ɡ
чийдэн	t͡ɕʰ iː t e ŋ
чинжүү	t͡ɕʰ i n t͡ɕ uː
чих	t͡ɕʰ i x
чоно	t͡ɕʰ ɔ n
чулуу	t͡ɕʰ ʊ ɮ ʊː
чухаг	t͡ɕʰ ʊ x ə ɡ
чухал	t͡ɕʰ ʊ x ə ɮ
чэ	t͡ɕʰ e
чүнчигноров	t͡ɕʰ u n t͡ɕʰ i k n ɔ r ɔ w̜
чөдөр	t͡ɕʰ ɵ t ɵ r̥
чөмөг	t͡ɕʰ o m ə ɡ
ш	ɕ
ша	ɕ a
шаазгай	ʃ aː t͡s ɢ a i
шаардах	ʃ aː r t ə x
шаардлага	ʃ aː r t ɮ ə ɢ
шавар	ʃ a w ə r
шал	ɕ a ɮ
шалах	ɕ a ɮ a x
шалбархай	ɕ a ɮ p a r x ɛː
шалгалт	ɕ a ɮ k a ɮ tʰ
шалгах	ʃ a ɮ ɢ ə x
шалгуур	ʃ a ɮ ɢ ʊ r
шалтаг	ʃ a ɮ tʰ ə ɡ
шалтгаа	ʃ a ɮ tʰ ɡ a
шалтгаа	ʃ a ɮ tʰ ɢ a
шалтгаан	ʃ a ɮ tʰ ɢ a ŋ
шанаа	ʃ a n a
шанд	ʃ a n t
шанз	ʃ a n t͡s
шар	ʃ a r
шатаах	ʃ a tʰ a x
шатар	ʃ a tʰ ə r
шафа	ʃ a f a
шах	ɕ a x
шахах	ʃ a x ə x
шашин	ɕ a ɕ i ŋ
шашингүй	ɕ a ɕ i ŋ k u i̯
шашингүйгээ	ɕ a ɕ i ŋ k u i̯ ɣ eː
шашинд	ɕ a ɕ i n t
шашиндаа	ɕ a ɕ i n t aː
шашинтай	ɕ a ɕ i n tʰ ɛː
шашинтайгаа	ɕ a ɕ i n tʰ ɛː k aː
шашнаа	ɕ a ɕ n aː
шашнаар	ɕ a ɕ n aː r̥
шашнаараа	ɕ a ɕ n aː r aː
шашнаас	ɕ a ɕ n aː s
шашнаасаа	ɕ a ɕ n aː s aː
шашнууд	ɕ a ɕ n ʊː t
шашнуудаа	ɕ a ɕ n ʊː t aː
шашнуудаар	ɕ a ɕ n ʊː t aː r̥
шашнуудаараа	ɕ a ɕ n ʊː t aː r aː
шашнуудаас	ɕ a ɕ n ʊː t aː s
шашнуудаасаа	ɕ a ɕ n ʊː t aː s aː
шашнуудад	ɕ a ɕ n ʊː t a t
шашнуудгүй	ɕ a ɕ n ʊː t k u i̯
шашнуудгүйгээ	ɕ a ɕ n ʊː t k u i̯ ɣ eː
шашнууддаа	ɕ a ɕ n ʊː t͉ t aː
шашнуудтай	ɕ a ɕ n ʊː t tʰ ɛː
шашнуудтайгаа	ɕ a ɕ n ʊː t tʰ ɛː k aː
шашнуудыг	ɕ a ɕ n ʊː t i k
шашнуудыгаа	ɕ a ɕ n ʊː t i ɣ aː
шашнуудын	ɕ a ɕ n ʊː t i ŋ
шашнуудынх	ɕ a ɕ n ʊː t i ŋ x
шашнуудынхаа	ɕ a ɕ n ʊː t i ŋ x aː
шашнуудынхан	ɕ a ɕ n ʊː t i ŋ x a ŋ
шашны	ɕ a ɕ n i
шашныг	ɕ a ɕ n i k
шашныгаа	ɕ a ɕ n i ɣ aː
шашных	ɕ a ɕ n i x
шашныхаа	ɕ a ɕ n i x aː
шашныхан	ɕ a ɕ n i x a ŋ
шивнэх	ʃ i w n ə x
шивээс	ʃ i w e s
шизофрени	ɕ i t͡s ɔ f rʲ ɵ n i
шийдвэр	ʃ iː t w ə r
шийжүү	ʃ iː t͡ɕ u
шил	ʃ i ɮ
шилбэ	ʃ i ɮ p
шилүүс	ʃ i ɮ u s
шингэн	ʃ i ŋ ɡ ə ŋ
шинжлэл	ɕ i n t͡ɕ ɮ e ɮ
шинэ	ʃ i n
шинэлэг	ʃ i n ɮ ə ɡ
ширхэг	ʃ i r x e ɡ
ширээ	ʃ i r e
шит	ɕ i tʰ
шодой	ʃ ɔ t ɔ i
шоколад	ɕ ɔ kʰ ɮ a t
шонхор	ʃ ɔ ŋ x ɔ r
шоо	ʃ ɔː
шоргоолж	ɕ ɔ r k oː ɮ t͡ɕ
шорлог	ʃ ɔ r ɮ ə ɡ
шороо	ɕ ɔ r oː
шпагетти	ɕ pʰ a kʲ ɵ tʰ
шувуу	ʃ ʊ w ʊ
шугам	ʃ ʊ ɢ ə m
шулуун	ʃ ʊ ɮ ʊ ŋ
шумуул	ɕ ʊ m ʊː ɮ
шуугиан	ʃ ʊː ɡʲ a ŋ
шуудан	ɕ ʊː t a ŋ
шээх	ɕ eː x
шянчи	ɕ j a n t͡ɕʰ i
шянчуу	ɕ j a n t͡ɕʰ ʊː
шүд	ʃ u d
шүлс	ʃ u ɮ s
шүү	ɕ uː
шүүдэр	ʃ uː t ə r
шүүр	ɕ uː r̥
шүүрдэх	ɕ uː r t e x
шүүс	ʃ uː s
шүүслэг	ʃ uː s ɮ ə ɡ
шүүслэх	ʃ uː s ɮ ə x
щ	ɕ
ща	ɕ a
щит	ɕ i tʰ
ы	i
ь	ʲ
э	e
эв	i w
эд	e tʰ
экзистенциализм	e kʰ t͡s i s tʰʲ ɵ n t͡sʰ i̯ aː ɮ i t͡s m
эл	e ɮ
элэг	i ɮ ə ɡ
эм	e m
эмнэлэг	i m n ə ɮ ə ɡ
эмчилгээ	e m t͡ɕʰ ə ɮ ɡ e
эмэгтэйчүүдийг	e m e k tʰ e i̯ t͡ɕʰ uː t iː k
эмэгтэйчүүдийн	e m e k tʰ e i̯ t͡ɕʰ uː t iː ŋ
эмэгтэйчүүдэд	e m e k tʰ e i̯ t͡ɕʰ uː t e t
эмээл	i m e ɮ
эн	e ŋ
эндометриоз	e n t ɔ mʲ ɵ tʰ r i̯ oː t͡s
энх	e ŋ x
энэ	e n
энэтхэгчүүд	e n e tʰ x e k t͡ɕʰ uː t
эр	e r̥
эргэх	i r ɡ i x
эрзээн	e r t͡s eː ŋ
эрлийзжих	e r ɮ iː t͡s t͡ɕ i x
эрх	i r x
эрхийвч	i r x i w t͡ɕʰ
эрхтэн	e r x tʰ e ŋ
эрхүүд	e r x uː t
эрч	i r t͡ɕʰ
эрчүүдийн	e r̥ t͡ɕʰ uː t iː ŋ
эрэгтэйчүүдийн	e r e k tʰ e i̯ t͡ɕʰ uː t iː ŋ
эрүү	e r u
эс	e s
эсгий	i s ɡ i
эф	e f
эх	i x
эхлэх	e x ɮ ə x
эхнэр	e x n e r̥
ээ	eː
ээмэг	eː m i k
ю	j u
ю	j ʊ
юм	j ʊ m
юмгүй	j ʊ m k u i̯
юмдүүжин	j ʊ m t uː t͡ɕ i ŋ
юмс	j ʊ m s
юмсан	j ʊ m s a ŋ
юу	j ʊː
юү	j uː
я	j a
яагаад	j aː ɢ a t
яам	j aː m
явдал	j a w t ə ɮ
явц	j a w t͡sʰ
явцуу	j a w t͡sʰ ʊ
ял	j a ɮ
ялгал	j a ɮ ɢ a ɮ
ялгах	j a ɮ ɢ a x
ямаа	j a m a
ямар	j a m ə r
яндан	j a n t a ŋ
янжуур	j a ŋ t͡ɕ ʊ r
янз	j a n t͡s
янхан	j a ŋ x a ŋ
япончууд	j a pʰ ɔ n t͡ɕʰ ʊː t
япончуудын	j a pʰ ɔ n t͡ɕʰ ʊː t i ŋ
ястан	j ä s tʰ ə ŋ
ятга	j a tʰ ə ɢ
ятуу	j a tʰ ʊ
ё	j ɔ
ёкозуна	j ɔ kʰ ɔ t͡s ʊ n
ёл	j ɔ ɮ
ёотон	j ɔː tʰ ɔ ŋ
ёс	j ɔ s
ёслол	j ɔ s ɮ ʊ ɮ
Ү	u
ү	u
үг	u ɡ
үггүй	u ɣ u i̯
үгийг	u ɣ iː k
үгийн	u ɡ i ŋ
үгний	u k n iː
үгнийх	u k n iː x
үгнийхэн	u k n iː x e ŋ
үгнээс	u k n eː s
үгс	u k s
үгсгүй	u k s k u i̯
үгсийг	u k s iː k
үгсийн	u k s iː ŋ
үгсийнх	u k s iː ŋ x
үгсийнхэн	u k s iː ŋ x e ŋ
үгстэй	u k s tʰ e i̯
үгсэд	u k s e t
үгсээр	u k s eː r̥
үгсээс	u k s eː s
үгтэй	u k tʰ e i̯
үгэн	u ɣ e ŋ
үгэнд	u ɣ e n t
үгээр	u ɣ eː r̥
үгүй	u ɡ u i̯
үдэш	u t e ɕ
үе	u j
үерхэх	u j ɵ r x e x
үзэлцэх	u t͡s e ɮ t͡sʰ e x
үзэм	u t͡s ə̆ m
үзэх	u t͡s ə x
үзүүр	u t͡s u r
үйл	u i ɮ
үйлдвэр	u i ɮ t w ə r
үйлдвэржих	u i ɮ t w ə r t͡ɕ ə x
үйлдвэрийн	u i̯ ɮ t w̜ e r iː ŋ
үйлдвэрлэл	u i ɮ t w ə r ɮ ə ɮ
үйлдвэрлэх	u i ɮ t w ə r ɮ ə x
үйлдвэрчин	u i ɮ t w ə r t͡ɕʰ ə ŋ
үйлдэл	u i ɮ t ə ɮ
үйлдэржилт	u i ɮ t w e r t͡ɕ ə ɮ tʰ
үйлдэх	u i ɮ t ə x
үйлс	u i̯ ɮ s
үйлчилгээ	u ɮ t͡ɕʰ i ɮ k eː
үйлчлэл	u i̯ ɮ t͡ɕʰ ɮ e ɮ
үйлчлэх	u i ɮ t͡ɕʰ ɮ ə x
үйлчлүүлэгч	u i̯ ɮ t͡ɕʰ ɮ uː ɮ e k t͡ɕʰ
үйлчлүүлэх	u i̯ ɮ t͡ɕʰ ɮ uː ɮ e x
үлээх	u ɮ e x
үндэстэн	u n t ə s t ə ŋ
үнс	u n s
үнсэх	u n s e x
үнэ	u n
үнэг	u n ə ɡ
үнэн	u n e n
үнээ	u n e
үр	u r
үсрэх	u s r e x
үтрэм	u tʰ r ə m
үтрээ	u tʰ r e
үхэр	u x ə r
үүл	uː l
үүлгүй	uː ɮ k u i̯
үүлийг	uː ɮ iː k
үүлний	uː ɮ n iː
үүлнээс	uː ɮ n eː s
үүлнүүд	uː ɮ n uː t
үүлнүүдгүй	uː ɮ n uː t k u i̯
үүлнүүдийг	uː ɮ n uː t iː k
үүлнүүдийн	uː ɮ n uː t iː ŋ
үүлнүүдтэй	uː ɮ n uː t tʰ e i̯
үүлнүүдэд	uː ɮ n uː t e t
үүлнүүдээр	uː ɮ n uː t eː r̥
үүлнүүдээс	uː ɮ n uː t eː s
үүлтэй	uː ɮ n tʰ e i̯
үүлэн	uː ɮ e ŋ
үүлэнд	uː ɮ e n t
үүлээр	uː ɮ eː r̥
үүргэвч	uː r k e w̜ t͡ɕʰ
Ө	œ
Ө	ɵ ~ o
Өгэдэй	ɵ ɣ e t e i̯
Өгэдэйг	ɵ ɣ e t e i̯ k
Өгэдэйгээр	ɵ ɣ e t e i̯ ɣ eː r̥
Өгэдэйгээс	ɵ ɣ e t e i̯ ɣ eː s
Өгэдэйгүй	ɵ ɣ e t e i̯ ɣ u i̯
Өгэдэйд	ɵ ɣ e t e i̯ t
Өгэдэйн	ɵ ɣ e t e i̯ ŋ
Өгэдэйнд	ɵ ɣ e t e i̯ n t
Өгэдэйтэй	ɵ ɣ e t e i̯ tʰ e i̯
Өлгий	ɵ ɮ k iː
Өндөрхаан	ɵ n t ɵ r x aː ŋ
Өэлүн	ɵ e ɮ u ŋ
Өэлүнгүй	ɵ e ɮ u ŋ k u i̯
Өэлүнд	ɵ e ɮ u n t
Өэлүний	ɵ e ɮ u n iː
Өэлүнийг	ɵ e ɮ u n iː k
Өэлүнийд	ɵ e ɮ u n iː t
Өэлүнтэй	ɵ e ɮ u n tʰ e i̯
Өэлүнээр	ɵ e ɮ u n eː r̥
Өэлүнээс	ɵ e ɮ u n eː s
ө	ɵ
өв	ɵ w̜
өвгөн	ɵ w̜ k ɵ ŋ
өвдөг	o w t ə ɡ
өвс	o w s
өвчин	ɵ w̜ t͡ɕʰ i ŋ
өвөл	ɵ w̜ ɵ ɮ
өвөр	o w o r
өвөө	ɵ w̜ ɵː
өгзөг	ɵ k t͡s ɵ k
өглөг	ɵ k ɮ ɵ k
өглөө	ɵ k ɮ ɵː
өгөх	o ɡ ə x
өд	o t
өдгөө	ɵ t k ɵː
өдөр	ɵ t ə r̥
өеө	ɵ j ɵ
өеөдөх	ɵ j ɵ ɵ t ɵ x
өлмий	o ɮ m i
өлсгөлөн	o ɮ s ɡ ə ɮ ə ŋ
өлсөх	o ɮ s ə x
өмд	ɵ m t
өмнө	ɵ m n
өмсөх	o m s ə x
өнгө	ɵ ŋ k
өндгөн	ɵ n t k ɵ ŋ
өнчин	o n t͡ɕʰ ə ŋ
өр	ɵ r̥
өргөдөл	ɵ r k ɵ t ɵ ɮ
өргөлт	ɵ r k ɵ ɮ tʰ
өргөлттэй	ɵ r k ɵ ɮ tʰ e i̯
өргөө	ɵ r k ɵː
өргөөн	ɵ r k ɵː ŋ
өрсөлдөгч	ɵ r s ɵ ɮ t ɵ ɡ t͡ʃʰ
өрсөлдөх	ɵ r s u ɮ t u x
өрсөлдөөн	ɵ r s ɵ ɮ t oː ŋ
өрсөх	ɵ r s u x
өрөм	o r ə m
өсгий	ɵ s k iː
өтгөн	o tʰ ɡ ə ŋ
өчүүхэн	o t͡ɕʰ u x ə ŋ
өө	ɵː
өөд	ɵː t
өөлд	oː ɮ tʰ
өөр	oː r
өөрийн	ɵː r iː ŋ
өөрийнхөө	ɵː r iː ŋ x ɵː
өөрчлөлт	oː r t͡ɕʰ ɮ ə ɮ tʰ
өөрчлөх	oː r t͡ɕʰ ɮ ə x
өөх	oː x
өөхлөг	oː x ɮ ə ɡ
өөш	ɵː ɕ
