अं	ʌ̃ m
अकास	ʌ k ä s
अखबार	ʌ k̞ʰ b ä r
अग्नि	ʌ ɡ n ĩ
अङ्गुर	ʌ̃ ŋ ɡ u r
अङ्ग्रेजी	ʌ̃ ŋ ɡ r e d͡z i
अचार	ʌ t͡s ä r
अञ्चल	ʌ̃ n̻ t͡s ʌ l
अट्ठा	ʌ ʈ̚ ʈʰ ä
अट्ठाईस	ʌ ʈ̚ ʈʰ ä i̯ s
अठतीस	ʌ ɽ t̪ i s
अठसट्ठी	ʌ ʈʰ ʌ s ʌ ʈ̚ ʈʰ i
अठहत्तर	ʌ ʈʰ ʌ ɦ ʌ t̪̚ t̪ ʌ r
अठार	ʌ ʈʰ ä ɾ ʌ
अठाह्र	ʌ ʈʰ ä ɾ ʌ
अड्चालीस	ʌ ɽ t͡s ä l i s
अड्तीस	ʌ ɽ t̪ i s
अड्सठ्ठी	ʌ ɽ s ʌ ʈʰ ʈʰ i
अणु	ʌ ɽ̃ u
अण्डा	ʌ̃ ɳ ɖ ä
अथवा	ʌ t̪ʰ ʌ w ä
अधिकार	ʌ d̪ i k ä r
अनावश्यक	ʌ̃ n ä b ʌ sː e k
अनि	ʌ̃ n ĩ
अनुपम	ʌ̃ n ũ p ʌ̃ m
अनुबादक	ʌ̃ n ũ b ä d̪ ʌ k
अनुमति	ʌ̃ n ũ m ʌ t̪ i
अन्ठाउन्न	ʌ̃ ɳ ʈʰ ä u̯ nː ʌ
अन्ठानब्बे	ʌ̃ ɳ ʈʰ ä̃ n ʌ b̚ b e
अन्डा	ʌ̃ ɳ ɖ ä
अन्दाजी	ʌ̃ n̪ d̪ ä d͡z i
अन्य	ʌ̃ nː e
अमिलो	ʌ̃ m ĩ l o
अमेरिका	ʌ̃ m e ɾ i k ä
अरब	ʌ ɾ ʌ b
अर्ध	ʌ r d̪ʱ ʌ̤
अल्छी	ʌ l̻ t͡sʰ i
अस्ट्रेलिया	ʌ s̠ t̠ r e l i j ä
अस्पताल	ʌ s p ʌ t̪ ä l
अस्मान	ʌ s m ä̃ n
अहिले	ʌ i̯ l e
अह्राउनु	ʌ ɾ ä u̯ n ũ
आ	ä
आँखा	ä̃ kʰ ä
आँखीभौं	ä̃ kʰ i β ʌ̃ u̯
आआफ्नो	ä ä ɸ n o
आआफ्नो	ä ʔ ä ɸ n o
आइतबार	ä i̯ t̪ ʌ b ä r
आइस्ड	ä i̯ s̠ d̠
आईतबार	ä i̯ t̪ ʌ b ä r
आउनु	ä u̯ n ũ
आउनुहोस्	ä u̯ n ũ ɦ o s
आकाश	ä k ä s
आकाशे	ä k ä s e
आगो	ä ɡ o
आज	ä d͡z ʌ
आठ	ä ʈʰ
आफ्नो	ä ɸ n o
आमा	ä̃ m ä
आराम	ä ɾ ä̃ m
आलु	ä l u
आवश्यक	ä b ʌ sː e k
आस्मानी	ä s m ä̃ n ĩ
आहा	ä ɦ ä
आहा	äʰ ˨ ɦ ä ˦
इँट्टा	ĩ ʈ̚ ʈ ä
इंडिया	ĩ ɳ ɖ i j ä
इतिहास	i t̪ i j ä s
इन्टरनेट	ĩ ɳ ʈ ʌ r n e ʈ
इन्द्रेनी	ĩ n̪ d̪ r ẽ n ĩ
इस्टोनिया	i s̠ t̠ õ n ĩ j ä
इस्लाम	i s l ä̃ m
ईँट्टा	ĩ ʈ̚ ʈ ä
ईश्वर	i sː o r
उँचाइ	ũ t͡s ä i̯
उखु	u k̞ʰ u
उचाइ	u t͡s ä i̯
उठ्नु	u ʈʰ ɳ ũ
उड्नु	u ɽ ɳ ũ
उत्तर	u t̪̚ t̪ ʌ r
उदजन	u d̪ d͡z ʌ̃ n
उदाहरण	u d̪ ä ɦ ä̆ r ʌ ɽ̃
उनचालीस	ũ n̻ t͡s ä l i s
उनतीस	ũ n ʌ̃ t̪ i s
उनन्चालीस	ũ n ʌ̃ n̻ t͡s ä l i s
उनन्तीस	ũ n ʌ̃ n̪ t̪ i s
उनन्पचास	ũ n ʌ̃ n p ʌ t͡s ä s
उनपचास	ũ n p ʌ t͡s ä s
उनसाठी	ũ n s ä ʈʰ i
उनानब्बे	ũ n ä̃ n ʌ b̚ b e
उनानसय	ũ n ä̃ n s ʌ e̞
उनान्असी	ũ n ä̃ n ʌ̃ s i
उनासी	ũ n ä̃ s i
उनी	ũ n ĩ
उनीहरू	ũ n ĩ ɦ ʌ ɾ u
उन्चालीस	ũ n̻ t͡s ä l i s
उन्तीस	ũ n̪ t̪ i s
उन्नाइस	ũ nː ä i̯ s
उन्सत्तरी	ũ n s ʌ t̪̚ t̪ ʌ ɾ i
उपन्यास	u p ʌ̃ nː j ä s
उपाय	u p ä e̞
उफ्रनु	u ɸ r ʌ̃ n ũ
उभिनु	u β ĩ n ũ
उमेर	ũ m e r
उसमा	u s m ä
उसलाई	u s l ä i̯
उहाँहरूको	u ɦ ä̃ ɦ ʌ ɾ u k o
उहाहरुको	u ɦ ä̃ ɦ ʌ ɾ u k o
ऋ	ɾ i
एउटा	e u̯ ʈ ä
एकचालीस	e k t͡s ä l i s
एकतीस	e k̚ t̪ i s
एकत्तर	e k ʌ t̪̚ t̪ ʌ r
एकत्तीस	e k ʌ t̪̚ t̪ i s
एकदम	e k̚ d̪ ʌ̃ m
एकसट्ठी	e k s ʌ ʈ̚ ʈʰ i
एकहत्तर	e k ʌ ɦ ʌ t̪̚ t̪ ʌ r
एकाउन्न	e k ä u̯ nː ʌ
एकानब्बे	e k ä̃ n ʌ b̚ b e
एकासी	e k ä s i
एक्का	e k̚ k ä
एक्काइस	e k̚ k ä i̯ s
एक्काईस	e k̚ k ä i̯ s
एक्काउन्न	e k̚ k ä u̯ nː ʌ
एक्त्तीस	e k̚ t̪ t̪ i s
एगार	e ɡ ä ɾ ʌ
एघार	e ɡ̞ ä ɾ ʌ
एशिया	e s i j ä
एसिया	e s i j ä
ऐना	ʌ ĩ̯ n ä
ओहायो	o ɦ ä j o
औंठी	ʌ ũ̯ ɳ ʈʰ i
औंला	ʌ̃ u̯ l ä
औषधी	ʌ u̯ s ʌ d̪ i
कन्या	k ʌ̃ n j ä
कन्या	k ʌ̃ nː j ä
कपाल	k ʌ p ä l
कफी	k ʌ ɸ i
कमिज	k ʌ̃ m ĩ d͡z
कमिलो	k ʌ̃ m ĩ l o
कमीज	k ʌ̃ m ĩ d͡z
कम्बल	k ʌ̃ m b ʌ l
कराउनु	k ʌ ɾ ä u̯ n ũ
करोड	k ʌ ɾ o ɽ
कलम	k ʌ l ʌ̃ m
कसमा	k ʌ s m ä
कसरी	k ʌ s ʌ ɾ i
कसलाई	k ʌ s l ä i̯
कहाँ	k ä̃ː
कहाँ	k ä̆ ɦ ä̤̃
कहाँ	k ä̤̃
कहिले	k ʌ i̯ l e
काँच	k ä̃ t͡s
काँध	k ä̃ d̪ʱ
काँसो	k ä̃ s o
कांच	k ä̃ t͡s
काख	k ä k̞ʰ
कागज	k ä ɡ ʌ d͡z
कागत	k ä ɡ ʌ t̪
कागती	k ä ɡ ʌ t̪ i
काजी	k ä d͡z i
काठमाडौँ	k ä ʈʰ m ä ɽ ʌ̃ u̯
काठमाडौँ	k ä ʈʰ m ä̃ ɳ ɖ u
काठमाडौं	k ä ʈʰ m ä ɽ ʌ̃ u̯
काठमाडौं	k ä ʈʰ m ä̃ ɳ ɖ u
कापी	k ä p i
काफल	k ä ɸ ʌ l
काम	k ä̃ m
कामना	k ä̃ m ʌ̃ n ä
कामी	k ä̃ m ĩ
काम्लो	k ä̃ m l o
कार	k ä r
कालो	k ä l o
कालोपाटी	k ä l o p ä ʈ i
किताप	k i t̪ ä p
किताब	k i t̪ ä b
किताबहरू	k i t̪ ä b ɦ ʌ ɾ u
किन	k ĩ n ʌ
किनभने	k ĩ n ʌ β ʌ̃ n e
किन्नु	k ĩ nː ũ
किराना	k i ɾ ä̃ n ä
कुइरे	k u i̯ ɾ e
कुइरो	k u i̯ ɾ o
कुट्नु	k u ʈ ɳ ũ
कुद्नु	k u d̪ n̪ u
कुन	k ũ n
कुनचाहिँ	k ũ n̻ t͡s ä ĩ̯
कुनै	k ũ n ʌ i̯
कुमारी	k ũ m ä ɾ i
कुरा	k u ɾ ä
कुरी	k u ɾ i
कृपया	k ɾ i p ʌ j ä
केटा	k e ʈ ä
केमा	k ẽ m ä
केरा	k e ɾ ä
केलाई	k e l ä i̯
केही	k e i̯
केही	k e ɦ i
कोठा	k o ʈʰ ä
क्ष	t͡sʰʲ ʌ
क्षत्राणी	t͡sʰʲ ʌ t̪ r ä ɽ̃ i
क्षत्रिय	t͡sʰʲ ʌ t̪ r i e̞
क्षमता	t͡sʰʲ ʌ̃ m ʌ t̪ ä
क्षयरोग	t͡sʰʲ ʌ e̞ r o ɡ
क्षेत्र	t͡sʰʲ e t̪ r ʌ
क्षेत्रिनी	t͡sʰʲ e t̪ r ĩ n ĩ
क्षेत्री	t͡sʰʲ e t̪ r i
क्‍लास	k l ä s
खत्रिनी	kʰ ʌ t̪ r ĩ n ĩ
खरब	kʰ ʌ ɾ ʌ b
खरानी	kʰ ʌ ɾ ä̃ n ĩ
खराब	kʰ ʌ ɾ ä b
खरी	kʰ ʌ ɾ i
खरीमट्टी	kʰ ʌ ɾ ĩ m ʌ ʈ̚ ʈ i
खल्ती	kʰ ʌ l̪ t̪ i
खस्नु	kʰ ʌ s n ũ
खा	kʰ ä
खाजा	kʰ ä d͡z ä
खाता	kʰ ä t̪ ä
खाना	kʰ ä̃ n ä
खानु	kʰ ä̃ n ũ
खानेकुरा	kʰ ä̃ n e k u ɾ ä
खुकुरी	kʰ u k u ɾ i
खुवाउनु	kʰ u w ä u̯ n ũ
खेल्नु	kʰ e l n ũ
खैरो	kʰ ʌ i̯ ɾ o
खोज्नु	kʰ o d͡z n ũ
खोर्सानी	kʰ o r s ä̃ n ĩ
खोला	kʰ o l ä
खोल्नु	kʰ o l n ũ
गगन	ɡ ʌ ɡ ʌ̃ n
गणतन्त्र	ɡ ʌ ɽ̃ ʌ t̪ ʌ̃ n̪ t̪ r ʌ
गन्नु	ɡ ʌ̃ nː ũ
गराउनु	ɡ ʌ ɾ ä u̯ n ũ
गरि	ɡ ʌ ɾ i
गरेर	ɡ ʌ ɾ e r ʌ
गर्नु	ɡ ʌ r n ũ
गर्नुहोला	ɡ ʌ r n ũ ɦ o l ä
गर्मी	ɡ ʌ r m ĩ
गह्रुङ्गो	ɡ ʌ ɾ ũ ŋ ɡ o
गह्रौं	ɡ ʌ ɾ ʌ̃ u̯
गा	ɡ ä
गाई	ɡ ä i̯
गाउँ	ɡ ä ũ̯
गाउनु	ɡ ä u̯ n ũ
गाऊ	ɡ ä u̯
गाढा	ɡ ä ɽ ä
गाली	ɡ ä l i
गाह्रो	ɡ ä ɾ o
गुजराती	ɡ u d͡z r ä t̪ i
गुणसूत्र	ɡ u ɽ̃ ʌ s u t̪ r ʌ
गुफा	ɡ u ɸ ä
गुरु	ɡ u ɾ u
गुलाबी	ɡ u l ä b i
गुलाम	ɡ u l ä̃ m
गैँडा	ɡ ʌ̃ i̯ ɽ ä
गैंडा	ɡ ʌ̃ i̯ ɽ ä
गोर्खा	ɡ o r kʰ ä
ग्यार	ɡ j ä ɾ ʌ
ग्रह	ɡ ɾ ʌː
घ	ɡʱ ʌ̤
घंटा	ɡʱ ʌ̤̃ ɳ ʈ ä
घडी	ɡʱ ʌ̤ ɽ i
घर	ɡʱ ʌ̤ r
घाउ	ɡʱ ä̤ u̯
घाम	ɡʱ ä̤̃ m
घूस	ɡʱ ṳ s
घोड़ा	ɡʱ o̤ ɽ ä
घोडा	ɡʱ o̤ ɽ ä
चक्कु	t͡s ʌ k̚ k u
चढ्नु	t͡s ʌ ɽ ɳ ũ
चन्द्र	t͡s ʌ̃ n̪ d̪ r ʌ
चन्द्रमा	t͡s ʌ̃ n̪ d̪ r ʌ̃ m ä
चरा	t͡s ʌ ɾ ä
चरित्र	t͡s ʌ ɾ i t̪ r ʌ
चलचित्र	t͡s ʌ l̻ t͡s i t̪ r ʌ
चलन	t͡s ʌ l ʌ̃ n
चल्नु	t͡s ʌ l n ũ
चवालीस	t͡s ʌ w ä l i s
चाख	t͡s ä k̞ʰ
चाट	t͡s ä ʈ
चार	t͡s ä r
चालीस	t͡s ä l i s
चाहिँ	t͡s ä ĩ̯
चिउरा	t͡s i u̯ ɾ ä
चिक्नु	t͡s i k n ũ
चिठी	t͡s i ʈ̚ ʈʰ i
चिडी	t͡s i ɽ i
चित्त	t͡s i t̪̚ t̪ ʌ
चिनी	t͡s ĩ n ĩ
चिया	t͡s i j ä
चीन	t͡s ĩ n
चीनियाँ	t͡s ĩ n ĩ j ä̃
चुरोट	t͡s u ɾ o ʈ
चौका	t͡s ʌ u̯ k ä
चौतारी	t͡s ʌ u̯ t̪ ä ɾ i
चौध	t͡s ʌ u̯ d̪ ʌ
चौरत्तर	t͡s ʌ u̯ ɾ ʌ t̪̚ t̪ ʌ r
चौरानब्बे	t͡s ʌ u̯ ɾ ä̃ n ʌ b̚ b e
चौरासी	t͡s ʌ u̯ ɾ ä s i
चौवन्न	t͡s ʌ u̯ w ʌ̃ nː ʌ
चौहत्तर	t͡s ʌ u̯ ɦ ʌ t̪̚ t̪ ʌ r
छक्का	t͡sʰ ʌ k̚ k ä
छत्तीस	t͡sʰ ʌ t̪̚ t̪ i s
छन्	t͡sʰ ʌ̃ n
छप्पन्न	t͡sʰ ʌ p̚ p ʌ̃ nː ʌ
छब्बीस	t͡sʰ ʌ b̚ b i s
छयत्तर	t͡sʰ ʌ e̞ t̪̚ t̪ ʌ r
छयसट्ठी	t͡sʰ ʌ e̞ s ʌ ʈ̚ ʈʰ i
छयानब्बे	t͡sʰ ʌ j ä̃ n ʌ b̚ b e
छयालीस	t͡sʰ ʌ j ä l i s
छयासी	t͡sʰ ʌ j ä s i
छहत्तर	t͡sʰ ʌ ɦ ʌ t̪̚ t̪ ʌ r
छाउपडी	t͡sʰ ä u̯ p ʌ ɽ i
छाना	t͡sʰ ä̃ n ä
छान्नु	t͡sʰ ä̃ nː ũ
छिट्टो	t͡sʰ i ʈ̚ ʈ o
छिनो	t͡sʰ ĩ n o
छिमेकी	t͡sʰ ĩ m e k i
छेत्रिनी	t͡sʰ e t̪ r ĩ n ĩ
छैन	t͡s ʌ ĩ̯ n ʌ
छैनौ	t͡sʰ ʌ ĩ̯ n ʌ u̯
छोग्याल	t͡sʰ o ɡ j ä l
छोरा	t͡sʰ o ɾ ä
छोरी	t͡sʰ o ɾ i
छोरो	t͡sʰ o ɾ o
छोल्नु	t͡sʰ o l n ũ
जङ्गल	d͡z ʌ̃ ŋ ɡ ʌ l
जनकपुर	d͡z ʌ̃ n ʌ k̚ p u r
जनसंख्या	d͡z ʌ̃ n ʌ̃ s ʌ̃ ŋ kʰ j ä
जनसङ्ख्या	d͡z ʌ̃ n ʌ̃ s ʌ̃ ŋ kʰ j ä
जना	d͡z ʌ̃ n ä
जनावर	d͡z ʌ̃ n ä w ʌ r
जन्मदिन	d͡z ʌ̃ n m ʌ d̪ ĩ n ʌ
जम्मा	d͡z ʌ̃ mː ä
जरो	d͡z ʌ ɾ o
जर्मनी	d͡z ʌ r m ʌ̃ n ĩ
जसमा	d͡z ʌ s m ä
जसलाई	d͡z ʌ s l ä i̯
जहाँ	d͡z ä̃
जहाँ	d͡z ä̆ ɦ ä̤̃
जहाज	d͡z ä̆ ɦ ä̤ d͡z
जाँच्नु	d͡z ä̃ t͡s n ũ
जाँठो	d͡z ä̃ ʈʰ o
जाडो	d͡z ä ɽ o
जाति	d͡z ä t̪ i
जानु	d͡z ä̃ n ũ
जामुनी	d͡z ä̃ m ũ n ĩ
जिउनु	d͡z i ũ̯ n ũ
जिल्ला	d͡z i l l ä
जीवनी	d͡z i b ʌ̃ n ĩ
जुत्ता	d͡z u t̪̚ t̪ ä
जुन	d͡z ũ n
जेठानी	d͡z e ʈʰ ä̃ n ĩ
जेब्रा	d͡z e b r ä
ज्ञान	ɡ j ä̃ n
झ	d͡zʱ ʌ̤
झरी	d͡zʱ ʌ̤ ɾ i
झाँट	d͡zʱ ä̤̃ ʈ
झाक्री	d͡zʱ ä̤ k r i
झाडु	d͡zʱ ä̤ ɽ u
झोला	d͡zʱ o̤ l ä
झ्याल	d͡zʱ j ä l
टाउको	ʈ ä u̯ k o
टाढा	ʈ ä ɽ ä
टीका	ʈ i k ä
टोक्नु	ʈ o k n ũ
ट्याक्सी	ʈ j ä k s i
ठकुरी	ʈʰ ʌ k u ɾ i
ठन्कनु	ʈʰ ʌ̃ n k ʌ̃ n ũ
ठन्काउनु	ʈʰ ʌ̃ n k ä u̯ n ũ
ठाउँ	ʈʰ ä ũ̯
ठोक्नु	ʈʰ o k n ũ
डराउनु	ɖ ʌ ɾ ä u̯ n ũ
डाक्टर	ɖ ä k̚ ʈ ʌ r
डाक्टर	ɖ ʌ k̚ ʈ ʌ r
डाक्टरी	ɖ ä k̚ ʈ ʌ ɾ i
डुङ्गा	ɖ ũ ŋ ɡ ä
डुल्नु	ɖ u l n ũ
डेनमार्क	ɖ ẽ n m ä r k
ढ	ɖʱ ʌ̤
ढाक्नु	ɖʱ ä̤ k n ũ
ढिँडो	ɖʱ ĩ ɽ o
ढिलो	ɖʱ i̤ l o
ढोका	ɖʱ o̤ k ä
ण	ɽ̃ ʌ
ण	ʌ̃ ɽ̃ ʌ
तँमा	t̪ ʌ̃ m ä
तँलाई	t̪ ʌ̃ l ä i̯
तथा	t̪ ʌ t̪ʰ ä
तथापि	t̪ ʌ t̪ʰ ä p i
तन्ना	t̪ ʌ̃ nː ä
तपाईं	t̪ ʌ p ä ĩ̯
तपाईंको	t̪ ʌ p ä ĩ̯ k o
तपाईंमा	t̪ ʌ p ä ĩ̯ m ä
तपाईंलाई	t̪ ʌ p ä ĩ̯ l ä i̯
तपाईंले	t̪ ʌ p ä ĩ̯ l e
तर	t̪ ʌ ɾ ʌ
तरकारी	t̪ ʌ r k ä ɾ i
तातो	t̪ ä t̪ o
ताप	t̪ ä p
तापक्रम	t̪ ä p̚ k r ʌ̃ m
तारा	t̪ ä ɾ ä
ताल	t̪ ä l
तास	t̪ ä s
तिक्का	t̪ i k̚ k ä
तिब्बत	t̪ i b̚ b ʌ t̪
तिमि	t̪ ĩ m ĩ
तिमी	t̪ ĩ m ĩ
तिमीमा	t̪ ĩ m ĩ m ä
तिमीलाई	t̪ ĩ m ĩ l ä i̯
तिमीले	t̪ ĩ m ĩ l e
तिम्रो	t̪ ĩ m r o
तिर	t̪ i ɾ ʌ
तिरत्तर	t̪ i ɾ ʌ t̪̚ t̪ ʌ r
तिरानब्बे	t̪ i ɾ ä̃ n ʌ b̚ b e
तिरासी	t̪ i ɾ ä s i
तिर्चालिस	t̪ i r t͡s ä l i s
तिर्नु	t̪ i r n ũ
तिर्पन्न	t̪ i r p ʌ̃ nː ʌ
तिहार	t̪ i j ä r
तीन	t̪ ĩ n
तुतुरो	t̪ u t̪ u ɾ o
तुरी	t̪ u ɾ i
तेजारत	t̪ e d͡z ä ɾ ʌ t̪
तेत्तीस	t̪ e t̪̚ t̪ i s
तेरो	t̪ e ɾ o
तेह्र	t̪ e ɾ ʌ
त्यसको	t̪ e s k o
त्यसमा	t̪ e s m ä
त्यसलाई	t̪ e s l ä i̯
त्यसले	t̪ e s l e
त्यहाँ	t̪ j ä̃
त्यहाँ	t̪ j ä̆ ɦ ä̤̃
त्रिचालीस	t̪ r i t͡s ä l i s
त्रिपन्न	t̪ r i p ʌ̃ nː ʌ
त्रियासी	t̪ r i j ä s i
त्रिसट्ठी	t̪ r i s ʌ ʈ̚ ʈʰ i
थापा	t̪ʰ ä p ä
थाल	t̪ʰ ä l
थाह	t̪ʰ ä ɦ ä̆
थाहा	t̪ʰ ä ɦ ä
थुक्नु	t̪ʰ u k n ũ
थुरी	t̪ʰ u ɾ i
दक्षिण	d̪ ʌ k̚ kʰ ĩ n , d̪ ʌ k t͡sʰ ĩ ɽ
दक्षिण	d̪ ʌ k̚ t͡sʰʲ i ɽ̃
दगुर्नु	d̪ ʌ ɡ u r n ũ
दाँज्नु	d̪ ä̃ d͡z n ũ
दाँत	d̪ ä̃ t̪
दाइ	d̪ ä i̯
दाई	d̪ ä i̯
दाजु	d̪ ä d͡z u
दाना	d̪ ä̃ n ä
दार्जिलिङ	d̪ ä r d͡z i l ĩ ŋ
दिन	d̪ ĩ n ʌ
दिनु	d̪ ĩ n ũ
दुक्का	d̪ u k̚ k ä
दुखी	d̪ u k̞ʰ i
दुख्नु	d̪ u k̞ʰ n ũ
दुध	d̪ u d̪
दुश्मन	d̪ u s m ʌ̃ n
दूध	d̪ u d̪
देखाउनु	d̪ e k̞ʰ ä u̯ n ũ
देखि	d̪ e k̞ʰ i
देख्नु	d̪ e k̞ʰ n ũ
देवनागरी	d̪ e b ʌ̃ n ä ɡ ʌ ɾ i
दोकान	d̪ o k ä̃ n
दौडनु	d̪ ʌ u̯ ɽ ʌ̃ n ũ
ध	d̪ʱ ʌ̤
धनगढी	d̪ʱ ʌ̤̃ n ɡ ʌ ɽ i
धन्यवाद	d̪ʱ ʌ̤̃ nː e b ä d̪
धरान	d̪ʱ ʌ̤ ɾ ä̃ n
धर्म	d̪ʱ ʌ̤ r m ʌ
धुनु	d̪ʱ ṳ̃ n ũ
ध्वासे	d̪ʱ w ä s e
नक्सा	n ʌ k s ä
नगर	n ʌ ɡ ʌ ɾ ʌ
नजिक	n ʌ̃ d͡z i k
नदी	n ʌ̃ d̪ i
नब्बे	n ʌ b̚ b e
नमस्कार	n ʌ̃ m ʌ s k ä r
नमस्ते	n ʌ̃ m ʌ s t̪ e
नयाँ	n ʌ j ä̃
नराम्रो	n ʌ ɾ ä̃ m r o
नाइटो	n ä i̯ ʈ o
नाच	n ä̃ t͡s ʌ
नाच्नु	n ä̃ t͡s n ũ
नानी	n ä̃ n ĩ
नाम	n ä̃ m
नि	n ĩ
निद्रा	n ĩ d̪ r ä
निम्ति	n ĩ m t̪ i
निर्माण	n ĩ r m ä ɽ̃
निलो	n ĩ l o
निस्कनु	n ĩ s k ʌ̃ n ũ
नील	n ĩ l
नीलो	n ĩ l o
नुन	n ũ n
नेपाल	n e p ä l
नेपालको	n e p ä l k o
नेपालगंज	n e p ä l ɡ ʌ̃ n̻ d͡z
नेपालगञ्ज	n e p ä l ɡ ʌ̃ n̻ d͡z
नेपाली	n e p ä l i
नैनु	n ʌ ĩ̯ n ũ
न्यानो	n j ä̃ n o
पंजा	p ʌ̃ n̻ d͡z ä
पकाउनु	p ʌ k ä u̯ n ũ
पकौडा	p ʌ k ʌ u̯ ɽ ä
पक्का	p ʌ k̚ k ä
पखाला	p ʌ k̞ʰ ä l ä
पचत्तर	p ʌ t͡s ʌ t̪̚ t̪ ʌ r
पचपन्न	p ʌ t͡s p ʌ̃ nː ʌ
पचहत्तर	p ʌ t͡s ʌ ɦ ʌ t̪̚ t̪ ʌ r
पचास	p ʌ t͡s ä s
पचासी	p ʌ t͡s ä s i
पच्चीस	p ʌ t̚ t͡s i s
पढ	p ʌ ɽ ʌ
पढाउनु	p ʌ ɽ ä u̯ n ũ
पढ्	p ʌ ɽ
पढ्नु	p ʌ ɽ ɳ ũ
पढ्नुहोस्	p ʌ ɽ ɳ ũ ɦ o s
पत्रिका	p ʌ t̪ r i k ä
पनि	p ʌ̃ n ĩ
पन्चानब्बे	p ʌ̃ n̻ t͡s ä̃ n ʌ b̚ b e
पन्जा	p ʌ̃ n̻ d͡z ä
पन्द्र	p ʌ̃ n̪ d̪ r ʌ
पन्ध्र	p ʌ̃ n̪ d̪ʱ r ʌ
परासी	p ʌ ɾ ä s i
परिचय	p ʌ ɾ i t͡s e
परिचय	p ʌ ɾ i t͡s ʌ e̞
परिबार	p ʌ ɾ i b ä r
परिवार	p ʌ ɾ i w ä r
परीक्षा	p ʌ ɾ i k̚ t͡sʰʲ ä
परेली	p ʌ ɾ e l i
पर्खनु	p ʌ r kʰ ʌ̃ n ũ
पश्चिम	p ʌ s t͡s ĩ m
पस्नु	p ʌ s n ũ
पहाड	p ä̆ ɦ ä̤ ɖ
पहिला	p ʌ i̯ l ä
पहिले	p ʌ i̯ l e
पहिलो	p ʌ i̯ l o
पाँच	p ä̃ t͡s
पाक्नु	p ä k n ũ
पाखुरा	p ä k̞ʰ u ɾ ä
पाठ	p ä ʈʰ
पात	p ä t̪
पान	p ä̃ n
पानी	p ä̃ n ĩ
पाहुना	p ä u̯ n ä
पिउनु	p i ũ̯ n ũ
पिट्नु	p i ʈ ɳ ũ
पिपीलिका	p i p i l i k ä
पिरो	p i ɾ o
पुग्नु	p u ɡ n ũ
पुनः	p ũ n ʌ ɦ ʌ
पुरातत्त्वशास्त्र	p u ɾ ä t̪ ʌ t̪̚ t̪ o s ä s t̪ r ʌ
पुरानो	p u ɾ ä̃ n o
पुस्तकालय	p u s t̪ ʌ k ä l ʌ e̞
पूर्व	p u rː o
पृथ्वी	p ɾ i t̪ʰ b i
पृथ्वी	p ɾ i t̪ʰ i b i
पृष्ठ	p ɾ i s̠ t̠ʰ ʌ
पैँचालीस	p ʌ̃ i̯ t͡s ä l i s
पैंतालीस	p ʌ̃ i̯ t̪ ä l i s
पैंसट्ठी	p ʌ̃ i̯ s ʌ ʈ̚ ʈʰ i
पैसा	p ʌ i̯ s ä
पोखरा	p o k̞ʰ ʌ ɾ ä
पौने	p ʌ ũ̯ n e
प्यारो	p j ä ɾ o
प्रकाशाणु	p r ʌ k ä s ä ɽ̃ u
प्रकृति	p r ʌ k ɾ i t̪ i
प्रत्यक्ष	p r ʌ t̪ t̪ e k̚ t͡sʰʲ ʌ
प्रत्यक्ष	p r ʌ t̪ ʌ k̚ t͡sʰʲ ʌ
प्रबिधि	p r ʌ b i d̪ i
प्रमुख	p r ʌ̃ m ũ kʰ
प्रयोगकर्ता	p r ʌ j o ɡ k ʌ r t̪ ä
प्रविधि	p r ʌ b i d̪ i
प्रश्नहरू	p r ʌ s n ʌ ɦ ʌ ɾ u
प्रहरी	p r ʌ ɦ ʌ ɾ i
प्राय	p r ä e̞
प्राय	p r ä j ʌ
प्रेम	p r ẽ m
फरक	pʰ ʌ ɾ ʌ k
फेब्रुअरी	pʰ e b r u ʌ ɾ i
फेरि	pʰ e ɾ i
फेर्नु	pʰ e r n ũ
फ्याँक्नु	pʰ j ä̃ k n ũ
बच्चा	b ʌ t̚ t͡s ä
बजाउनु	b ʌ d͡z ä u̯ n ũ
बजार	b ʌ d͡z ä r
बत्तीस	b ʌ t̪̚ t̪ i s
बदाम्	b ʌ d̪ ä̃ m
बदाम्	b ʌ d̪ ʌ̃ m
बन्द	b ʌ̃ n̪ d̪ ʌ
बयानब्बे	b ʌ j ä̃ n ʌ b̚ b e
बयालीस	b ʌ j ä l i s
बयासी	b ʌ j ä s i
बरफ	b ʌ ɾ ʌ ɸ
बर्खा	b ʌ r kʰ ä
बसन्त	b ʌ s ʌ̃ n̪ t̪ ʌ
बस्नु	b ʌ s n ũ
बहत्तर	b ʌ ɦ ʌ t̪̚ t̪ ʌ r
बहिनी	b ʌ i̯ n ĩ
बहिनी	b ʌ ĩ̯ n ĩ
बा	b ä
बाईस	b ä i̯ s
बाउन्न	b ä u̯ nː ʌ
बाकस	b ä k ʌ s
बाख्रा	b ä k̞ʰ r ä
बाघ	b ä ɡ̞
बाथ	b ä t̪ʰ
बादल	b ä d̪ ʌ l
बादशाह	b ä d̪ s ä ɦ ä̆
बाबु	b ä b u
बारेमा	b ä ɾ ẽ m ä
बाहुन	b ä u̯ n
बाह्र	b ä ɾ ʌ
बिकास	b i k ä s
बिज्ञान	b i ɡ j ä̃ n
बिदा	b i d̪ ä
बिपना	b i p ʌ̃ n ä
बिबाह	b i b ä ɦ ä̆
बिभिन्न	b i β ĩ nː ʌ
बियर	b i e̞ r
बियर	b i j ʌ ɾ
बिराटनगर	b i ɾ ä ʈ ɳ ʌ ɡ ʌ r
बिरामी	b i ɾ ä̃ m ĩ
बिरालो	b i ɾ ä l o
बिसौनी	b i s ʌ ũ̯ n ĩ
बिस्तारै	b i s t̪ ä ɾ ʌ i̯
बिस्तारो	b i s t̪ ä ɾ o
बिहा	b i j ä
बिहान	b i j ä̃ n ʌ
बिहिबार	b i ɦ i b ä r
बिहीबार	b i ɦ i b ä r
बुझ्नु	b u d͡z n ũ
बुढो	b u ɽ o
बुद्ध	b u d̪̚ d̪ʱ ʌ̤
बुद्धिचाल	b u d̪̚ d̪ʱ i̤ t͡s ä l
बुधबार	b u d̪ ʌ b ä r
बुबा	b u b ä
बुवा	b u w ä
बेइजिङ	b e i̯ d͡z ĩ ŋ
बेलुका	b e l u k ä
बैंक	b ʌ ĩ̯ ŋ k
बैंक	b ẽ ŋ k
बैजनी	b ʌ i̯ d͡z ʌ̃ n ĩ
बैसट्ठी	b ʌ i̯ s ʌ ʈ̚ ʈʰ i
बोका	b o k ä
ब्रह्मदेश	b r ʌ mː ʌ d̪ e s
ब्रह्माण्ड	b r ʌ mː ä̃ ɳ ɖ ʌ
ब्वाँसो	b w ä̃ s o
भ	bʱ ʌ̤
भक्तपुर	bʱ ʌ̤ k̚ t̪ ʌ p u r
भने	bʱ ʌ̤̃ n e
भनेर	bʱ ʌ̤̃ n e ɾ ʌ
भन्दा	bʱ ʌ̤̃ n̪ d̪ ä
भन्नु	bʱ ʌ̤̃ nː ũ
भरतपुर	bʱ ʌ̤ ɾ ʌ t̪̚ p u r
भाँच्नु	bʱ ä̤̃ t͡s n ũ
भाइ	bʱ ä̤ i̯
भाडा	bʱ ä̤ ɽ ä
भारत	bʱ ä̤ ɾ ʌ t̪
भालू	bʱ ä̤ l u
भाषा	bʱ ä̤ s ä
भिजेको	bʱ i̤ d͡z e k o
भिडियो	bʱ i̤ ɽ i j o
भिसा	bʱ i̤ s ä
भीर	bʱ i̤ r
भुइँ	bʱ ʌ̤̃ i̯
भुइँ	bʱ ṳ ĩ
भुइँचालो	bʱ ṳ ĩ t͡s ä l o
भुटान	bʱ ṳ ʈ ä̃ n
भुत्रो	bʱ ṳ t̪ r o
भूकम्प	bʱ ṳ k ʌ̃ m p ʌ
भूगोल	bʱ ṳ ɡ o l
भेट्नु	bʱ e̤ ʈ ɳ ũ
भैँसी	bʱ ʌ̤̃ i̯ s i
भैंसी	bʱ ʌ̤̃ i̯ s i
भोक	bʱ o̤ k
भोलि	bʱ o̤ l i
मङ्गलबार	m ʌ̃ ŋ ɡ ʌ l b ä r
मजेन्टा	m ʌ̃ d͡z ẽ ɳ ʈ ä
मन	m ʌ̃ n
मन्त्री	m ʌ̃ n̪ t̪ r i
मम	m ʌ̃ m ʌ
ममा	m ʌ̃ m ä
मराठी	m ʌ ɾ ä ʈʰ i
मरुभूमि	m ʌ ɾ u β ũ m ĩ
मर्नु	m ʌ r n ũ
मलाई	m ʌ l ä i̯
महिना	m ʌ i̯ n ä
महिला	m ʌ i̯ l ä
मा	m ä
माचिक्नी	m ä̃ t͡s i k n ĩ
माछा	m ä̃ t͡sʰ ä
माझ्नु	m ä̃ d͡z n ũ
मानिस	m ä̃ n ĩ s
माने	m ä̃ n e
मान्छे	m ä̃ n̻ t͡sʰ e
माफ	m ä ɸ
मार्ग	m ä r ɡ ʌ
मार्नु	m ä r n ũ
माला	m ä l ä
मासु	m ä s u
मिठो	m ĩ ʈʰ o
मिति	m ĩ t̪ i
मित्र	m ĩ t̪ r ʌ
मिनेट	m ĩ n e ʈ
मिस्सी	m ĩ sː i
मुख	m ũ kʰ
मुख्य	m ũ kʰ e
मुजी	m ũ d͡z i
मुटु	m ũ ʈ u
मुद्रा	m ũ d̪ r ä
मूल	m ũ l
मेरो	m e ɾ o
मोजा	m o d͡z ä
मोटरसाइकल	m o ʈ ʌ r s ä i̯ k ʌ l
मोड्नु	m o ɽ ɳ ũ
मौरी	m ʌ u̯ ɾ i
मौसम	m ʌ u̯ s ʌ̃ m
म्वाइँ	m w ä ĩ̯
यदि	e d̪ i
यस	e s
यसको	e s k o
यसमा	e s m ä
यसलाई	e s l ä i̯
यसले	e s l e
यसै	e s ʌ i̯
यहाँ	j ä̃
यहाँ	j ä̃ː
यहाँ	j ä̆ ɦ ä̤̃
यहाँ	ɦ j ä̃
यहाँको	j ä̆ ɦ ä̤̃ k o
यहाँमा	j ä̆ ɦ ä̤̃ m ä
यहाँलाई	j ä̆ ɦ ä̤̃ l ä i̯
यहाँले	j ä̆ ɦ ä̤̃ l e
यही	e i̯
या	j ä
यातायात	j ä t̪ ä j ä t̪
यानाति	j ä̃ n ä̃ t̪ i
यी	i
यूरोप	j u ɾ o p
योगदान	j o ɡ d̪ ä̃ n
योगदानहरू	j o ɡ d̪ ä̃ n ɦ ʌ ɾ u
रंडी	r ʌ̃ ɳ ɖ i
रक्सी	r ɒ k s i
रङ	r ʌ̃ ŋ
रङ्ग	r ʌ̃ ŋ
रङ्ग	r ʌ̃ ŋ ɡ ʌ
रङ्गीचङ्गी	r ʌ̃ ŋ ɡ i t͡s ʌ̃ ŋ ɡ i
रचना	r ʌ t͡s ʌ̃ n ä
रच्नु	r ʌ t͡s n ũ
रण्डी	r ʌ̃ ɳ ɖ i
रत्न	r ʌ t̪ n̪ ʌ
रन्डी	r ʌ̃ ɳ ɖ i
रमाइलो	r ʌ̃ m ä i̯ l o
रहनु	r ʌ ɦ ʌ̃ n ũ
राँबो	r ä̃ b o
राख्नु	r ä k̞ʰ n ũ
राजधानी	r ä d͡z d̪ʱ ä̤̃ n ĩ
राजा	r ä d͡z ä
रात	r ä t̪
राति	r ä t̪ i
रातो	r ä t̪ o
रामो	r ä̃ m o
राम्रो	r ä̃ m r o
राष्ट्र	r ä s̠ t̠ r ʌ
राष्ट्रपति	r ä s̠ t̠ r ʌ p ʌ t̪ i
रित्तो	r i t̪̚ t̪ o
रुख	r u k̞ʰ
रुनु	r ũ n ũ
रुपियाँ	r u p i j ä̃
रोक्नु	r o k n ũ
रोपनी	r o p ʌ̃ n ĩ
लक्ष्मी	l ʌ k s m ĩ
लक्ष्मी	l ʌ k̚ t͡sʰʲ m ĩ
लक्ष्मी	l ʌ t̚ t͡sʰ ĩ m ĩ
लगाउनु	l ʌ ɡ ä u̯ n ũ
लगानी	l ʌ ɡ ä̃ n ĩ
लघ्वातु	l ʌ ɡ̞ b ä t̪ u
लड्नु	l ʌ ɽ ɳ ũ
लसुन	l ʌ s ũ n
लाई	l ä i̯
लाउनु	l ä u̯ n ũ
लाख	l ä k̞ʰ
लागि	l ä ɡ i
लाग्नु	l ä ɡ n ũ
लाडो	l ä ɽ o
लामा	l ä̃ m ä
लामो	l ä̃ m o
लिनु	l ĩ n ũ
लुकाउनु	l u k ä u̯ n ũ
लुक्नु	l u k n ũ
लुगा	l u ɡ ä
लुम्बिनी	l ũ m b ĩ n ĩ
लेख	l e k̞ʰ
लेख	l e k̞ʰ ʌ
लेखहरू	l e k̞ʰ ɦ ʌ ɾ u
लेखिएको	l e k̞ʰ i e k o
लेखिनु	l e k̞ʰ ĩ n ũ
लेख्	l e k̞ʰ
लेख्न	l e k̞ʰ n ʌ
लेख्नु	l e k̞ʰ n ũ
लैङ्गिक	l ʌ ĩ̯ ŋ ɡ i k
वटा	o ʈ ä
वटा	w ʌ ʈ ä
वर्णमाला	b ʌ r n ʌ̃ m ä l ä
वर्णमाला	b ʌ r ɽ̃ ʌ̃ m ä l ä
वर्षा	b ʌ r s ä
वसन्त	b ʌ s ʌ̃ n̪ t̪ ʌ
वहाँ	w ä̃
वहाँ	w ä̆ ɦ ä̤̃
वहाँ	ɦ w ä̃
वहाँको	w ä̆ ɦ ä̤̃ k o
वहाँमा	w ä̆ ɦ ä̤̃ m ä
वहाँलाई	w ä̆ ɦ ä̤̃ l ä i̯
वहाँले	w ä̆ ɦ ä̤̃ l e
वाक्य	w ä k k e
वार्ता	b ä r t̪ ä
वार्तालाप	b ä r t̪ ä l ä p
विकास	b i k ä s
विकिपीडिया	w i k i p i ɽ i j ä
विजयादशमी	b i d͡z ʌ j ä d̪ ʌ s ʌ̃ m ĩ
विज्ञान	b i ɡ j ä̃ n
विडूर	b i ɽ u r
विद्यार्थी	b i d̪ j ä r t̪ʰ i
विभिन्न	b i β ĩ nː ʌ
विराटनगर	b i ɾ ä ʈ ɳ ʌ ɡ ʌ r
विवाह	b i b ä ɦ ä̆
विश्व	b i sː o
विषाणु	b i s ä ɽ̃ u
वृश्चिक	b ɾ i s t͡s i k
श	ʃ ʌ
शनिबार	s ʌ̃ n ĩ b ä r
शब्दकोश	s ʌ b̚ d̪ ʌ k o s
शब्दकोष	s ʌ b̚ d̪ ʌ k o s
शरद	s ʌ ɾ ʌ d̪
शान्त	s ä̃ n̪ t̪ ʌ
शास्त्र	s ä s t̪ r ʌ
शाह	s ä ɦ ä̆
शिक्षक	s i k̚ t͡sʰʲ ʌ k
शिक्षक	s i t̚ t͡sʲ ʌ k
शिक्षक	ʃ i k ʃ ʌ k
शिक्षा	s i k̚ t͡sʰʲ ä
शिक्षा	s i t̚ t͡sʰ j ä
शुक्रबार	s u k r ʌ b ä r
शुभ	s u β ʌ
शुभकामना	s u β ʌ k ä̃ m ʌ̃ n ä
शून्य	s ũ nː e
शून्य	s ũ nː ä
शौचालय	s ʌ u̯ t͡s ä l ʌ e̞
श्रावण	s r ä w ʌ ɽ̃
श्रेणी	s r e ɽ̃ i
श्रेष्ठ	s r e s̠ t̠ʰ ʌ
सँग	s ʌ̃ ŋ ɡ ʌ
संग	s ʌ̃ ŋ ɡ ʌ
संगति	s ʌ̃ ŋ ɡ ʌ t̪ i
संगीत	s ʌ̃ ŋ ɡ i t̪
संवाद	s ʌ̃ m b ä d̪
संस्कृत	s ʌ̃ n s k ɾ i t̪
संस्कृति	s ʌ̃ n s k ɾ i t̪ i
संस्कृति	s ʌ̃ s k ɾ i t̪ i
संस्था	s ʌ̃ n s t̪ʰ ä
सक्नु	s ʌ k n ũ
सक्नुहुन्छ	s ʌ k n ũ ɦ ũ n̻ t͡sʰ ʌ
सखर	s ʌ k̞ʰ ʌ r
सगरमाथा	s ʌ ɡ ʌ r m ä t̪ʰ ä
सङ्गति	s ʌ̃ ŋ ɡ ʌ t̪ i
सङ्गीत	s ʌ̃ ŋ ɡ i t̪
सड्सठ्ठी	s ʌ ɽ s ʌ ʈʰ ʈʰ i
सतचालीस	s ʌ t̪ t͡s ä l i s
सतसट्ठी	s ʌ t̪ ʌ s ʌ ʈ̚ ʈʰ i
सतहत्तर	s ʌ t̪ ʌ ɦ ʌ t̪̚ t̪ ʌ r
सत्तरी	s ʌ t̪̚ t̪ ʌ ɾ i
सत्ता	s ʌ t̪̚ t̪ ä
सत्ताईस	s ʌ t̪̚ t̪ ä i̯ s
सन्चै	s ʌ̃ n̻ t͡s ʌ i̯
सन्ताउन्न	s ʌ̃ n̪ t̪ ä u̯ nː ʌ
सन्तानब्बे	s ʌ̃ n̪ t̪ ä̃ n ʌ b̚ b e
सन्देश	s ʌ̃ n̪ d̪ e s
सन्सरबार्	s ʌ̃ n s ʌ ɾ ʌ b ä r
सपना	s ʌ p ʌ̃ n ä
सफा	s ʌ ɸ ä
समय	s ʌ̃ m ʌ e̞
समस्या	s ʌ̃ m ʌ s j ä
समस्याको	s ʌ̃ m ʌ s j ä k o
समाज	s ʌ̃ m ä̃ d͡z
समुद्र	s ʌ̃ m ũ d̪ r ʌ
समृद्ध	s ʌ̃ m ɾ i d̪̚ d̪ʱ ʌ̤
सम्पर्क	s ʌ̃ m p ʌ r k ʌ
सम्बन्धी	s ʌ̃ m b ʌ̃ n̪ d̪ʱ i̤
सम्म	s ʌ̃ mː ʌ
सय	s ʌ e̞
सरोज	s ʌ ɾ o d͡z
सहपाठी	s ʌ ɦ ʌ p ä ʈʰ i
सहायता	s ä̆ ɦ ä̤ e t̪ ä
सहि	s ʌ i̯
साँप	s ä̃ p
सांझ	s ä̃ d͡z
साइकल	s ä i̯ k ʌ l
साचो	s ä t͡s o
साट्नु	s ä ʈ ɳ ũ
साठी	s ä ʈʰ i
साढे	s ä ɽ e
सात	s ä t̪
साता	s ä t̪ ä
साथी	s ä t̪ʰ i
सानो	s ä̃ n o
साप	s ä p
सामान्य	s ä̃ m ä̃ nː e
सिंह	s ĩ ŋ ɦ ʌ
सिकाउनु	s i k ä u̯ n ũ
सिक्किम	s i k̚ k ĩ m
सिक्नु	s i k n ũ
सिपाही	s i p ä i̯
सिम्रिक	s ĩ m r i k
सिरानी	s i ɾ ä̃ n ĩ
सिसाकलम	s i s ä k ʌ l ʌ̃ m
सीपाही	s i p ä i̯
सुझाव	s u d͡z ä b
सुत्नु	s u t̪ n̪ u
सुन	s ũ n
सुन्तला	s ũ n̪ t̪ ʌ l ä
सुन्दर	s ũ n̪ d̪ ʌ r
सुन्ना	s ũ nː ä
सुन्नु	s ũ nː ũ
सुन्नुहोस्	s ũ nː ũ ɦ o s
सूर्य	s u rː e
सैंतालीस	s ʌ̃ i̯ t̪ ä l i s
सोधपुछ	s o d̪̚ p u t͡sʰ
सोध्नु	s o d̪ n̪ u
सोमबार	s õ m b ä r
सोमबार	s ʌ̃ u̯ b ä r
सोह्र	s o ɾ ʌ
स्याउ	s j ä u̯
स्वतन्त्र	s o t̪ ʌ̃ n̪ t̪ r ʌ
स्वागत	s w ä ɡ ʌ t̪
स्वादिलो	s w ä d̪ i l o
स्वास्नि	s w ä s n ĩ
हग्नु	ɦ ʌ ɡ n ũ
हजार	ɦ ʌ d͡z ä r
हप्ता	ɦ ʌ p̚ t̪ ä
हप्‍ता	ɦ ʌ p̚ t̪ ä
हरियो	ɦ ʌ ɾ i j o
हरेक	ɦ ʌ ɾ e k
हवाईजहाज	ɦ ʌ w ä i̯ d͡z ä̆ ɦ ä̤ d͡z
हस्कनु	ɦ ʌ s k ʌ̃ n ũ
हस्तमैथुन	ɦ ʌ s t̪ ʌ̃ m ʌ i̯ t̪ʰ ũ n
हाँक्नु	ɦ ä̃ k n ũ
हाँसो	ɦ ä̃ s o
हाँस्नु	ɦ ä̃ s n ũ
हाइड्रोजन	ɦ ä i̯ ɖ r o d͡z ʌ̃ n
हात	ɦ ä t̪
हात्ती	ɦ ä t̪̚ t̪ i
हामी	ɦ ä̃ m ĩ
हामीमा	ɦ ä̃ m ĩ m ä
हामीलाई	ɦ ä̃ m ĩ l ä i̯
हामीले	ɦ ä̃ m ĩ l e
हाम्रो	ɦ ä̃ m r o
हावा	ɦ ä w ä
हिँड्नु	ɦ ĩ ɽ ɳ ũ
हिन्दी	ɦ ĩ n̪ d̪ i
हिमाल	ɦ ĩ m ä l
हिमालय	ɦ ĩ m ä l ʌ e̞
हुकुम	ɦ u k ũ m
हुनु	ɦ ũ n ũ
हुनुहुन्छ	ɦ ũ n ũ ɦ ũ n̻ t͡sʰ ʌ
हुनुहुन्न	ɦ ũ n ũ ɦ ũ nː ʌ
हुनेछ	ɦ ũ n e t͡sʰ ʌ
हुन्छ	ɦ ũ n̻ t͡sʰ ʌ
हुन्छन्	ɦ ũ n̻ t͡sʰ ʌ̃ n
हृदय	ɾ i d̪ ʌ e̞
हेटौडा	ɦ e ʈ ʌ u̯ ɽ ä
हेर्नु	ɦ e r n ũ
हेर्नुहोस्	ɦ e r n ũ ɦ o s
होइन	ɦ o ĩ̯ n ʌ
होइनौ	ɦ o ĩ̯ n ʌ u̯
होईन	ɦ o ĩ̯ n ʌ
होला	ɦ o l ä
ह्रस्व	r ʌ sː o
