abessiiva	a p e s s i jː v a
ablatiiva	a pː l a tʰ i jː v a
abmet	a bː m e h t
abohtta	a p o hː t a
aborta	a p o r t a
aborteret	a p o r t eː r e h t
abskissa	a pː s k iː s s a
absorberet	a pː s o r p eː r e h t
abstrákta	a pː s t r aː k t a
addalit	a dː d a l i h t
adde	a dː d e
adderet	a dː d eː r e h t
addes	a dː d e s
addesis	a dː d e s i s
addet	a dː d e h t
addi	a dː d iː
addilit	a dː d iː l i h t
addit	a dː d iː h t
addišuvdna	a dː d iː ʃ u vː t n a
addjohit	a ɟː ɟ o h i h t
addjot	a ɟː ɟ o h t
addon	a dː d o n
addot	a dː d o h t
addu	a dː d uː
addáladdat	a dː d aː l a dː d a h t
addálas	a dː d aː l a s
addálasamus	a dː d aː l a s a m u s
addálasat	a dː d aː l a s a h t
addáleamos	a dː d aː l e̯ a m o s
addálit	a dː d aː l i h t
addámuš	a dː d aː m u ʃ
adessiiva	a t e s s i jː v a
adjektiiva	a ɟ ɟ e k t i jː v a
adjágas	a ɟ ɟ aː k a s
administratiiva	a tː m iː n i sː t r a tʰ i jː v a
administrašuvdna	a tː m iː n i sː t r a ʃ u vː t n a
administreret	a tː m iː n i sː t r eː r e h t
admirála	a tː m iː r aː l a
adni	a dː n iː
adnostit	a dː n o s t i h t
adnot	a dː n o h t
adopteret	a t o p t eː r e h t
adopšuvdna	a t o p ʃ u vː t n a
adreassa	a tː r e a̯ s s a
adresseret	a tː r e s s eː r e h t
adveanta	a tː v e a̯ n t a
advearba	a tː v e a̯ r p a
adverbiála	a tː v e r p i aː l a
advokáhta	a tː v o kʰ aː h t a
aforisma	a f o r i sː m a
afrihkká	a fː r iː hː k aː
afrihkálaš	a fː r iː h k aː l a ʃ
aggressiiva	a ɡː ɡ r e s s i jː v a
agi	a k iː
agis	a k iː s
agit	a k iː h t
agáiduvvat	a k aː j t u v v a h t
agálaččat	a k aː l a t t͡ʃ a h t
agálaš	a k aː l a ʃ
agálašvuohta	a k aː l a ʃː v u o̯ h t a
agás	a k aː s
ahccot	a hː t͡s o h t
ahccát	a hː t͡s aː h t
ahcit	a h t͡s iː h t
ahkahaš	a h k a h a ʃ
ahki	a h k iː
ahkidis	a h k iː t i s
ahkiduššat	a h k iː t u ʃ ʃ a h t
ahkit	a h k iː h t
ahkitvuohta	a h k iː t v u o̯ h t a
ahkkái	a hː k aː j
ahkkás	a hː k aː s
ahkáduvvat	a h k aː t u v v a h t
ahkásaš	a h k aː s a ʃ
ahkásii	a h k aː s i j
ahte	a h t e
aiddo	a jː t t o
aiddolaš	a jː t t o l a ʃ
aiddonassii	a jː t t o n a s s i j
aiddostahttit	a jː t t o s t a hː t iː h t
aiddostassii	a jː t t o s t a s s i j
aiget	a jː k e h t
ain	a j n
aisttan	a j s t a n
aitto	a j t t o
aivve	a j v v e
aivvefal	a j v v e f a l
aivvestassii	a j v v e s t a s s i j
aji	a j iː
ajihastit	a j iː h a sː t iː h t
ajihustit	a j iː h u sː t iː h t
ajihuvvat	a j iː h u v v a h t
akademalaš	a kʰ a t eː m a l a ʃ
akademihkar	a kʰ a t e m iː h k a r
akademiija	a kʰ a t e m i j j a
akkusatiiva	a k k uː s a tʰ i j v a
akselereret	a kː s e l e r eː r e h t
akta	a kː t a
aktiiva	a kː t i j v a
aktiivvalaččat	a kː t i j v v a l a t t͡ʃ a h t
aktiivvalaš	a kː t i j v v a l a ʃ
aktiveret	a kː t iː v eː r e h t
aktivitehta	a kː t iː v i tʰ eː h t a
akustihkalaš	a kʰ uː s t i h k a l a ʃ
akustihkka	a kʰ uː s t i hː k a
akšuvdna	a kː ʃ uː v t n a
ala	a l a
alarmeret	a l a r m eː r e h t
albbas	a lː p p a s
albma	a lː p m a
albmadit	a lː p m a t i h t
albmaduvvat	a lː p m a t u v v a h t
albmanit	a lː p m a n i h t
albmeassi	a lː p m e a s s iː
albmi	a lː p m iː
albmoneapmi	a lː p m o n e a̯ p m iː
albmudit	a lː p m uː t i h t
albmáimannan	a lː p m aː j m a n n a n
albánia	a lː p aː n i a
alde	a lː t e
aldi	a lː t iː
aldna	a lː t n a
ale	a l e
alfabehta	a lː f a p eː h t a
alfabehtalaš	a lː f a p eː h t a l a ʃ
algoritma	a lː k o r i tː m a
algŋa	a lː t ɲ a
aliheamos	a l iː h e̯ a m o s
alihit	a l iː h i h t
alimahtes	a l iː m a h t e s
alimas	a l iː m a s
alimus	a l iː m u s
alimusriekti	a l iː m u sː r i e̯ k t i
alit	a l iː h t
alitfális	a l iː t f aː l iː s
alitrássi	a l iː t r aː s s iː
alkohola	a lː k o h oː l a
alkoholaheapme	a lː k o h oː l a h e̯ a p m e
alkoholisma	a lː k o h o l iː s m a
alkoholista	a lː k o h o l iː s t a
alla	a l l a
alladávttat	a l l a t aː v t t a h t
alladávttálaš	a l l a t aː v t t aː l a ʃ
allalávlla	a l l a l aː v l l a
allamielalaš	a l l a m i e̯ l a l a ʃ
allamielalašvuohta	a l l a m i e̯ l a l a ʃː v u o̯ h t a
allaskuvla	a l l a s k u vː l a
allat	a l l a h t
allatiiva	a l l a tʰ i jː v a
allatvuohta	a l l a t v u o̯ h t a
allergiija	a l l e r k i j j a
allergiijalaš	a l l e r k i j j a l a ʃ
allet	a l l e h t
alli	a lː l iː
allodat	a l l o t a h t
allodatnjuiken	a l l o t a t ɲ u j k e n
allon	a l l o n
allos	a l l o s
alloset	a l l o s e h t
alloska	a l l o s k a
allot	a l l o h t
allu	a lː l uː
almmaiduvvat	a l m m a j t u v v a h t
almmenáhkki	a l m m e n aː hː k iː
almmivierca	a l m m iː v i e̯ rː t͡s a
almmolaččat	a l m m o l a t t͡ʃ a h t
almmolaš	a l m m o l a ʃ
almmolašvuohta	a l m m o l a ʃː v u o̯ h t a
almmostahttit	a l m m o s t a hː t iː h t
almmuheapmi	a l m m uː h e a̯ p m iː
almmuhit	a l m m uː h i h t
almmuhus	a l m m uː h u s
almmus	a l m m uː s
almmustahttit	a l m m uː s t a hː t iː h t
almmustit	a l m m uː s t i h t
almmá	a l m m aː
almmálaš	a l m m aː l a ʃ
almmáskit	a l m m aː s k i h t
alternatiiva	a lː t e r n a tʰ i j v a
altteson	a l t t e s o n
alumiidna	a l uː m i jː t n a
alva	a lː v a
alvvaheapme	a l v v a h e̯ a p m e
alvvahuvvat	a l v v a h u v v a h t
alvvaiduvvat	a l v v a j t u v v a h t
alvvalaš	a l v v a l a ʃ
alárbma	a l aː r p m a
amas	a m a s
amastit	a m a s t i h t
ambassáda	a mː p a s s aː t a
ambulánsa	a mː p uː l aː nː s a
amerihkká	a m e r i hː k aː
amiidit	a m i j t i h t
ammal	a m m a l
ampera	a mː p eː r a
amputeret	a mː p uː tʰ eː r e h t
analogiija	a n a l o k i j j a
analysa	a n a l y s a
analyseret	a n a l y s eː r e h t
anatomiija	a n a tʰ o m i j j a
ane	a n e
anemiija	a n e m i j j a
anihahtti	a n iː h a hː t iː
anihit	a n iː h i h t
anteanna	a nː t e a̯ n n a
antihkalaš	a nː t iː h k a l a ʃ
antihkka	a nː t iː hː k a
antimona	a nː t iː m oː n a
antologiija	a nː t o l o k i j j a
antárktis	a nː t aː r k t i s
anánas	a n aː n a s
anár	a n aː r
anáraš	a n aː r a ʃ
anárašgiella	a n aː r a ʃː k i e̯ l l a
anárjávri	a n aː r j aː vː r iː
apmaseamos	a p m a s e̯ a m o s
apmasit	a p m a s i h t
apoastal	a pʰ o ɑ̯ s t a l
apostal	a pʰ o s t a l
apostolalaš	a pʰ o s t o l a l a ʃ
apostovllalaš	a pʰ o s t o v l l a l a ʃ
apotehka	a pʰ o tʰ eː h k a
apotehkár	a pʰ o tʰ eː h k aː r
appellatiiva	a p p e l l a tʰ i j v a
appelsiidna	a p p e l s i jː t n a
appelsinsákta	a p p e l s i nː s aː k t a
arena	a r e n a
aresteret	a r e s t eː r e h t
arestet	a r e s t e h t
argon	a rː k o n
argumeanta	a rː k uː m e a̯ nː t a
argumenteret	a rː k uː m e nː t eː r e h t
aritmetihkka	a r iː t m e tʰ iː hː k a
arjepluovvi	a rː j e p l u o̯ v v iː
arkeologa	a rː k e o l oː k a
arkeologiija	a rː k e o l o k i j j a
arktalaš	a rː k t a l a ʃ
artihkal	a rː t iː h k a l
artista	a rː t iː s t a
arva	a rː v a
arvat	a rː v a h t
arvi	a rː v iː
arvit	a rː v iː h t
arvu	a rː v uː
arvvosmahttit	a r v v o s m a hː t iː h t
arvvosmit	a r v v o s m i h t
arvát	a rː v aː h t
arába	a r aː p a
arábagiella	a r aː p a k i e̯ l l a
aseheapme	a s e h e̯ a p m e
asi	a s iː
asis	a s iː s
asit	a s iː h t
aski	a sː k iː
aspárggus	a sː p aː r k k u s
assi	a s s iː
astan	a sː t a n
astat	a sː t a h t
aste	a sː t e
astet	a sː t e h t
asti	a sː t iː
astos	a sː t o s
astronávta	a sː t r o n aː vː t a
astta	a s t a
asttuheapme	a s t uː h e a̯ p m e
astu	a sː t uː
astut	a sː t uː h t
ateisma	a tʰ e j s m a
ateista	a tʰ e j s t a
atnin	a t n iː n
atnit	a t n iː h t
atnu	a t n uː
atte	a t t e
attestit	a t t e s t i h t
attribuhtta	a tː t r iː p u hː t a
automatiseren	a uː tʰ o m a tʰ i s eː r e n
automatiseret	a uː tʰ o m a tʰ i s eː r e h t
automašuvdna	a uː tʰ o m a ʃ u vː t n a
automáhtalaš	a uː tʰ o m aː h t a l a ʃ
automáhtta	a uː tʰ o m aː hː t a
autorisašuvdna	a uː tʰ o r iː s a ʃ uː v t n a
autoriseret	a uː tʰ o r iː s eː r e h t
autoritehta	a uː tʰ o r iː tʰ eː h t a
autoritára	a uː tʰ o r iː tʰ aː r a
ave	a v e
avi	a v iː
avii	a v i j
avis	a v iː s
avvi	a v v iː
avvi	a vː v iː
avvit	a v v iː h t
ađa	a ð a
ađadákti	a ð a t aː kː t iː
ađaheapme	a ð a h e̯ a p m e
ađahuvvat	a ð a h u v v a h t
ađaiduvvat	a ð a j t u v v a h t
ađđamahttá	a ð ð a m a hː t aː
ađđái	a ð ð aː j
badjel	p a ɟ ɟ e l
badjelahttu	p a ɟ ɟ e l a hː t uː
badji	p a ɟ ɟ iː
bagadeaddji	p a k a t e a̯ ɟː ɟ iː
bagadit	p a k a t i h t
baggat	p a ɡː ɡ a h t
bahta	p a h t a
bahá	p a h aː
bahámus	p a h aː m u s
bahás	p a h aː s
bahát	p a h aː h t
bahčit	p a h t͡ʃ iː h t
baika	p a jː k a
baikit	p a jː k iː h t
bajiloaidnu	p a j iː l o ɑ̯ jː t n uː
baján	p a j aː n
bakku	p a k k uː
bala	p a l a
balahahtti	p a l a h a hː t iː
balai	p a l a j
balan	p a l a n
balat	p a l a h t
baldalit	p a lː t a l i h t
balddihahtti	p a lː t t iː h a hː t iː
balde	p a lː t e
balden	p a lː t e n
baldi	p a lː t iː
baldit	p a lː t iː h t
baldu	p a lː t uː
baldá	p a lː t aː
ballalas	p a l l a l a s
ballan	p a l l a n
ballat	p a l l a h t
balle	p a l l e
ballen	p a l l e n
ballet	p a l l e h t
balli	p a lː l iː
ballon	p a l l o n
ballot	p a l l o h t
ballu	p a l l uː
ballu	p a lː l uː
ballun	p a l l uː n
ballát	p a lː l aː h t
balsa	p a lː s a
balu	p a l uː
baluheapme	p a l uː h e̯ a p m e
balus	p a l uː s
balut	p a l uː h t
balva	p a lː v a
balvan	p a lː v a n
banána	p a n aː n a
bardit	p a rː t iː h t
bargat	p a rː k a h t
barge	p a rː k e
bargen	p a rː k e n
bargu	p a rː k uː
barohkka	p a r o hː k a
barta	p a rː t a
barut	p a r uː h t
basadit	p a s a t i h t
basahat	p a s a h a h t
basahit	p a s a h i h t
basaldat	p a s a l t a h t
basastit	p a s a s t i h t
base	p a s e
basiheapme	p a s iː h e̯ a p m e
basii	p a s i j
bassat	p a s s a h t
basse	p a s s e
bassen	p a s s e n
basset	p a s s e h t
bassi	p a s s iː
bassi	p a sː s iː
bassit	p a s s iː h t
basson	p a s s o n
bassos	p a s s o s
bassot	p a s s o h t
baste	p a sː t e
basten	p a sː t e n
bastil	p a sː t iː l
bastit	p a sː t iː h t
basttoheapme	p a s t o h e̯ a p m e
basttálmit	p a s t aː l m i h t
batke	p a tː k e
bavhli	p a vː l̥ iː
bavssa	p a v s s a
beage	p e̯ a k e
beagán	p e a̯ k aː n
beahci	p e a̯ h t͡s iː
beahkit	p e a̯ h k iː h t
beahttit	p e a̯ hː t iː h t
beaiveloddi	p e̯ a jː v e l o dː d iː
beaivet	p e̯ a jː v e h t
beaivi	p e a̯ jː v iː
beaivit	p e a̯ jː v iː h t
beaivválaš	p e a̯ j v v aː l a ʃ
beaivváš	p e a̯ j v v aː ʃ
beaivvášgoddi	p e a̯ j v v aː ʃ k o dː d iː
bealdu	p e a̯ lː t uː
bealgi	p e a̯ lː k iː
bealjeheamos	p e̯ a ʎ ʎ e h e̯ a m o s
bealjeheapme	p e̯ a ʎ ʎ e h e̯ a p m e
bealjehisvuohta	p e̯ a ʎ ʎ e h i sː v u o̯ h t a
bealjehit	p e̯ a ʎ ʎ e h i h t
bealji	p e a̯ ʎ ʎ iː
bealkit	p e a̯ lː k iː h t
bealli	p e a̯ l l iː
beallji	p e a̯ ʎː ʎ iː
bealušteaddji	p e a̯ l uː ʃ t e a̯ ɟː ɟ iː
bealuštit	p e a̯ l uː ʃ t i h t
beana	p e a̯ n a
beanna	p e a̯ nː n a
bearal	p e a̯ r a l
bearaš	p e a̯ r a ʃ
beargalat	p e a̯ rː k a l a h t
bearjadat	p e a̯ rː j a t a h t
bearral	p e a̯ r r a l
bearrat	p e a̯ r r a h t
beaska	p e a̯ sː k a
beassat	p e a̯ s s a h t
beassi	p e a̯ s s iː
beassi	p e a̯ sː s iː
beasti	p e a̯ sː t iː
beastit	p e a̯ sː t iː h t
beavdi	p e a̯ vː t iː
beavrrehis	p e̯ a v r r e h i s
beavrrihis	p e a̯ v r r iː h i s
beavrrit	p e a̯ v r r iː h t
beađbi	p e a̯ ðː p iː
beađđat	p e a̯ ð ð a h t
beaŋka	p e a̯ ŋː k a
belko	p e lː k o
belohahkii	p eː l o h a h k i j
bensiidna	p e nː s i j t n a
beroštit	p eː r o ʃ t i h t
beroštupmi	p eː r o ʃ t u p m iː
beryllium	p e r y l l iː u m
beste	p eː sː t e
besten	p eː sː t e n
beston	p eː sː t o n
beđo	p eː ð o
beštor	p e ʃː t o r
bibliografiija	p i pː l iː o kː r a f i j j a
biblioteahka	p i pː l iː o tʰ e a̯ h k a
bibliotehka	p i pː l iː o tʰ eː h k a
biddi	p i dː d iː
biddu	p i dː d uː
bidjat	p i ɟ ɟ a h t
biebmat	p i e̯ bː m a h t
biebmu	p i e̯ bː m uː
biedju	p i e̯ ɟ ɟ uː
biegga	p i e̯ ɡː ɡ a
bieggat	p i e̯ ɡː ɡ a h t
biehkan	p i e̯ h k a n
biehtadit	p i e̯ h t a t i h t
biehtár	p i e̯ h t aː r
bielka	p i e̯ lː k a
bielkka	p i e̯ l k k a
biera	p i e̯ r a
bierdna	p i e̯ rː t n a
bierdni	p i e̯ rː t n iː
biergu	p i e̯ rː k uː
biertna	p i e̯ r t n a
biestit	p i e̯ sː t iː h t
bievval	p i e̯ v v a l
bieđgát	p i e̯ ðː k aː h t
bieđut	p i e̯ ð uː h t
bigge	p iː ɡː ɡ e
biggen	p iː ɡː ɡ e n
bihkka	p i hː k a
bihpar	p i h p a r
bihppor	p i hː p o r
bihttá	p i hː t aː
biibal	p i jː p a l
biibbal	p i jː p p a l
biigot	p i jː k o h t
biigá	p i jː k aː
biila	p i jː l a
biilačoavdda	p i jː l a t͡ʃ o ɑ̯ vː t t a
biipu	p i jː p uː
biise	p i jː s e
bikká	p i k k aː
bikte	p i kː t e
bikten	p i kː t e n
biktit	p i kː t iː h t
bikšut	p i kː ʃ uː h t
bilbut	p i lː p uː h t
bilda	p i lː t a
bilidit	p i l iː t i h t
bilkideaddji	p i lː k iː t e a̯ ɟː ɟ iː
bilkidit	p i lː k iː t i h t
bindut	p i nː t uː h t
binná	p i nː n aː
biologa	p i o l oː k a
biologiija	p i o l o k i j j a
bircu	p i rː t͡s uː
bircut	p i rː t͡s uː h t
biro	p i r o
birra	p i r r a
birrin	p i r r iː n
bispa	p i sː p a
bistit	p i sː t iː h t
bivaheapme	p i v a h e̯ a p m e
bivdit	p i vː t iː h t
bivgi	p i vː k iː
bivnnuheapme	p i v n n uː h e̯ a p m e
bivnnuhis	p i v n n uː h i s
bivnnut	p i v n n uː h t
bivval	p i v v a l
bivvalis	p i v v a l i s
bivvat	p i v v a h t
bivvát	p i v v aː h t
biđonsámegiella	p i ð o n s aˑ m e k i e̯ l l a
biŋal	p i ɲ a l
bleahkka	p l e a̯ hː k a
bláđet	p l aː ð e h t
bláđđi	p l aː ð ð iː
boadnji	p o ɑ̯ dː ɲ iː
boaggut	p o ɑ̯ ɡː ɡ uː h t
boagustit	p o ɑ̯ k uː s t i h t
boagán	p o ɑ̯ k aː n
boahtal	p o ɑ̯ h t a l
boahtin	p o ɑ̯ h t iː n
boahtit	p o ɑ̯ h t iː h t
boahtte	p o̯ ɑ hː t e
boahttevuohta	p o̯ ɑ hː t e v u o̯ h t a
boahtteáigi	p o̯ ɑ hː t e aː jː k iː
boaibmut	p o ɑ̯ jː p m uː h t
boalbut	p o ɑ̯ lː p uː h t
boaldit	p o ɑ̯ lː t iː h t
boanda	p o ɑ̯ nː t a
boandut	p o ɑ̯ nː t uː h t
boares	p o̯ ɑ r e s
boaris	p o ɑ̯ r iː s
boarti	p o ɑ̯ rː t iː
boaráseamos	p o ɑ̯ r aː s e̯ a m o s
boarásit	p o ɑ̯ r aː s i h t
boaski	p o ɑ̯ sː k iː
boasta	p o ɑ̯ sː t a
boatkanit	p o ɑ̯ tː k a n i h t
boazu	p o ɑ̯ t͡s uː
boađus	p o ɑ̯ ð uː s
boaššu	p o ɑ̯ ʃː ʃ uː
bodda	p o dː d a
boddu	p o dː d uː
bodni	p o dː n iː
bodnját	p o dː ɲ aː h t
bohcci	p o hː t͡s iː
bohccon	p oː hː t͡s o n
bohkat	p o h k a h t
bohkká	p o hː k aː
bohtal	p o h t a l
bohtanit	p o h t a n i h t
bohttu	p o hː t uː
bohtás	p o h t aː s
bohčit	p o h t͡ʃ iː h t
boija	p o j j a
boksa	p o kː s a
boksen	p o kː s e n
bokset	p o kː s e h t
bokte	p o kː t e
bokten	p o kː t e n
boktit	p o kː t iː h t
bolde	p oː lː t e
bolden	p oː lː t e n
boles	p o l e s
bolfát	p o lː f aː h t
bollu	p o lː l uː
bollát	p o lː l aː h t
bolto	p o lː t o
boltut	p o lː t uː h t
bomba	p o mː p a
bone	p o n e
bora	p o r a
bora	p oː r a
borahahtti	p o r a h a hː t iː
boran	p o r a n
boras	p o r a s
borde	p o rː t e
borden	p o rː t e n
bordet	p o rː t e h t
bordi	p o rː t iː
bordit	p o rː t iː h t
bordon	p o rː t o n
bordos	p o rː t o s
bordá	p o rː t aː
borga	p o rː k a
borgat	p o rː k a h t
borgemánnu	p o rː k e m aː n n uː
borgár	p o rː k aː r
borgárlaš	p o rː k aː r l a ʃ
borraba	p o r r a p a
borramuš	p o r r a m u ʃ
borran	p o r r a n
borrat	p o r r a h t
borre	p o r r e
borren	p o r r e n
borri	p o rː r iː
borrá	p o r r aː
boršut	p o rː ʃ uː h t
boso	p o s o
bosolit	p o s o l i h t
boson	p o s o n
bosso	p o s s o
bossu	p o s s uː
bossu	p o sː s uː
bossut	p o s s uː h t
bosun	p o s uː n
botnet	p o t n e h t
botnit	p o t n iː h t
botnjat	p o t ɲ a h t
breahtta	p r e a̯ hː t a
breava	p r e a̯ v a
brigáda	p r i k aː t a
brillat	p r i l l a h t
broma	p r oː m a
bronsa	p r o nː s a
bronsaáigi	p r o nː s a aː jː k iː
brugga	p r u ɡː ɡ a
brutto	p r u t t o
bruvda	p r u vː t a
bruvsa	p r u vː s a
bráhkka	p r aː hː k a
buddele	p u dː d e l e
buddet	p u dː d e h t
buffalo	p u f f a l o
buhtes	p u h t e s
buhtis	p u h t iː s
buhttáseamos	p u hː t aː s e̯ a m o s
buhttásit	p u hː t aː s i h t
buikku	p u j k k uː
buiku	p u jː k uː
buksa	p u kː s a
bukte	p u kː t e
bukten	p u kː t e n
buktit	p u kː t iː h t
buktu	p u kː t uː
buldu	p u lː t uː
buldut	p u lː t uː h t
buleš	p uː l e ʃ
bulki	p u lː k iː
bulle	p uː l l e
bullen	p uː l l e n
bullet	p uː l l e h t
bumbá	p u mː p aː
bumma	p u mː m a
buogu	p u o̯ k uː
buohcat	p u o̯ h t͡s a h t
buohcceviessu	p u̯ o hː t͡s e v i e̯ s s uː
buohcci	p u o̯ hː t͡s iː
buohccát	p u o̯ hː t͡s aː h t
buohkat	p u o̯ h k a h t
buoibmat	p u o̯ jː p m a h t
buoidda	p u o̯ jː t t a
buoiddat	p u o̯ jː t t a h t
buoiddeheapme	p u̯ o jː t t e h e̯ a p m e
buoiddes	p u̯ o jː t t e s
buoiddášit	p u o̯ jː t t aː ʃ i h t
buoidi	p u o̯ jː t iː
buoidivuohta	p u o̯ jː t iː v u o̯ h t a
buoidudit	p u o̯ jː t uː t i h t
buoidut	p u o̯ jː t uː h t
buokčat	p u o̯ kː t͡ʃ a h t
buole	p u̯ o l e
buollin	p u o̯ l l iː n
buollinolmmái	p u o̯ l l iː n o l m m aː j
buollinčáskadanbiila	p u o̯ l l iː n t͡ʃ aː sː k a ð a n p i j l a
buollit	p u o̯ l l iː h t
buolláhit	p u o̯ lː l aː h i h t
buollát	p u o̯ lː l aː h t
buolva	p u o̯ lː v a
buoremus	p u̯ o r e m u s
buoret	p u̯ o r e h t
buoridit	p u o̯ r iː t i h t
buorre	p u̯ o r r e
buorráneaddji	p u o̯ r r aː n e a̯ ɟː ɟ iː
buorránit	p u o̯ r r aː n i h t
buot	p u o̯ h t
buotnjut	p u o̯ t ɲ uː h t
buođgát	p u o̯ ðː k aː h t
buođđu	p u o̯ ð ð uː
buođđut	p u o̯ ð ð uː h t
bures	p uː r e s
burke	p u rː k e
burru	p u rː r uː
burrus	p u r r uː s
bursa	p u rː s a
busir	p u s iː r
busse	p u sː s e
bussá	p u sː s aː
butnjat	p u t ɲ a h t
buvda	p u vː t a
buvri	p u vː r iː
buvru	p u vː r uː
buvssat	p u v s s a h t
buvtta	p u v t t a
buđeita	p u ð e j t a
buđet	p u ð e h t
buškit	p u ʃː k iː h t
bušku	p u ʃː k uː
bábir	p aː p iː r
báddat	p aː dː d a h t
báffat	p aː f f a h t
bággu	p aː ɡː ɡ uː
báhcci	p aː hː t͡s iː
báhcet	p aː h t͡s e h t
báhcit	p aː h t͡s iː h t
báhkas	p aː h k a s
báhkka	p aː hː k a
báhkket	p aː hː k e h t
báhkki	p aː hː k iː
báhpu	p aː h p uː
báhčit	p aː h t͡ʃ iː h t
báidi	p aː jː t iː
báidnit	p aː jː t n iː h t
báiki	p aː jː k iː
báitit	p aː jː t iː h t
báitot	p aː jː t o h t
bájil	p aː j iː l
bákti	p aː kː t iː
bákŋat	p aː t ɲ a h t
bákŋi	p aː t ɲ iː
bálbma	p aː lː p m a
bálggis	p aː lː k k iː s
bálgán	p aː lː k aː n
bállit	p aː l l iː h t
bállu	p aː lː l uː
bálvalit	p aː lː v a l i h t
bámbu	p aː mː p uː
bánedoavttir	p aˑ n e t o ɑ̯ v t t iː r
bánis	p aː n iː s
bánno	p aː nː n o
bánžat	p aː nː t͡ʃ a h t
bára	p aː r a
báraheapme	p aː r a h e̯ a p m e
bárahisstávvalsátni	p aː r a h i sː s t aː v v a lː s aː t n i
báralaš	p aː r a l a ʃ
bárbmoloddi	p aˑ rː p m o l o dː d iː
bárbmu	p aː rː p m uː
bárdnat	p aː rː t n a h t
bárdnemánná	p aː rː t n e m aː n n aː
bárdni	p aː rː t n iː
bárgidit	p aː rː k iː t i h t
bárgut	p aː rː k uː h t
báron	p aː r o n
bárra	p aː r r a
bárrastávvalsátni	p aː r r a s t aː v v a l s aː t n iː
bárru	p aː r r uː
bárti	p aː rː t iː
bártni	p aː r t n iː
bárut	p aː r uː h t
báska	p aː sː k a
bássa	p aː sː s a
básár	p aː s aː r
bátnedoavttir	p aˑ t n e t o ɑ̯ v t t iː r
bátni	p aː t n iː
bávkit	p aː vː k iː h t
bávlos	p aː vː l o s
bávtat	p aː vː t a h t
báze	p aː t͡s e
bázzi	p aː dː d͡z iː
báŋka	p aː ŋː k a
báŋku	p aː ŋː k uː
cabbi	t͡s a bː b iː
cabbin	t͡s a bː b iː n
cadjat	t͡s a ɟ ɟ a h t
caga	t͡s a k a
cagai	t͡s a k a j
cagan	t͡s a k a n
cagat	t͡s a k a h t
caggat	t͡s a ɡː ɡ a h t
caggi	t͡s a ɡː ɡ iː
cahkat	t͡s a h k a h t
cahkkehit	t͡s a hː k e h i h t
cahkkát	t͡s a hː k aː h t
cahpat	t͡s a h p a h t
cahppát	t͡s a hː p aː h t
cappi	t͡s a p p iː
cappis	t͡s a p p iː s
ceaggát	t͡s e a̯ ɡː ɡ aː h t
ceahkki	t͡s e a̯ hː k iː
ceakkus	t͡s e a̯ k k uː s
cealkit	t͡s e a̯ lː k iː h t
cearki	t͡s e a̯ rː k iː
ceavvi	t͡s e a̯ v v iː
cegget	t͡s eː ɡː ɡ e h t
ceggoseamos	t͡s eː ɡː ɡ o s e̯ a m o s
ceggosit	t͡s eː ɡː ɡ o s i h t
cibmut	t͡s i bː m uː h t
cieggat	t͡s i e̯ ɡː ɡ a h t
ciellat	t͡s i e̯ l l a h t
cihrra	t͡s i r̥ r̥ a
ciiku	t͡s i jː k uː
cillat	t͡s i l l a h t
cinná	t͡s i nː n aː
cirgut	t͡s i rː k uː h t
cissat	t͡s i sː s a h t
cissen	t͡s i sː s e n
cisset	t͡s i sː s e h t
cizáš	t͡s i t͡s aː ʃ
coahki	t͡s o ɑ̯ h k iː
coakci	t͡s o ɑ̯ kː t͡s iː
coakcul	t͡s o ɑ̯ kː t͡s uː l
coakcut	t͡s o ɑ̯ kː t͡s uː h t
coggat	t͡s o ɡː ɡ a h t
cogge	t͡s o ɡː ɡ e
cuhllat	t͡s u l̥ l̥ a h t
cuhlli	t͡s u l̥ː l̥ iː
cuhpat	t͡s u h p a h t
cukcat	t͡s u kː t͡s a h t
culci	t͡s u lː t͡s iː
cullat	t͡s u l l a h t
cummá	t͡s u mː m aː
cummát	t͡s u mː m aː h t
cumpi	t͡s u mː p iː
cuohkki	t͡s u o̯ hː k iː
cuohppa	t͡s u o̯ hː p a
cuokca	t͡s u o̯ kː t͡s a
cuollat	t͡s u o̯ l l a h t
cuoppu	t͡s u o̯ p p uː
cuovcca	t͡s u o̯ v t t͡s a
cuovka	t͡s u o̯ vː k a
cuovkaneapmi	t͡s u o̯ vː k a n e a̯ p m iː
cuovkanit	t͡s u o̯ vː k a n i h t
cuozza	t͡s u o̯ dː d͡z a
cuoŋománnu	t͡s u̯ o ɲ o m aː n n uː
cuvket	t͡s uː vː k e h t
cuvkit	t͡s u vː k iː h t
cuvzat	t͡s u vː t͡s a h t
cábmit	t͡s aː bː m iː h t
cáhkit	t͡s aː h k iː h t
cáhkkat	t͡s aː hː k a h t
cáhpat	t͡s aː h p a h t
daddjot	t a ɟː ɟ o h t
dadjat	t a ɟ ɟ a h t
daga	t a k a
dagahit	t a k a h i h t
dagan	t a k a n
dagat	t a k a h t
dahje	t a j̥ e
dahjege	t a j̥ e k e
dahkat	t a h k a h t
dahkkot	t a hː k o h t
dahku	t a h k uː
dahppat	t a hː p a h t
dajaldat	t a j a l t a h t
dal	t a l
dalle	t a l l e
dami	t a m iː
danne	t a n n e
dapmi	t a p m iː
darfi	t a rː f iː
darjjesámegiella	t a r j j e s aˑ m e k i e̯ l l a
darvi	t a rː v iː
dasgo	t a sː k o
dassat	t a s s a h t
dassái	t a s s aː j
dat	t a h t
datni	t a t n iː
davi	t a v iː
davis	t a v iː s
davrát	t a vː r aː h t
davvenuorta	t a v v e n u o̯ rː t a
davvenuorti	t a v v e n u o̯ rː t iː
davveoarji	t a v v e o ɑ̯ rː j iː
davveriikkat	t a v v e r i j k k a h t
davveviesttar	t a v v e v i e̯ s t a r
davvi	t a v v iː
davviriikkat	t a v v iː r i j k k a h t
davvisámegiel	t a v v iː s aˑ m e k i e̯ l
davvisámegielat	t a v v iː s aˑ m e k i e̯ l a h t
davvisámegiella	t a v v iː s aː m e k i e̯ l l a
davás	t a v aː s
daŋas	t a ɲ a s
de	t e
deabbu	t e a̯ bː b uː
deabbut	t e a̯ bː b uː h t
deaddit	t e a̯ dː d iː h t
deaddu	t e a̯ dː d uː
deadja	t e a̯ ɟ ɟ a
deadjabaste	t e a̯ ɟ ɟ a p a sː t e
deadjasilli	t e a̯ ɟ ɟ a s i lː l iː
deaffat	t e a̯ f f a h t
deahkka	t e a̯ hː k a
deahkki	t e a̯ hː k iː
deaivat	t e a̯ jː v a h t
deaivu	t e a̯ jː v uː
deaivvadit	t e a̯ j v v a t i h t
deakčut	t e a̯ kː t͡ʃ uː h t
deallut	t e a̯ l l uː h t
dealo	t e̯ a l o
deapmat	t e a̯ p m a h t
dearbmi	t e a̯ rː p m iː
deardna	t e a̯ rː t n a
dearvašeamos	t e a̯ rː v a ʃ e̯ a m o s
dearvašit	t e a̯ rː v a ʃ i h t
dearvva	t e a̯ r v v a
dearvvaš	t e a̯ r v v a ʃ
dearvvuohta	t e a̯ r v v u o̯ h t a
deasta	t e a̯ sː t a
deasttaheapme	t e a̯ s t a h e̯ a p m e
deatnu	t e a̯ t n uː
deatte	t e̯ a t t e
deavdit	t e a̯ vː t iː h t
deaččalakkis	t e a̯ t t͡ʃ a l a k k iː s
deaššat	t e a̯ ʃ ʃ a h t
debbo	t eː bː b o
dego	t e k o
dehálaččamus	t e h aː l a t t͡ʃ a m u s
dehálaččat	t e h aː l a t t͡ʃ a h t
dehálaš	t e h aː l a ʃ
deháleamos	t e h aː l e̯ a m o s
dehálit	t e h aː l i h t
deike	t e jː k e
dello	t eː l l o
dellos	t eː l l o s
deret	t eː r e h t
devdot	t eː vː t o h t
dialoga	t i a l o k a
diddi	t i dː d iː
didjiide	t i ɟ ɟ i j t e
didnu	t i dː n uː
diehko	t i̯ e h k o
diehppi	t i e̯ hː p iː
diehtit	t i e̯ h t iː h t
diehtosátnegirji	t i̯ e h t o s aˑ t n e k i rː j iː
diehtu	t i e̯ h t uː
dieigi	t i e̯ jː k iː
dieigu	t i e̯ jː k uː
dieigut	t i e̯ jː k uː h t
dielku	t i e̯ lː k uː
dieno	t i̯ e n o
dieppe	t i̯ e p p e
dierbbes	t i̯ e rː p p e s
dierbi	t i e̯ rː p iː
dierbut	t i e̯ rː p uː h t
diet	t i e̯ h t
dietnut	t i e̯ t n uː h t
dievas	t i e̯ v a s
dievasmahttit	t i e̯ v a s m a hː t iː h t
dievddu	t i e̯ vː t t uː
dievdu	t i e̯ vː t uː
dievvaseamos	t i e̯ v v a s e̯ a m o s
dievvasit	t i e̯ v v a s i h t
dievvat	t i e̯ v v a h t
dievvá	t i e̯ v v aː
dieđa	t i e̯ ð a
diggi	t i ɡː ɡ iː
diggot	t i ɡː ɡ o h t
dihkkat	t i hː k a h t
dihkki	t i hː k iː
dihte	t i h t e
dihton	t iː h t o n
dihtor	t iː h t o r
dii	t i j
diibmu	t i jː p m uː
diibmá	t i jː p m aː
diila	t i jː l a
diksu	t i kː s uː
dikta	t i kː t a
diktit	t i kː t iː h t
dikŋa	t i t ɲ a
dikšu	t i kː ʃ uː
dikšut	t i kː ʃ uː h t
dilli	t i l l iː
dilljá	t i ʎː ʎ aː
din	t iː n
dinguin	t iː nː k u j n
dinin	t iː n iː n
dipmat	t i p m a h t
dirči	t i rː t͡ʃ iː
dis	t iː s
disdat	t i sː t a h t
divo	t i v o
divraseamos	t i vː r a s e̯ a m o s
divrasit	t i vː r a s i h t
divri	t i vː r iː
divrras	t i v r r a s
divvut	t i v v uː h t
diŋgot	t i ŋː k o h t
doabo	t o̯ ɑ p o
doadjit	t o ɑ̯ ɟ ɟ iː h t
doahkki	t o ɑ̯ hː k iː
doahput	t o ɑ̯ h p uː h t
doai	t o ɑ̯ j
doaibat	t o ɑ̯ jː p a h t
doaibma	t o ɑ̯ jː p m a
doaibmat	t o ɑ̯ jː p m a h t
doaibmi	t o ɑ̯ jː p m iː
doaimmahat	t o ɑ̯ j m m a h a h t
doaimmaheaddji	t o ɑ̯ j m m a h e a̯ ɟː ɟ iː
doaimmaheapme	t o ɑ̯ j m m a h e̯ a p m e
doaimmahit	t o ɑ̯ j m m a h i h t
doaimmahus	t o ɑ̯ j m m a h u s
doaimmalaš	t o ɑ̯ j m m a l a ʃ
doaivu	t o ɑ̯ jː v uː
doaivut	t o ɑ̯ jː v uː h t
doaivva	t o ɑ̯ j v v a
doaivvuheapme	t o ɑ̯ j v v uː h e̯ a p m e
doaivvuhit	t o ɑ̯ j v v uː h i h t
doallat	t o ɑ̯ l l a h t
doalli	t o ɑ̯ l l iː
doallu	t o ɑ̯ l l uː
doalvi	t o ɑ̯ lː v iː
doalvut	t o ɑ̯ lː v uː h t
doapmat	t o ɑ̯ p m a h t
doardna	t o ɑ̯ rː t n a
doarggistit	t o ɑ̯ rː k k iː s t i h t
doarjut	t o ɑ̯ rː j uː h t
doaro	t o̯ ɑ r o
doarridit	t o ɑ̯ r r iː t i h t
doarru	t o ɑ̯ r r uː
doarru	t o ɑ̯ rː r uː
doarrut	t o ɑ̯ r r uː h t
doarrát	t o ɑ̯ rː r aː h t
doarvi	t o ɑ̯ rː v iː
doavggus	t o ɑ̯ vː k k uː s
doavhli	t o ɑ̯ vː l̥ iː
doavki	t o ɑ̯ vː k iː
doavttir	t o ɑ̯ v t t iː r
doaŋgi	t o ɑ̯ ŋː k iː
doboš	t oː p o ʃ
dodje	t oː ɟ ɟ e
doggi	t o ɡː ɡ iː
dohko	t o h k o
dohpat	t o h p a h t
dohppa	t o hː p a
doidit	t o jː t iː h t
doidos	t o jː t o s
dola	t o l a
dolaheapme	t o l a h e̯ a p m e
dolalaš	t o l a l a ʃ
dolas	t o l a s
dolastaddat	t o l a s t a dː d a h t
dolastit	t o l a s t i h t
dolat	t o l a h t
dolgi	t o lː k iː
dolin	t o l iː n
dolkat	t o lː k a h t
dolla	t o l l a
dollalakkis	t o l l a l a k k iː s
dollarieban	t o l l a r i e̯ p a n
dollavárri	t o l l a v aː r r iː
dolle	t oː l l e
dollen	t oː l l e n
dološ	t o l o ʃ
don	t o n
don	t oː n
doppe	t o p p e
doppe	t oː p p e
dorski	t o rː s k iː
dorve	t o rː v e
dorvu	t o rː v uː
dorvvastit	t o r v v a s t i h t
dorvvolaččamus	t o r v v o l a t t͡ʃ a m u s
dorvvolaččat	t o r v v o l a t t͡ʃ a h t
dorvvolaš	t o r v v o l a ʃ
dorvvoleamos	t o r v v o l e̯ a m o s
dorvvolit	t o r v v o l i h t
dorvvuheapme	t o r v v uː h e̯ a p m e
dot	t oː h t
dovdat	t o vː t a h t
dovddaldat	t o vː t t a l t a h t
dovde	t o vː t e
dovtta	t o v t t a
du	t uː
duddjot	t uː ɟː ɟ o h t
dudno	t u dː n o
dudnon	t u dː n o n
dudnos	t u dː n o s
dudnuide	t u dː n u j t e
dudnuin	t u dː n u j n
duhkki	t u hː k iː
duhkku	t u hː k uː
duhtadit	t u h t a t i h t
duhtat	t u h t a h t
duhtavaš	t u h t a v a ʃ
duháhat	t u h aː h a h t
duhát	t u h aː h t
duinna	t u j n n a
duipi	t u jː p iː
duiska	t u jː s k a
duivi	t u jː v iː
dulde	t uː lː t e
dulden	t uː lː t e n
duldet	t uː lː t e h t
dulvi	t u lː v iː
dunin	t uː n iː n
duoddi	t u o̯ dː d iː
duoddut	t u o̯ dː d uː h t
duodji	t u o̯ ɟ ɟ iː
duoggi	t u o̯ ɡː ɡ iː
duoggut	t u o̯ ɡː ɡ uː h t
duogáš	t u o̯ k aː ʃ
duogášsuonjardeapmi	t u o̯ k aː ʃ s u o̯ ɲ a r t e a̯ p m iː
duogŋat	t u o̯ dː ɲ a h t
duohken	t u̯ o h k e n
duohki	t u o̯ h k iː
duohkin	t u o̯ h k iː n
duohko	t u̯ o h k o
duohkái	t u o̯ h k aː j
duohpat	t u o̯ h p a h t
duohta	t u o̯ h t a
duohččat	t u o̯ hː t͡ʃ a h t
duolbbas	t u o̯ lː p p a s
duolbmat	t u o̯ lː p m a h t
duolbut	t u o̯ lː p uː h t
duoldat	t u o̯ lː t a h t
duollji	t u o̯ ʎː ʎ iː
duollu	t u o̯ lː l uː
duolva	t u o̯ lː v a
duolvaseamos	t u o̯ lː v a s e̯ a m o s
duolvasit	t u o̯ lː v a s i h t
duolvva	t u o̯ l v v a
duolvvas	t u o̯ l v v a s
duopma	t u o̯ p m a
duopmu	t u o̯ p m uː
duorastat	t u o̯ r a s t a h t
duorga	t u o̯ rː k a
duorrat	t u o̯ r r a h t
duortnus	t u o̯ r t n uː s
duoršu	t u o̯ rː ʃ uː
duostat	t u o̯ sː t a h t
duostil	t u o̯ sː t iː l
duostilis	t u o̯ sː t iː l i s
duostut	t u o̯ sː t uː h t
duot	t u o̯ h t
duotka	t u o̯ tː k a
duotna	t u o̯ t n a
duottar	t u o̯ t t a r
duovli	t u o̯ vː l iː
duođamus	t u o̯ ð a m u s
duođat	t u o̯ ð a h t
durka	t u rː k a
dus	t uː s
duski	t u sː k iː
dutkat	t u tː k a h t
dutnje	t u t ɲ e
duvdit	t u vː t iː h t
duvdni	t u vː t n iː
duvvá	t u vː v aː
duđaheapme	t u ð a h e̯ a p m e
duđahit	t u ð a h i h t
dušše	t u ʃ ʃ e
dá	t aː
dábba	t aː bː b a
dábálaččat	t aː p aː l a t t͡ʃ a h t
dábálaš	t aː p aː l a ʃ
dáhpi	t aː h p iː
dáhpáhus	t aː h p aː h u s
dáhpáhuvvat	t aː h p aː h u v v a h t
dáhtolaš	t aː h t o l a ʃ
dáhttu	t aː hː t uː
dáhttut	t aː hː t uː h t
dáidda	t aː jː t t a
dáiddalaš	t aː jː t t a l a ʃ
dáiddačájáhus	t aː jː t t a t͡ʃ aː j aː h u s
dáidduheapme	t aː jː t t uː h e̯ a p m e
dáiddár	t aː jː t t aː r
dáidit	t aː jː t iː h t
dáidu	t aː jː t uː
dáigi	t aː jː k iː
dákko	t aː k k o
dákti	t aː kː t iː
dál	t aː l
dálki	t aː lː k iː
dálkkas	t aː l k k a s
dállas	t aː l l a s
dállu	t aː l l uː
dálvat	t aː lː v a h t
dálvet	t aˑ lː v e h t
dálvi	t aː lː v iː
dálvit	t aː lː v iː h t
dálvvadis	t aː l v v a t i s
dálvvás	t aː l v v aː s
dánmárku	t aː nː m aː r k u
dápmat	t aː p m a h t
dápmot	t aː p m o h t
dápmu	t aː p m uː
dáppe	t aː p p e
dárbbašit	t aː rː p p a ʃ i h t
dárbbuheapme	t aː rː p p uː h e̯ a p m e
dárbu	t aː rː p uː
dárjat	t aː rː j a h t
dárogiella	t aˑ r o k i e̯ l l a
dárru	t aː r r uː
dárustit	t aː r uː s t i h t
dáseheapme	t aˑ s e h e̯ a p m e
dásset	t aː sː s e h t
dásset	t aˑ s s e h t
dássi	t aː s s iː
dássit	t aː s s iː h t
dávda	t aː vː t a
dávdi	t aː vː t iː
dávgi	t aː vː k iː
dávgut	t aː vː k uː h t
dávjá	t aː vː j aː
dávli	t aː vː l iː
dávvir	t aː v v iː r
dávžat	t aː vː t͡ʃ a h t
dáčča	t aː t t͡ʃ a
dáđvi	t aː ðː v iː
dáški	t aː ʃː k iː
dáža	t aː t͡ʃ a
eaba	e a̯ p a
eadjit	e a̯ ɟ ɟ iː h t
eadnespiidni	e a̯ dː n e s p i jː t n iː
eadni	e a̯ dː n iː
eadnin	e a̯ dː n iː n
eadnis	e a̯ dː n iː s
eadniset	e a̯ dː n iː s e h t
eadniska	e a̯ dː n iː s k a
eadnáde	e a̯ dː n aː t e
eadnádet	e a̯ dː n aː t e h t
eadnái	e a̯ dː n aː j
eadnáme	e a̯ dː n aː m e
eadnámet	e a̯ dː n aː m e h t
eadnán	e a̯ dː n aː n
eadnát	e a̯ dː n aː h t
eahccit	e a̯ hː t͡s iː h t
eahket	e̯ a h k e h t
eahki	e a̯ h k iː
eahppi	e a̯ hː p iː
eai	e a̯ j
eaidat	e a̯ jː t a h t
eaktu	e a̯ kː t uː
ealas	e a̯ l a s
eale	e̯ a l e
ealet	e̯ a l e h t
ealihit	e a̯ l iː h i h t
ealla	e a̯ l l a
eallaseamos	e a̯ l l a s e̯ a m o s
eallasit	e a̯ l l a s i h t
ealli	e a̯ lː l iː
eallin	e a̯ l l iː n
eallinvuohki	e a̯ l l iː n v u o̯ h k iː
eallisilba	e a̯ lː l iː s i lː p a
eallit	e a̯ l l iː h t
eallju	e a̯ ʎː ʎ uː
eallo	e a̯ l l o
eallu	e a̯ l l uː
ealáhus	e a̯ l aː h u s
ealán	e a̯ l aː n
eambbo	e̯ a mː p p o
eamit	e a̯ m iː h t
ean	e a̯ n
eana	e a̯ n a
eanas	e a̯ n a s
eanemus	e̯ a n e m u s
eanet	e̯ a n e h t
eanodat	e̯ a n o t a h t
eanu	e a̯ n uː
eapmi	e a̯ p m iː
eappir	e a̯ p p iː r
earta	e a̯ rː t a
earti	e a̯ rː t iː
eará	e a̯ r aː
easka	e a̯ sː k a
easkka	e a̯ s k a
eastat	e a̯ sː t a h t
eat	e a̯ h t
eatnagat	e a̯ t n a k a h t
eatnat	e a̯ t n a h t
eatni	e a̯ t n iː
eatnigiella	e a̯ t n iː k i e̯ l l a
eatnis	e a̯ t n iː s
eatnit	e a̯ t n iː h t
eatnu	e a̯ t n uː
eaŋgalas	e a̯ ŋː k a l a s
eaŋgals	e a̯ ŋː k a l s
edet	e t e h t
egypta	e kː y p t a
ehpet	eː h p e h t
einnostit	eː j n n o s t i h t
einnostus	eː j n n o s t u s
ekonoma	e kʰ o n o m a
ekonomiija	e kʰ o n o m i j j a
elle	e lː l e
elle	eː l l e
ellen	eː l l e n
ellet	eː l l e h t
ellos	eː l l o s
ellá	e l l aː
erenoamáš	e r e n o ɑ̯ m aː ʃ
eret	eː r e h t
eske	e sː k e
estlánda	e sː t l aː n t a
estteeana	e s t e e a̯ n a
esttegiella	e s t e k i e̯ l l a
etniid	eː t n i j t
etniide	eː t n i j t e
etniiguin	eː t n i j k u j n
etniin	eː t n i j n
eurohpá	e uː r o h p aː
evttohit	e v t t o h i h t
evttohus	e v t t o h u s
eŋgelas	e ŋː k e l a s
fabrihkka	f a pː r iː hː k a
faggut	f a ɡː ɡ uː h t
fagŋát	f a dː ɲ aː h t
fanas	f a n a s
fargga	f a rː k k a
fas	f a s
fearrat	f e a̯ r r a h t
feret	f eː r e h t
fidnu	f i dː n uː
fierbmi	f i e̯ rː p m iː
fiero	f i̯ e r o
fierpmi	f i e̯ r p m iː
fierrut	f i e̯ r r uː h t
fiertu	f i e̯ rː t uː
figgat	f i ɡː ɡ a h t
figge	f i ɡː ɡ e
fihtolaš	f iː h t o l a ʃ
filippiinnat	f i l iː p p i j n n a h t
fiskadas	f i sː k a t a s
fiskadeamos	f i sː k a t e̯ a m o s
fiskadit	f i sː k a t i h t
fiskat	f i sː k a h t
fiskes	f i sː k e s
fitnat	f i t n a h t
fluora	f l u oː r a
frankriika	f r a nː k r i j k a
friddja	f r i ɟː ɟ a
friddjamus	f r i ɟː ɟ a m u s
friddjat	f r i ɟː ɟ a h t
frákta	f r aː kː t a
fránskkagiella	f r aː n s k a k i e̯ l l a
funet	f uː n e h t
fuobmát	f u o̯ bː m aː h t
fuoikit	f u o̯ jː k iː h t
fuolki	f u o̯ lː k iː
fuones	f u̯ o n e s
fuorrá	f u o̯ r r aː
fuotni	f u o̯ t n iː
fuotnut	f u o̯ t n uː h t
fuođđu	f u o̯ ð ð uː
fysihkka	f y s i hː k a
fáddá	f aː dː d aː
fáhcca	f aː hː t͡s a
fákta	f aː kː t a
fális	f aː l iː s
fállat	f aː l l a h t
fállá	f aː lː l aː
fápmu	f aː p m uː
fárfu	f aː rː f uː
fárret	f aː rː r e h t
fárru	f aː r r uː
fáskat	f aː sː k a h t
fáŋga	f aː ŋː k a
fáŋgal	f aː ŋː k a l
gabba	k a bː b a
gahcut	k a h t͡s uː h t
gahkit	k a h k iː h t
gahpir	k a h p iː r
gahppat	k a hː p a h t
gahčat	k a h t͡ʃ a h t
gahččat	k a hː t͡ʃ a h t
gaiba	k a jː p a
gaigŋir	k a jː t ɲ iː r
gaikut	k a jː k uː h t
gaivát	k a jː v aː h t
galbmaskábe	k a lː p m a s k aː p e
galbmaskábede	k a lː p m a s k aː p e t e
galbmaskábedet	k a lː p m a s k aː p e t e h t
galbmaskábeme	k a lː p m a s k aː p e m e
galbmaskábemet	k a lː p m a s k aː p e m e h t
galbmaskáben	k a lː p m a s k aː p e n
galbmaskábes	k a lː p m a s k aː p e s
galbmaskábeset	k a lː p m a s k aː p e s e h t
galbmaskábeska	k a lː p m a s k aː p e s k a
galbmaskábet	k a lː p m a s k aː p e h t
galbmaskábii	k a lː p m a s k aː p i j
galbmaskábiid	k a lː p m a s k aː p i j t
galbmaskábiide	k a lː p m a s k aː p i j t e
galbmaskábiiguin	k a lː p m a s k aː p i j k u j n
galbmaskábiin	k a lː p m a s k aː p i j n
galbmit	k a lː p m iː h t
galgan	k a lː k a n
galgat	k a lː k a h t
galge	k a lː k e
galgen	k a lː k e n
galgos	k a lː k o s
galle	k a lː l e
gallen	k a lː l e n
gallet	k a lː l e h t
gallii	k a lː l i j
galmmas	k a l m m a s
ganjal	k a ɲ a l
gapmu	k a p m uː
garas	k a r a s
garca	k a rː t͡s a
garcut	k a rː t͡s uː h t
gargit	k a rː k iː h t
garjá	k a rː j aː
garra	k a r r a
garrasit	k a r r a s i h t
garvit	k a rː v iː h t
gaska	k a sː k a
gaskat	k a sː k a h t
gaskavahkku	k a sː k a v a hː k uː
gaskavuohta	k a sː k a v u o̯ h t a
gasket	k a sː k e h t
gaskii	k a sː k i j
gaskit	k a sː k iː h t
gaskkas	k a s k a s
gaste	k a sː t e
gasten	k a sː t e n
gasti	k a sː t iː
gastit	k a sː t iː h t
gaston	k a sː t o n
gastos	k a sː t o s
gastá	k a sː t aː
gatna	k a t n a
gavja	k a vː j a
gazo	k a t͡s o
gazole	k a t͡s o l e
gazza	k a dː d͡z a
gaŋgát	k a ŋː k aː h t
gaŋkát	k a ŋː k aː h t
gaškát	k a ʃː k aː h t
gažahit	k a t͡ʃ a h i h t
gažaldat	k a t͡ʃ a l t a h t
geafes	k e̯ a f e s
geafi	k e a̯ f iː
geahkat	k e a̯ h k a h t
geahpis	k e a̯ h p iː s
geahppán	k e a̯ hː p aː n
geahčastallat	k e a̯ h t͡ʃ a s t a l l a h t
geahčastat	k e a̯ h t͡ʃ a s t a h t
geahčastit	k e a̯ h t͡ʃ a s t i h t
geahčen	k e̯ a h t͡ʃ e n
geahči	k e a̯ h t͡ʃ iː
geahččaleapmi	k e a̯ hː t͡ʃ a l e a̯ p m iː
geahččalit	k e a̯ hː t͡ʃ a l i h t
geahččat	k e a̯ hː t͡ʃ a h t
geahčču	k e a̯ hː t͡ʃ uː
geaidi	k e a̯ jː t iː
geaidit	k e a̯ jː t iː h t
geaidnu	k e a̯ jː t n uː
geaidu	k e a̯ jː t uː
geaidut	k e a̯ jː t uː h t
gealbu	k e a̯ lː p uː
gealdit	k e a̯ lː t iː h t
geallat	k e a̯ l l a h t
geallir	k e a̯ l l iː r
geallit	k e a̯ l l iː h t
gealut	k e a̯ l uː h t
geandit	k e a̯ nː t iː h t
geargat	k e a̯ rː k a h t
gearpmaš	k e a̯ r p m a ʃ
gease	k e̯ a s e
geassemánnu	k e̯ a s s e m aː n n uː
geasset	k e̯ a s s e h t
geassi	k e a̯ s s iː
geassi	k e a̯ sː s iː
geassit	k e a̯ s s iː h t
geatki	k e a̯ tː k iː
geavaheaddjedovddaldat	k e a̯ v a h e̯ a ɟː ɟ e t o vː t t a l t a h t
geavaheaddji	k e a̯ v a h e a̯ ɟː ɟ iː
geavaheaddjidovddaldat	k e a̯ v a h e a̯ ɟː ɟ iː t o vː t t a l t a h t
geavaheaddjit	k e a̯ v a h e a̯ ɟː ɟ iː h t
geavahit	k e a̯ v a h i h t
geavrát	k e a̯ vː r aː h t
geavvat	k e a̯ v v a h t
geađgi	k e a̯ ðː k iː
geaŧŧu	k e a̯ θ θ uː
geho	k eː h o
gelde	k eː lː t e
gelden	k eː lː t e n
gesse	k eː s s e
gessen	k eː s s e n
gessos	k eː s s o s
giebmi	k i e̯ bː m iː
gieddi	k i e̯ dː d iː
gieggat	k i e̯ ɡː ɡ a h t
giehka	k i e̯ h k a
giehpa	k i e̯ h p a
giehta	k i e̯ h t a
giehtamátta	k i e̯ h t a m aː t t a
giehtaruohtas	k i e̯ h t a r u o̯ h t a s
giektat	k i e̯ kː t a h t
gielaheapme	k i e̯ l a h e̯ a p m e
gielda	k i e̯ lː t a
gieldda	k i e̯ lː t t a
gielddasámegiella	k i e̯ lː t t a s aˑ m e k i e̯ l l a
gielddu	k i e̯ lː t t uː
gieldit	k i e̯ lː t iː h t
gieldu	k i e̯ lː t uː
giella	k i e̯ l l a
giellaoahppa	k i e̯ l l a o ɑ̯ hː p a
giellá	k i e̯ l l aː
giemardit	k i e̯ m a r t i h t
giepma	k i e̯ p m a
gierdat	k i e̯ rː t a h t
giessat	k i e̯ s s a h t
gievdni	k i e̯ vː t n iː
gievra	k i e̯ vː r a
gievrramus	k i e̯ v r r a m u s
gievrras	k i e̯ v r r a s
gievrrat	k i e̯ v r r a h t
gieđbmi	k i e̯ ðː p m iː
gieđmmi	k i e̯ ð m m iː
gihpu	k i h p uː
gii	k i j
giitit	k i jː t iː h t
giitu	k i jː t uː
giksat	k i kː s a h t
gikta	k i kː t a
gildát	k i lː t aː h t
gili	k i l iː
gilli	k i l l iː
gilljut	k i ʎː ʎ uː h t
gillát	k i lː l aː h t
gilvit	k i lː v iː h t
gilvu	k i lː v uː
girdi	k i rː t iː
girdit	k i rː t iː h t
girdno	k i rː t n o
girjedárogiella	k i rː j e t aˑ r o k i e̯ l l a
girjerádju	k i rː j e r aː ɟ ɟ uː
girječálli	k i rː j e t͡ʃ aː lː l iː
girji	k i rː j iː
girjjálaš	k i r j j aː l a ʃ
girjjálašvuohta	k i r j j aː l a ʃː v u o̯ h t a
girjjáš	k i r j j aː ʃ
girku	k i rː k uː
giron	k i r o n
giron	k iː r o n
girona	k iː r o n a
girse	k i rː s e
girtat	k i rː t a h t
gissat	k i s s a h t
gisse	k iː s s e
gissen	k iː s s e n
gitta	k i t t a
givlo	k i vː l o
giđđa	k i ð ð a
giđđat	k i ð ð a h t
go	k o
goabbá	k o ɑ̯ bː b aː
goahcat	k o ɑ̯ h t͡s a h t
goahkka	k o ɑ̯ hː k a
goahppil	k o ɑ̯ hː p iː l
goahti	k o ɑ̯ h t iː
goaikut	k o ɑ̯ jː k uː h t
goaivu	k o ɑ̯ jː v uː
goaivut	k o ɑ̯ jː v uː h t
goallut	k o ɑ̯ l l uː h t
goallát	k o ɑ̯ lː l aː h t
goalmmát	k o ɑ̯ l m m aː h t
goalo	k o̯ ɑ l o
goalsi	k o ɑ̯ lː s iː
goalvát	k o ɑ̯ lː v aː h t
goansta	k o ɑ̯ nː s t a
goapma	k o ɑ̯ p m a
goardit	k o ɑ̯ rː t iː h t
goargŋut	k o ɑ̯ rː t ɲ uː h t
goarjut	k o ɑ̯ rː j uː h t
goarkŋun	k o ɑ̯ r t ɲ uː n
goaro	k o̯ ɑ r o
goarrat	k o ɑ̯ r r a h t
goarrut	k o ɑ̯ r r uː h t
goas	k o ɑ̯ s
goasii	k o ɑ̯ s i j
goaski	k o ɑ̯ sː k iː
goaskin	k o ɑ̯ sː k iː n
goavdi	k o ɑ̯ vː t iː
gobi	k o p iː
gobiid	k o p i j t
gobmi	k o bː m iː
goddi	k o dː d iː
goddit	k o dː d iː h t
goddot	k o dː d o h t
gohccát	k o hː t͡s aː h t
gohcit	k o h t͡s iː h t
gohcu	k o h t͡s uː
gohcut	k o h t͡s uː h t
gohpat	k o h p a h t
gohpi	k o h p iː
gohppa	k o hː p a
gohppi	k o hː p iː
gohččut	k o hː t͡ʃ uː h t
goikat	k o jː k a h t
goikkis	k o j k k iː s
goikáseamos	k o jː k aː s e̯ a m o s
goikásit	k o jː k aː s i h t
goivo	k oː jː v o
gokčat	k o kː t͡ʃ a h t
golbma	k o lː p m a
golbmii	k o lː p m i j
goldnat	k o lː t n a h t
golgadat	k o lː k a t a h t
golgadit	k o lː k a t i h t
golgat	k o lː k a h t
golggotmánnu	k o lː k k o t m aː n n uː
gollat	k o l l a h t
golli	k o lː l iː
gonagas	k o n a k a s
gonagasnieida	k o n a k a sː n i e̯ j t a
gopmat	k o p m a h t
gora	k o r a
gorai	k o r a j
gorde	k oː rː t e
gorden	k oː rː t e n
gordni	k o rː t n iː
gordon	k oː rː t o n
gordos	k oː rː t o s
gorrat	k o r r a h t
gorri	k o rː r iː
gorro	k oː r r o
gorros	k o r r o s
gorros	k oː r r o s
gorru	k o rː r uː
gos	k o s
gosa	k o s a
gosahat	k o s a h a h t
gosahit	k o s a h i h t
gosan	k o s a n
gosat	k o s a h t
gossan	k o s s a n
gossat	k o s s a h t
gosse	k o s s e
gossen	k o s s e n
gossos	k o s s o s
gotka	k o tː k a
gotte	k o t t e
govahallat	k o v a h a l l a h t
govdut	k o vː t uː h t
govlut	k o vː l uː h t
govva	k o v v a
goze	k o t͡s e
gođđat	k o ð ð a h t
gođđit	k o ð ð iː h t
gođđit	k o ðː ð iː h t
gožu	k o t͡ʃ uː
gožža	k o dː d͡ʒ a
greika	k r e jː k a
gráda	k r aː t a
grámmá	k r aː mː m aː
gudden	k uː dː d e n
gudni	k u dː n iː
guhkes	k u h k e s
guhkesjuolggat	k u h k e s j u o̯ lː k k a h t
guhkimus	k u h k iː m u s
guhkit	k u h k iː h t
guhkkat	k u hː k a h t
guhkki	k u hː k iː
guhkkin	k u hː k iː n
guhte	k u h t e
guhtemuš	k u h t e m u ʃ
guhtta	k u hː t a
guhtur	k u h t uː r
guidot	k u jː t o h t
guksi	k u kː s iː
guktii	k u kː t i j
gula	k u l a
gulan	k u l a n
gulat	k u l a h t
gulaš	k u l a ʃ
gulbmi	k u lː p m iː
gulcat	k u lː t͡s a h t
gulkat	k u lː k a h t
gulla	k u lː l a
gullat	k u l l a h t
gullen	k u l l e n
gullet	k u l l e h t
gullet	k uː lː l e h t
gulli	k u lː l iː
gullot	k u lː l o h t
gullu	k u l l uː
gummi	k u mː m iː
gumpe	k u mː p e
guoccat	k u o̯ t t͡s a h t
guoddit	k u o̯ dː d iː h t
guoddu	k u o̯ dː d uː
guoddá	k u o̯ dː d aː
guodja	k u o̯ ɟ ɟ a
guoggi	k u o̯ ɡː ɡ iː
guoggut	k u o̯ ɡː ɡ uː h t
guoggát	k u o̯ ɡː ɡ aː h t
guohcagit	k u o̯ h t͡s a k i h t
guohkkat	k u o̯ hː k a h t
guohpput	k u o̯ hː p uː h t
guoibmevuohta	k u̯ o jː p m e v u o̯ h t a
guoibmi	k u o̯ jː p m iː
guoika	k u o̯ jː k a
guoirat	k u o̯ jː r a h t
guokte	k u̯ o kː t e
guoktelogiguokte	k u o̯ kː t e l o k iː k u o̯ kː t e
guokteloginubbi	k u̯ o kː t e l o k iː n u bː b iː
guolbmat	k u o̯ lː p m a h t
guolga	k u o̯ lː k a
guolla	k u o̯ l l a
guolli	k u o̯ l l iː
guolástit	k u o̯ l aː s t i h t
guomu	k u o̯ m uː
guopmi	k u o̯ p m iː
guoppar	k u o̯ p p a r
guorbmi	k u o̯ rː p m iː
guorbát	k u o̯ rː p aː h t
guorga	k u o̯ rː k a
guoros	k u̯ o r o s
guorsat	k u o̯ rː s a h t
guorus	k u o̯ r uː s
guoskat	k u o̯ sː k a h t
guosmut	k u o̯ sː m uː h t
guossa	k u o̯ s s a
guossi	k u o̯ sː s iː
guostát	k u o̯ sː t aː h t
guottu	k u o̯ t t uː
guovda	k u o̯ vː t a
guovddi	k u o̯ vː t t iː
guovdi	k u o̯ vː t iː
guovgát	k u o̯ vː k aː h t
guovla	k u o̯ vː l a
guovlat	k u o̯ vː l a h t
guovllu	k u o̯ v l l uː
guovlu	k u o̯ vː l uː
guovssahas	k u o̯ v s s a h a s
guovssat	k u o̯ v s s a h t
guovssu	k u o̯ v s s uː
guovvamánnu	k u o̯ v v a m aː n n uː
guovža	k u o̯ vː t͡ʃ a
guođđit	k u o̯ ð ð iː h t
gurdit	k u rː t iː h t
gurká	k u rː k aː
gurra	k u r r a
gurroseamos	k uː r r o s e̯ a m o s
gurrosit	k uː r r o s i h t
gursa	k u rː s a
gurut	k u r uː h t
gusa	k u s a
gussa	k u s s a
gutna	k u t n a
guvri	k u vː r iː
guvrut	k u vː r uː h t
guvrát	k u vː r aː h t
guđat	k u ð a h t
guđju	k u ðː j uː
gužža	k u dː d͡ʒ a
gába	k aː p a
gáddi	k aː dː d iː
gáddit	k aː dː d iː h t
gádja	k aː ɟ ɟ a
gádjit	k aː ɟ ɟ iː h t
gádjut	k aː ɟ ɟ uː h t
gáfe	k aː f e
gáffe	k aː f f e
gággat	k aː ɡː ɡ a h t
gáhkkor	k aː hː k o r
gáhkku	k aː hː k uː
gáhtat	k aː h t a h t
gáhttu	k aː hː t uː
gáhččat	k aː hː t͡ʃ a h t
gáibi	k aː jː p iː
gáibmi	k aː jː p m iː
gáidnu	k aː jː t n uː
gáigá	k aː jː k aː
gáisi	k aː jː s iː
gáisá	k aː jː s aː
gáivo	k aː jː v o
gájot	k aː j o h t
gákkis	k aː k k iː s
gákti	k aː kː t iː
gákšu	k aː kː ʃ uː
gálašit	k aː l a ʃ i h t
gálbi	k aː lː p iː
gálgat	k aː lː k a h t
gálgi	k aː lː k iː
gállis	k aː l l iː s
gállit	k aː l l iː h t
gállit	k aː lː l iː h t
gálojeatni	k aˑ l o j e a̯ t n iː
gálvát	k aː lː v aː h t
gáma	k aː m a
gámme	k aː mː m e
gánda	k aː nː t a
gáranas	k aː r a n a s
gárbbis	k aː rː p p iː s
gárpa	k aː rː p a
gárrat	k aː r r a h t
gárta	k aː rː t a
gártat	k aː rː t a h t
gárvvis	k aː r v v iː s
gáržut	k aː rː t͡ʃ uː h t
gáskit	k aː sː k iː h t
gássa	k aː s s a
gáttán	k aː t t aː n
gáttát	k aː t t aː h t
gávcci	k aː v t t͡s iː
gávccát	k aː v t t͡s aː h t
gávdnat	k aː vː t n a h t
gávdnot	k aː vː t n o h t
gávpi	k aː vː p iː
gávpot	k aː vː p o h t
gávppašanlihppu	k aː v p p a ʃ a nː l iː hː p u
gávppašanlistu	k aː v p p a ʃ a nː l iː s t u
gávppašit	k aː v p p a ʃ i h t
gávri	k aː vː r iː
gávrut	k aː vː r uː h t
gávrát	k aː vː r aː h t
gávtti	k aː v t t iː
gázzi	k aː dː d͡z iː
haddi	h a dː d iː
haga	h a k a
hahppit	h a hː p iː h t
haksi	h a kː s iː
haksit	h a kː s iː h t
haŋkit	h a ŋː k iː h t
haŋŋá	h a ŋ ɲ aː
headju	h e a̯ ɟ ɟ uː
heagga	h e a̯ ɡː ɡ a
heahkka	h e a̯ hː k a
heaibat	h e a̯ jː p a h t
heaibut	h e a̯ jː p uː h t
heaika	h e a̯ jː k a
heaitit	h e a̯ jː t iː h t
heargi	h e a̯ rː k iː
hearvát	h e a̯ rː v aː h t
heavdni	h e a̯ vː t n iː
heaŋgut	h e a̯ ŋː k uː h t
heaŋgát	h e a̯ ŋː k aː h t
hedjonit	h eː ɟ ɟ o n i h t
hehkke	h e hː k e
heike	h e jː k e
heksána	h e kː s aː n a
hekto	h e kː t o
helbmo	h e lː p m o
helium	h eː l iː u m
helsset	h e l s s e h t
helvet	h e lː v e h t
hersko	h e rː s k o
hevro	h e vː r o
heŋge	h e ŋː k e
heŋgo	h e ŋː k o
hieibmat	h i e̯ jː p m a h t
hihttát	h i hː t aː h t
hilbbut	h i lː p p uː h t
hilgut	h i lː k uː h t
himsi	h i mː s iː
hipmu	h i p m uː
hirsa	h i rː s a
hivsset	h i v s s e h t
hoallat	h o ɑ̯ l l a h t
hoallu	h o ɑ̯ l l uː
hoallu	h o ɑ̯ lː l uː
hoigat	h o jː k a h t
hoitát	h o jː t aː h t
holbi	h o lː p iː
holga	h o lː k a
holle	h oː l l e
hollen	h oː l l e n
hollos	h oː l l o s
holvut	h o lː v uː h t
homofiila	h o m o f i jː l a
honnet	h o n n e h t
horbma	h o rː p m a
horsta	h o rː s t a
horti	h o rː t iː
huhpat	h u h p a h t
huhttát	h u hː t aː h t
hui	h u j
huikit	h u jː k iː h t
huilát	h u jː l aː h t
hullat	h u l l a h t
huma	h u m a
humai	h u m a j
human	h u m a n
humat	h u m a h t
hupmat	h u p m a h t
hurri	h u rː r iː
hydrogena	h y t r o k eː n a
háhccát	h aː hː t͡s aː h t
háhkat	h aː h k a h t
háhtta	h aː hː t a
hála	h aː l a
hállan	h aː l l a n
hállat	h aː l l a h t
hállu	h aː l l uː
hállu	h aː lː l uː
hápmi	h aː p m iː
hárcut	h aː rː t͡s uː h t
hárdit	h aː rː t iː h t
hárdu	h aː rː t uː
hárve	h aˑ rː v e
hávda	h aː vː t a
hávdi	h aː vː t iː
hávga	h aː vː k a
hávkat	h aː vː k a h t
hávkka	h aː v k k a
háŋgu	h aː ŋː k uː
háŋgut	h aː ŋː k uː h t
idea	i t e a̯
idja	i ɟ ɟ a
idjadit	i ɟ ɟ a t i h t
idjaklubba	i ɟ ɟ a k l u bː b a
idjaloddi	i ɟ ɟ a l o dː d iː
ieš	i e̯ ʃ
ieža	i e̯ t͡ʃ a
iežade	i e̯ t͡ʃ a t e
iežadet	i e̯ t͡ʃ a t e h t
iežame	i e̯ t͡ʃ a m e
iežamet	i e̯ t͡ʃ a m e h t
iežan	i e̯ t͡ʃ a n
iežas	i e̯ t͡ʃ a s
iežaset	i e̯ t͡ʃ a s e h t
iežaska	i e̯ t͡ʃ a s k a
iežat	i e̯ t͡ʃ a h t
ihkku	i hː k uː
ihtit	i h t iː h t
ihttin	i hː t iː n
ii	i j
ijašit	i j a ʃ i h t
ikte	i kː t e
ilbmat	i lː p m a h t
illu	i l l uː
illui	i l l u j
ilu	i l uː
ilus	i l uː s
imi	i m iː
imis	i m iː s
imit	i m iː h t
imperatiiva	i mː p e r a tʰ i j v a
in	i n
interneahtta	i nː t e r n e a̯ hː t a
ipmi	i p m iː
ipmil	i p m iː l
ipmirdit	i p m iː r t i h t
iras	i r a s
irraseamos	i r r a s e̯ a m o s
irrasit	i r r a s i h t
isit	i s iː h t
iskat	i sː k a h t
isken	i sː k e n
islánda	i sː l aː n t a
issoras	i s s o r a s
issorasamus	i s s o r a s a m u s
issorasat	i s s o r a s a h t
issoreamos	i s s o r e̯ a m o s
issorit	i s s o r i h t
it	i h t
itku	i tː k uː
ivdnet	i vː t n e h t
ivdni	i vː t n iː
iđit	i ð iː h t
ja	j a
jabbut	j a bː b uː h t
jagi	j a k iː
jagiáigi	j a k iː aː jː k iː
jahkečuohti	j a h k e t͡ʃ u o̯ h t iː
jahki	j a h k iː
jahkodat	j a h k o t a h t
jahkásaš	j a h k aː s a ʃ
jahtat	j a h t a h t
jakŋat	j a t ɲ a h t
jalga	j a lː k a
jalgadeamos	j a lː k a t e̯ a m o s
jalgadit	j a lː k a t i h t
jalgat	j a lː k a h t
jalges	j a lː k e s
jalkát	j a lː k aː h t
jalla	j a lː l a
jallamus	j a l l a m u s
jallas	j a l l a s
jallat	j a l l a h t
jalŋŋis	j a l ŋ ɲ iː s
jarfát	j a rː f aː h t
jaska	j a sː k a
jaskadeamos	j a sː k a t e̯ a m o s
jaskadit	j a sː k a t i h t
jaskat	j a sː k a h t
jaskes	j a sː k e s
jassa	j a s s a
jeaggi	j e a̯ ɡː ɡ iː
jeagil	j e a̯ k iː l
jealahas	j e a̯ l a h a s
jearahit	j e a̯ r a h i h t
jearaldat	j e a̯ r a l t a h t
jearransátni	j e a̯ r r a n s aː t n iː
jearrat	j e a̯ r r a h t
jegolaš	j e k o l a ʃ
jiehkki	j i e̯ hː k iː
jiehtanas	j i e̯ h t a n a s
jiekŋa	j i e̯ t ɲ a
jiekŋabadji	j i e̯ t ɲ a p a ɟ ɟ iː
jiekŋaáigi	j i e̯ t ɲ a aː jː k iː
jiellat	j i e̯ l l a h t
jielli	j i e̯ lː l iː
jielti	j i e̯ lː t iː
jienas	j i e̯ n a s
jienasta	j i e̯ n a s t a
jienastan	j i e̯ n a s t a n
jienastat	j i e̯ n a s t a h t
jienaste	j i e̯ n a s t e
jienasteaba	j i e̯ n a s t e a̯ p a
jienasteaddji	j i e̯ n a s t e a̯ ɟː ɟ iː
jienasteadnu	j i e̯ n a s t e a̯ dː n uː
jienasteahkki	j i e̯ n a s t e a̯ hː k iː
jienasteahppi	j i e̯ n a s t e a̯ hː p iː
jienasteapmi	j i e̯ n a s t e a̯ p m iː
jienasteatnot	j i e̯ n a s t e a̯ t n o h t
jienastedje	j i e̯ n a s t e ɟ ɟ e
jienastedjen	j i e̯ n a s t e ɟ ɟ e n
jienastedjet	j i e̯ n a s t e ɟ ɟ e h t
jienastehket	j i e̯ n a s t eː h k e h t
jienastehkon	j i e̯ n a s t eː h k o n
jienastehkos	j i e̯ n a s t eː h k o s
jienastehkoset	j i e̯ n a s t eː h k o s e h t
jienastehkoska	j i e̯ n a s t eː h k o s k a
jienastehkot	j i e̯ n a s t eː h k o h t
jienastehpet	j i e̯ n a s t eː h p e h t
jienasteidde	j i e̯ n a s t e jː t t e
jienasteiddet	j i e̯ n a s t e jː t t e h t
jienasteigga	j i e̯ n a s t e jː k k a
jienasteimme	j i e̯ n a s t e j m m e
jienasteimmet	j i e̯ n a s t e j m m e h t
jienastetne	j i e̯ n a s t e t n e
jienastii	j i e̯ n a s t i j
jienastin	j i e̯ n a s t i n
jienastit	j i e̯ n a s t i h t
jienastus	j i e̯ n a s t u s
jierbmat	j i e̯ rː p m a h t
jierbmi	j i e̯ rː p m iː
jieris	j i e̯ r iː s
jietna	j i e̯ t n a
jietnadit	j i e̯ t n a t i h t
jo	j o
joahcat	j o ɑ̯ h t͡s a h t
joatkit	j o ɑ̯ tː k iː h t
joavdat	j o ɑ̯ vː t a h t
jode	j o t e
joga	j o k a
jogas	j o k a s
johanas	j o h a n a s
johka	j o h k a
johtil	j o h t iː l
johtit	j o h t iː h t
johttát	j o hː t aː h t
joksat	j o kː s a h t
joksi	j o kː s iː
jokŋa	j o t ɲ a
jorba	j o rː p a
jorbaseamos	j o rː p a s e̯ a m o s
jorbasit	j o rː p a s i h t
jorbbas	j o rː p p a s
jorbbot	j o rː p p o h t
jorgalit	j o rː k a l i h t
jorggihit	j o rː k k iː h i h t
jorgut	j o rː k uː h t
jorra	j o rː r a
jorrat	j o r r a h t
jorre	j o r r e
jorri	j o rː r iː
jos	j o s
jovsset	j o v s s e h t
jođán	j o ð aː n
jođánis	j o ð aː n i s
jođánit	j o ð aː n i h t
judda	j u dː d a
juga	j u k a
jugahahtti	j u k a h a hː t iː
jugale	j u k a l e
jugat	j u k a h t
juge	j uː k e
jugus	j u k uː s
juhkaluvvan	j u h k a l u v v a n
juhkaluvvat	j u h k a l u v v a h t
juhkat	j u h k a h t
juksat	j u kː s a h t
juksu	j u kː s uː
julevsámegiella	j u l e v s aˑ m e k i e̯ l l a
julmmut	j u l m m uː h t
jumeš	j uː m e ʃ
juná	j u n aː
juoddit	j u o̯ dː d iː h t
juogadit	j u o̯ k a t i h t
juogo	j u̯ o k o
juogut	j u o̯ k uː h t
juohke	j u̯ o h k e
juohkehaš	j u̯ o h k e h a ʃ
juohkit	j u o̯ h k iː h t
juohku	j u o̯ h k uː
juoigat	j u o̯ jː k a h t
juoiggus	j u o̯ jː k k uː s
juoksa	j u o̯ kː s a
juokŋat	j u o̯ t ɲ a h t
juolgat	j u o̯ lː k a h t
juolgi	j u o̯ lː k iː
juopmu	j u o̯ p m uː
juorbut	j u o̯ rː p uː h t
juovlamánnu	j u o̯ vː l a m aː n n uː
juovllat	j u o̯ v l l a h t
juovva	j u o̯ v v a
jupiter	j u pʰ iː tʰ e r
jurbmát	j u rː p m aː h t
jurdda	j u rː t t a
jurddašit	j u rː t t a ʃ i h t
jurdit	j u rː t iː h t
jus	j u s
justa	j u sː t a
justit	j u sː t iː h t
juvla	j u vː l a
já	j aː
jáhkkit	j aː hː k iː h t
jápmin	j aː p m iː n
jápmit	j aː p m iː h t
jápmán	j aː p m aː n
jástit	j aː sː t iː h t
játnat	j aː t n a h t
jávkat	j aː vː k a h t
jávri	j aː vː r iː
kaniidna	kʰ a n i j t n a
kanáda	kʰ a n aː t a
kanáriasullot	kʰ a n aː r i a s u l l o h t
kapealla	kʰ a pʰ e a̯ l l a
kapitalisma	kʰ a pʰ iː tʰ a l iː s m a
kapitalista	kʰ a pʰ iː tʰ a l iː s t a
kapitála	kʰ a pʰ iː tʰ aː l a
keallir	kʰ e a̯ l l iː r
kilo	kʰ i l o
kilográmmá	kʰ i l o k r aː mː m aː
kirgisistan	kʰ i rː k iː s i sː t a n
kirku	kʰ i rː k uː
klora	k l oː r a
klubba	k l u bː b a
koahkka	kʰ o ɑ̯ hː k a
kolonialisma	kʰ o l o n i a l i sː m a
koloniija	kʰ o l o n i j j a
koloniseret	kʰ o l o n i s eː r e h t
kolonista	kʰ o l o n i sː t a
komišuvdna	kʰ o m iː ʃ u vː t n a
kommišuvdna	kʰ o m m iː ʃ u vː t n a
konditionála	kʰ o nː t iː tʰ i o n aː l a
konto	kʰ o nː t o
kristus	k r i sː t uː s
kroma	k r oː m a
kruvdno	k r u vː t n o
krypton	k r y p t o n
kránnjá	k r aː ɲ ɲ aː
kránnjá	k r aː ɲː ɲ aː
kránnjáid	k r aː ɲ ɲ aː j t
kursa	kʰ u rː s a
kusta	kʰ u sː t a
káfe	kʰ aː f e
káffe	kʰ aː f f e
kálka	kʰ aː lː k a
kárpa	kʰ aː rː p a
kárta	kʰ aː rː t a
kárášjohka	kʰ aː r aː ʃ j o h k a
kássa	kʰ aː sː s a
labmát	l a bː m aː h t
laddat	l a dː d a h t
ladju	l a ɟ ɟ uː
laggat	l a ɡː ɡ a h t
lahka	l a h k a
lahpat	l a h p a h t
laigat	l a jː k a h t
laksi	l a kː s iː
laktit	l a kː t iː h t
lama	l a m a
lamai	l a m a j
laman	l a m a n
lamat	l a m a h t
lapmat	l a p m a h t
laskat	l a sː k a h t
lassa	l a s s a
lassi	l a s s iː
lassánit	l a s s aː n i h t
lasta	l a sː t a
lastan	l a sː t a n
latnja	l a t ɲ a
lea	l e a̯
leaba	l e a̯ p a
leabba	l e a̯ bː b a
leabbat	l e a̯ bː b a h t
leabbut	l e a̯ bː b uː h t
leade	l e̯ a t e
leadnu	l e a̯ dː n uː
leage	l e̯ a k e
leagi	l e a̯ k iː
leahki	l e a̯ h k iː
leahkit	l e a̯ h k iː h t
leahkki	l e a̯ hː k iː
leahkku	l e a̯ hː k uː
leahppi	l e a̯ hː p iː
leai	l e a̯ j
leaibi	l e a̯ jː p iː
leaigga	l e a̯ jː k k a
leaika	l e a̯ jː k a
leaikut	l e a̯ jː k uː h t
leaira	l e a̯ jː r a
leaksu	l e a̯ kː s uː
leamaš	l e a̯ m a ʃ
lean	l e a̯ n
leandit	l e a̯ nː t iː h t
leasmi	l e a̯ sː m iː
leat	l e a̯ h t
leatnot	l e̯ a t n o h t
leavdnit	l e a̯ vː t n iː h t
leavga	l e a̯ vː k a
leavvat	l e a̯ v v a h t
leačča	l e a̯ t t͡ʃ a
leaččan	l e a̯ t t͡ʃ a n
leaččat	l e a̯ t t͡ʃ a h t
leađbma	l e a̯ ðː p m a
leaŋga	l e a̯ ŋː k a
leaŋgga	l e a̯ ŋː k k a
leaš	l e a̯ ʃ
leažžaba	l e a̯ dː d͡ʒ a p a
leažžabeahtti	l e a̯ dː d͡ʒ a p e a̯ hː t iː
leažžabehtet	l e a̯ dː d͡ʒ a p eː h t e h t
leažžat	l e a̯ dː d͡ʒ a h t
leažžá	l e a̯ dː d͡ʒ aː
lebbes	l eː bː b e s
ledje	l e ɟ ɟ e
ledjen	l e ɟ ɟ e n
ledjet	l e ɟ ɟ e h t
ledjon	l eː ɟ ɟ o n
lehket	l eː h k e h t
lehkon	l eː h k o n
lehkos	l eː h k o s
lehkoset	l eː h k o s e h t
lehkoska	l eː h k o s k a
lehkot	l eː h k o h t
lehpet	l eː h p e h t
lei	l e j
leidde	l e jː t t e
leiddet	l e jː t t e h t
leigga	l e jː k k a
leimme	l e j m m e
leimmet	l e j m m e h t
letne	l e t n e
levlo	l e vː l o
leŋge	l e ŋː k e
leš	l e ʃ
ležže	l e dː d͡ʒ e
ležžet	l e dː d͡ʒ e h t
lidnu	l i dː n uː
lieksi	l i e̯ kː s iː
liekčát	l i e̯ kː t͡ʃ aː h t
liepma	l i e̯ p m a
lietuva	l i e̯ tʰ uː v a
lievla	l i e̯ vː l a
lievlla	l i e̯ v l l a
lievssi	l i e̯ v s s iː
lieđbmi	l i e̯ ðː p m iː
lieđđi	l i e̯ ð ð iː
lieđđut	l i e̯ ð ð uː h t
lihkkat	l i hː k a h t
lihpi	l i h p iː
lihppu	l i hː p uː
lihtter	l i hː t e r
liidni	l i jː t n iː
liiki	l i jː k iː
liikot	l i jː k o h t
liippát	l i j p p aː h t
liiva	l i jː v a
limpu	l i mː p uː
linnjár	l i ɲː ɲ aː r
litium	l i tʰ iː u m
litnjat	l i t ɲ a h t
livčče	l i v t t͡ʃ e
livččen	l i v t t͡ʃ e n
livččet	l i v t t͡ʃ e h t
livččii	l i v t t͡ʃ i j
livččiide	l i v t t͡ʃ i j t e
livččiidet	l i v t t͡ʃ i j t e h t
livččiiga	l i v t t͡ʃ i j k a
livččiime	l i v t t͡ʃ i j m e
livččiimet	l i v t t͡ʃ i j m e h t
liŋka	l i ŋː k a
loahppa	l o ɑ̯ hː p a
loahppat	l o ɑ̯ hː p a h t
loaidat	l o ɑ̯ jː t a h t
loaidu	l o ɑ̯ jː t uː
loaktit	l o ɑ̯ kː t iː h t
loamši	l o ɑ̯ mː ʃ iː
loapmi	l o ɑ̯ p m iː
loatna	l o ɑ̯ t n a
loavdda	l o ɑ̯ vː t t a
loavdit	l o ɑ̯ vː t iː h t
loađgu	l o ɑ̯ ðː k uː
loažži	l o ɑ̯ dː d͡ʒ iː
lobi	l o p iː
lobis	l o p iː s
loddi	l o dː d iː
lodji	l o ɟ ɟ iː
loga	l o k a
logai	l o k a j
logan	l o k a n
logat	l o k a h t
logi	l o k iː
logu	l o k uː
logus	l o k uː s
logát	l o k aː h t
lohkat	l o h k a h t
lohku	l o h k uː
lohpi	l o h p iː
lohpidit	l o h p iː t i h t
lohtat	l o h t a h t
loktat	l o kː t a h t
lokte	l o kː t e
lokten	l o kː t e n
loktit	l o kː t iː h t
lono	l o n o
losimus	l o s iː m u s
losit	l o s iː h t
lossa	l o s s a
lossadeamos	l o s s a t e̯ a m o s
lossadit	l o s s a t i h t
lossat	l o s s a h t
losses	l o sː s e s
lotnut	l o t n uː h t
lotti	l o t t iː
lottiid	l o t t i j t
lottáš	l o t t aː ʃ
lovde	l oː vː t e
lođa	l o ð a
luddat	l u dː d a h t
luhkka	l u hː k a
luike	l uː jː k e
luiken	l uː jː k e n
luiste	l u jː s t e
luite	l uː jː t e
luiten	l uː jː t e n
luli	l u l iː
lulli	l u l l iː
lullisámegiella	l u l l iː s aˑ m e k i e̯ l l a
lumma	l u mː m a
lunddolaččat	l uː nː t t o l a t t͡ʃ a h t
lunddolaš	l uː nː t t o l a ʃ
luodda	l u o̯ dː d a
luoddut	l u o̯ dː d uː h t
luohti	l u o̯ h t iː
luohttit	l u o̯ hː t iː h t
luoikat	l u o̯ jː k a h t
luoitit	l u o̯ jː t iː h t
luoittu	l u o̯ j t t uː
luoitu	l u o̯ jː t uː
luokta	l u o̯ kː t a
luokčat	l u o̯ kː t͡ʃ a h t
luomi	l u o̯ m iː
luomin	l u o̯ m iː n
luondu	l u o̯ nː t uː
luopmu	l u o̯ p m uː
luossa	l u o̯ s s a
luotkkos	l u̯ o t k o s
luotkkus	l u o̯ t k uː s
luotni	l u o̯ t n iː
luovdi	l u o̯ vː t iː
luovos	l u̯ o v o s
luovus	l u o̯ v uː s
lutkoseamos	l uː tː k o s e̯ a m o s
lutkosit	l uː tː k o s i h t
lutnjat	l u t ɲ a h t
lábbá	l aː bː b aː
lágut	l aː k uː h t
láhji	l aː j̥ iː
láhppi	l aː hː p iː
láhppit	l aː hː p iː h t
láhppot	l aː hː p o h t
láhppu	l aː hː p uː
láhtti	l aː hː t iː
láhčit	l aː h t͡ʃ iː h t
láibi	l aː jː p iː
láibu	l aː jː p uː
láibut	l aː jː p uː h t
láigohit	l aː jː k o h i h t
láigu	l aː jː k uː
láiki	l aː jː k iː
láikkes	l aˑ j k k e s
láikkimus	l aː j k k iː m u s
láikkit	l aː j k k iː h t
láiká	l aː jː k aː
láitit	l aː jː t iː h t
lákca	l aː kː t͡s a
lákcut	l aː kː t͡s uː h t
láktat	l aː kː t a h t
lállit	l aː l l iː h t
lánto	l aː nː t o
láppis	l aː p p iː s
láse	l aː s e
látna	l aː t n a
látvia	l aː tː v iː a
lávgut	l aː vː k uː h t
lávka	l aː vː k a
lávki	l aː vː k iː
lávlagan	l aː vː l a k a n
lávlagat	l aː vː l a k a h t
lávlageame	l aː vː l a k e̯ a m e
lávlageamet	l aː vː l a k e̯ a m e h t
lávlageaset	l aː vː l a k e̯ a s e h t
lávlageaskka	l aː vː l a k e a̯ s k a
lávlageatte	l aː vː l a k e̯ a t t e
lávlageattet	l aː vː l a k e̯ a t t e h t
lávlagis	l aː vː l a k i s
lávlla	l aː v l l a
lávlut	l aː vː l uː h t
lávvardat	l aː v v a r t a h t
lávvordat	l aː v v o r t a h t
lávži	l aː vː t͡ʃ iː
láđđi	l aː ð ð iː
magnesium	m a kː n eː s i uː m
mahkkit	m a hː k iː h t
maid	m a j t
maiddái	m a jː t t aː j
malediivvat	m a l e t i j v v a h t
mana	m a n a
manai	m a n a j
manale	m a n a l e
manan	m a n a n
manat	m a n a h t
manin	m a n iː n
mannagoahtit	m a n n a k o ɑ̯ h t iː h t
mannan	m a n n a n
mannat	m a n n a h t
manne	m a n n e
mannen	m a n n e n
mannet	m a n n e h t
manni	m a nː n iː
mannji	m a ɲ ɲ iː
mannos	m a n n o s
mannut	m a nː n uː h t
marokko	m a r o k k o
marshallsullot	m a rː s h a l l s u l l o h t
massit	m a sː s iː h t
mauretánia	m a uː r e tʰ aː n i a
maŋimus	m a ɲ iː m u s
maŋis	m a ɲ iː s
maŋit	m a ɲ iː h t
maŋos	m a ɲ o s
maŋŋebárga	m a ŋ ɲ e p aː rː k a
maŋŋel	m a ŋ ɲ e l
maŋŋidis	m a ŋ ɲ iː t i s
maŋŋil	m a ŋ ɲ iː l
maŋŋit	m a ŋ ɲ iː h t
maŋŋá	m a ŋ ɲ aː
meaddit	m e a̯ dː d iː h t
meahcci	m e a̯ hː t͡s iː
meahkástat	m e a̯ h k aː s t a h t
meara	m e a̯ r a
mearaguolli	m e a̯ r a k u o̯ l l iː
mearas	m e a̯ r a s
mearat	m e a̯ r a h t
meardi	m e a̯ rː t iː
mearka	m e a̯ rː k a
mearkkašit	m e a̯ r k k a ʃ i h t
mearra	m e a̯ r r a
meaštár	m e a̯ ʃː t aː r
media	m e t iː a
mehter	m eː h t e r
mette	m eː t t e
midjiide	m i ɟ ɟ i j t e
miehkki	m i e̯ hː k iː
miehta	m i e̯ h t a
miehtat	m i e̯ h t a h t
miehtá	m i e̯ h t aː
miekta	m i e̯ kː t a
miela	m i e̯ l a
mielas	m i e̯ l a s
mielddus	m i e̯ lː t t uː s
mielde	m i̯ e lː t e
mielga	m i e̯ lː k a
mielki	m i e̯ lː k iː
miella	m i e̯ l l a
mielli	m i e̯ lː l iː
mierká	m i e̯ rː k aː
miessemánnu	m i̯ e s s e m aː n n uː
miessi	m i e̯ s s iː
mihcamárat	m i h t͡s a m aː r a h t
mihtidit	m i h t iː t i h t
mii	m i j
miljovdna	m i ʎ ʎ o v t n a
millu	m i lː l uː
min	m iː n
minguin	m iː nː k u j n
minin	m iː n iː n
minta	m i nː t a
mirkko	m i r k k o
mirku	m i rː k uː
mis	m iː s
mo	m oː
moai	m o ɑ̯ j
moardit	m o ɑ̯ rː t iː h t
moarsi	m o ɑ̯ rː s iː
moddját	m o ɟː ɟ aː h t
modernisma	m o t e r n i sː m a
modernista	m o t e r n i sː t a
mohkki	m o hː k iː
mohkkái	m o hː k aː j
mohkkámus	m o hː k aː m u s
moivi	m o jː v iː
mokta	m o kː t a
mola	m o l a
molai	m o l a j
molale	m o l a l e
molan	m o l a n
molat	m o l a h t
mollat	m o l l a h t
molle	m o l l e
mollen	m o l l e n
mollet	m o l l e h t
molli	m o lː l iː
mollit	m o lː l iː h t
molljut	m o ʎː ʎ uː h t
molybdena	m o lː y p t eː n a
mon	m o n
moni	m o n iː
moniin	m o n i j n
monni	m o n n iː
morde	m oː rː t e
morden	m oː rː t e n
mordet	m oː rː t e h t
mordon	m oː rː t o n
mordos	m oː rː t o s
morša	m o rː ʃ a
moskva	m o sː k v a
moskát	m o sː k aː h t
movt	m o v h t
mođđat	m o ð ð a h t
mođđi	m o ð ð iː
mu	m uː
mugga	m u ɡː ɡ a
muhkki	m u hː k iː
muhtin	m u h t iː n
muhto	m u h t o
muhttit	m u hː t iː h t
muhtun	m u h t uː n
muinna	m u j n n a
muitaleaddji	m u jː t a l e a̯ ɟː ɟ iː
muitalit	m u jː t a l i h t
muitalus	m u jː t a l u s
muite	m u jː t e
muiten	m u jː t e n
muitit	m u jː t iː h t
muitos	m u jː t o s
muitte	m u j t t e
muitu	m u jː t uː
muitát	m u jː t aː h t
mulgut	m u lː k uː h t
mun	m u n
munin	m uː n iː n
munnje	m u ɲ ɲ e
munno	m u nː n o
munnon	m u nː n o n
munnos	m u nː n o s
munnuide	m u nː n u j t e
munnuin	m u nː n u j n
muoddá	m u o̯ dː d aː
muohta	m u o̯ h t a
muohtti	m u o̯ hː t iː
muohttit	m u o̯ hː t iː h t
muohttát	m u o̯ hː t aː h t
muohtu	m u o̯ h t uː
muolda	m u o̯ lː t a
muolddat	m u o̯ lː t t a h t
muoldu	m u o̯ lː t uː
muollat	m u o̯ l l a h t
muoná	m u o̯ n aː
muorji	m u o̯ rː j iː
muorra	m u o̯ r r a
muosát	m u o̯ s aː h t
muovla	m u o̯ vː l a
muovlla	m u o̯ v l l a
muoŧŧá	m u o̯ θ θ aː
murdit	m u rː t iː h t
mus	m uː s
musea	m u s e a̯
muvra	m u vː r a
muŋkát	m u ŋː k aː h t
máddi	m aː dː d iː
mádjit	m aː ɟ ɟ iː h t
mággá	m aː ɡː ɡ aː
máhccat	m aː hː t͡s a h t
máhccut	m aː hː t͡s uː h t
máhttit	m aː hː t iː h t
máhtu	m aː h t uː
máidnu	m aː jː t n uː
máidnut	m aː jː t n uː h t
máihli	m aː jː l̥ iː
máilbmi	m aː jː l p m iː
máilmmicup	m aː j l m m iː t͡s u p
máilmmicupa	m aː j l m m iː t͡s u pʰ a
máilmmiávus	m aː j l m m iː aː v uː s
máilmmiávvosa	m aː j l m m iː aː v v o s a
máinnas	m aː j n n a s
máinnastit	m aː j n n a s t i h t
máisa	m aː jː s a
máivi	m aː jː v iː
máksit	m aː kː s iː h t
málet	m aː l e h t
málle	m aː lː l e
málli	m aː l l iː
málta	m aː lː t a
máltit	m aː lː t iː h t
mánnat	m aː n n a h t
mánnodat	m aː n n o t a h t
mánnu	m aː n n uː
mánná	m aː n n aː
mánnávuohta	m aː n n aː v u o̯ h t a
mánus	m aː n uː s
mánáidgárdi	m aː n aː j t k aː rː t iː
mánálaš	m aː n aː l a ʃ
márfi	m aː rː f iː
márfut	m aː rː f uː h t
márjá	m aː rː j aː
mártá	m aː rː t aː
mátki	m aː tː k iː
mátkkoštit	m aː t k o ʃ t i h t
mátta	m aː t t a
máttanuorta	m aː t t a n u o̯ rː t a
máttanuorti	m aː t t a n u o̯ rː t iː
máttaoarji	m aː t t a o ɑ̯ rː j iː
máttasámegiella	m aː t t a s aˑ m e k i e̯ l l a
máze	m aː t͡s e
máŋga	m aː ŋː k a
máššat	m aː ʃ ʃ a h t
na	n a
nagir	n a k iː r
nahkihit	n a h k iː h i h t
nakšát	n a kː ʃ aː h t
nallat	n a l l a h t
nalttas	n a l t t a s
namma	n a m m a
nannet	n a nː n e h t
nanosmahttit	n a n o s m a hː t iː h t
nanosmit	n a n o s m i h t
nanus	n a n uː s
nappo	n a p p o
narge	n a rː k e
nargit	n a rː k iː h t
nas	n a s
nasisma	n a s iː s m a
natrium	n a tː r iː u m
navdit	n a vː t iː h t
nave	n a v e
navvit	n a v v iː h t
nazisma	n a t͡s iː s m a
nađđa	n a ð ð a
neahpi	n e a̯ h p iː
neahtta	n e a̯ hː t a
nealgi	n e a̯ lː k iː
nealgut	n e a̯ lː k uː h t
nearrat	n e a̯ r r a h t
nearva	n e a̯ rː v a
neavri	n e a̯ vː r iː
neavrres	n e̯ a v r r e s
negatiiva	n e k a tʰ i jː v a
neon	n eː o n
nie	n i e̯
niegadit	n i e̯ k a t i h t
nieida	n i e̯ jː t a
nieidda	n i e̯ jː t t a
nierra	n i e̯ r r a
nihkkel	n i hː k e l
nihlla	n i l̥ l̥ a
nihttit	n i hː t iː h t
niibi	n i jː p iː
niillas	n i j l l a s
niitit	n i jː t iː h t
niittu	n i j t t uː
niitu	n i jː t uː
niski	n i sː k iː
nissonolmmoš	n i s s o n o l m m o ʃ
nisu	n i s uː
nisun	n i s uː n
njahppit	ɲ a hː p iː h t
njala	ɲ a l a
njaldit	ɲ a lː t iː h t
njalgat	ɲ a lː k a h t
njalla	ɲ a l l a
njallat	ɲ a l l a h t
njamat	ɲ a m a h t
njammat	ɲ a m m a h t
njammot	ɲ a mː m o h t
njanzát	ɲ a nː t͡s aː h t
njartat	ɲ a rː t a h t
njassat	ɲ a s s a h t
njavge	ɲ a vː k e
njaŋgát	ɲ a ŋː k aː h t
njealját	ɲ e a̯ ʎ ʎ aː h t
njeallje	ɲ e̯ a ʎː ʎ e
njeazzát	ɲ e a̯ dː d͡z aː h t
njeađgat	ɲ e a̯ ðː k a h t
njelot	ɲ eː l o h t
njiedjat	ɲ i e̯ ɟ ɟ a h t
njiellat	ɲ i e̯ l l a h t
njierrá	ɲ i e̯ r r aː
njirvat	ɲ i rː v a h t
njivli	ɲ i vː l iː
njivlla	ɲ i v l l a
njižži	ɲ i dː d͡ʒ iː
njoahci	ɲ o ɑ̯ h t͡s iː
njoahcut	ɲ o ɑ̯ h t͡s uː h t
njoallut	ɲ o ɑ̯ l l uː h t
njoalpi	ɲ o ɑ̯ lː p iː
njoammil	ɲ o ɑ̯ m m iː l
njoammut	ɲ o ɑ̯ m m uː h t
njoarostit	ɲ o̯ ɑ r o s t i h t
njoarrat	ɲ o ɑ̯ r r a h t
njoazes	ɲ o̯ ɑ t͡s e s
njoazimus	ɲ o ɑ̯ t͡s iː m u s
njoazit	ɲ o ɑ̯ t͡s iː h t
njohcut	ɲ o h t͡s uː h t
njozet	ɲ oː t͡s e h t
njuiken	ɲ u jː k e n
njuiket	ɲ u jː k e h t
njuikut	ɲ u jː k uː h t
njukča	ɲ u kː t͡ʃ a
njukčamánnu	ɲ u kː t͡ʃ a m aː n n uː
njulges	ɲ uː lː k e s
njunni	ɲ u n n iː
njuolga	ɲ u o̯ lː k a
njuolgat	ɲ u o̯ lː k a h t
njuolggut	ɲ u o̯ lː k k uː h t
njuolgut	ɲ u o̯ lː k uː h t
njuolla	ɲ u o̯ l l a
njuorat	ɲ u o̯ r a h t
njuoratmánná	ɲ u o̯ r a t m aː n n aː
njuordat	ɲ u o̯ rː t a h t
njuorddut	ɲ u o̯ rː t t uː h t
njuorjju	ɲ u o̯ r j j uː
njuorju	ɲ u o̯ rː j uː
njuoršu	ɲ u o̯ rː ʃ uː
njuoska	ɲ u o̯ sː k a
njuoskaseamos	ɲ u o̯ sː k a s e̯ a m o s
njuoskasit	ɲ u o̯ sː k a s i h t
njuoskat	ɲ u o̯ sː k a h t
njuoskkas	ɲ u o̯ s k a s
njuovvat	ɲ u o̯ v v a h t
njuovčča	ɲ u o̯ v t t͡ʃ a
njurgut	ɲ u rː k uː h t
njuvdit	ɲ u vː t iː h t
njáhkat	ɲ aː h k a h t
njáhká	ɲ aː h k aː
njálbmi	ɲ aː lː p m iː
njáldit	ɲ aː lː t iː h t
njálggis	ɲ aː lː k k iː s
njálla	ɲ aː l l a
njálmmi	ɲ aː l m m iː
njárbat	ɲ aː rː p a h t
njárbe	ɲ aː rː p e
njárbes	ɲ aː rː p e s
njárbut	ɲ aː rː p uː h t
njávgit	ɲ aː vː k iː h t
njávgut	ɲ aː vː k uː h t
njávkat	ɲ aː vː k a h t
njáškát	ɲ aː ʃː k aː h t
noaidi	n o ɑ̯ jː t iː
noga	n o k a
nogai	n o k a j
nogat	n o k a h t
nohkan	n o h k a n
nohkat	n o h k a h t
nohkkat	n o hː k a h t
nolla	n o lː l a
nomen	n o m e n
nordan	n o rː t a n
nordat	n o rː t a h t
norde	n o rː t e
norden	n o rː t e n
nordon	n o rː t o n
norga	n o rː k a
nu	n uː
nubbi	n u bː b iː
nubbin	n u bː b iː n
nugo	n uː k o
nulle	n uː l l e
nullen	n uː l l e n
nullet	n uː l l e h t
nullos	n uː l l o s
nummir	n u m m iː r
nuohtti	n u o̯ hː t iː
nuollat	n u o̯ l l a h t
nuondat	n u o̯ nː t a h t
nuora	n u o̯ r a
nuoramus	n u o̯ r a m u s
nuorasmahttit	n u o̯ r a s m a hː t iː h t
nuorasmit	n u o̯ r a s m i h t
nuorat	n u o̯ r a h t
nuorra	n u o̯ r r a
nuorta	n u o̯ rː t a
nuortadavvi	n u o̯ rː t a t a v v iː
nuortalaš	n u o̯ rː t a l a ʃ
nuortalašgiella	n u o̯ rː t a l a ʃː k i e̯ l l a
nuortalašgillii	n u o̯ rː t a l a ʃː k iː l l i j
nuortalulli	n u o̯ rː t a l u l l iː
nuorti	n u o̯ rː t iː
nuorttu	n u o̯ r t t uː
nuortu	n u o̯ rː t uː
nuorvvu	n u o̯ r v v uː
nuppi	n u p p iː
ná	n aː
nábár	n aː p aː r
náhkki	n aː hː k iː
náhpi	n aː h p iː
náitit	n aː jː t iː h t
nála	n aː l a
nállat	n aː l l a h t
nállu	n aː l l uː
náráš	n aː r aː ʃ
násti	n aː sː t iː
návdi	n aː vː t iː
návli	n aː vː l iː
náđđut	n aː ð ð uː h t
náđđát	n aː ðː ð aː h t
náššat	n aː ʃ ʃ a h t
oabbá	o ɑ̯ bː b aː
oaddi	o ɑ̯ dː d iː
oadju	o ɑ̯ ɟ ɟ uː
oaggut	o ɑ̯ ɡː ɡ uː h t
oahci	o ɑ̯ h t͡s iː
oahkut	o ɑ̯ h k uː h t
oahpaheaddji	o ɑ̯ h p a h e a̯ ɟː ɟ iː
oahpahit	o ɑ̯ h p a h i h t
oahpes	o̯ ɑ h p e s
oahpis	o ɑ̯ h p iː s
oahppa	o ɑ̯ hː p a
oahppat	o ɑ̯ hː p a h t
oahppi	o ɑ̯ hː p iː
oahppáseamos	o ɑ̯ hː p aː s e̯ a m o s
oahppásit	o ɑ̯ hː p aː s i h t
oahpásmit	o ɑ̯ h p aː s m i h t
oaidnaleapmi	o ɑ̯ jː t n a l e a̯ p m iː
oaidnaleapmái	o ɑ̯ jː t n a l e a̯ p m aː j
oaidnalit	o ɑ̯ jː t n a l i h t
oaidnit	o ɑ̯ jː t n iː h t
oaidu	o ɑ̯ jː t uː
oaivi	o ɑ̯ jː v iː
oaksi	o ɑ̯ kː s iː
oakti	o ɑ̯ kː t iː
oalgi	o ɑ̯ lː k iː
oalle	o̯ ɑ l l e
oalli	o ɑ̯ l l iː
oallut	o ɑ̯ l l uː h t
oalul	o ɑ̯ l uː l
oalát	o ɑ̯ l aː h t
oanimus	o ɑ̯ n iː m u s
oanit	o ɑ̯ n iː h t
oapmet	o̯ ɑ p m e h t
oapmi	o ɑ̯ p m iː
oarbbis	o ɑ̯ rː p p iː s
oarjedavvi	o̯ ɑ rː j e t a v v iː
oarjelulli	o̯ ɑ rː j e l u l l iː
oarji	o ɑ̯ rː j iː
oarri	o ɑ̯ rː r iː
oasi	o ɑ̯ s iː
oasis	o ɑ̯ s iː s
oassi	o ɑ̯ s s iː
oastit	o ɑ̯ sː t iː h t
oatni	o ɑ̯ t n iː
oatnut	o ɑ̯ t n uː h t
oattes	o̯ ɑ t t e s
oattimus	o ɑ̯ t t iː m u s
oattit	o ɑ̯ t t iː h t
oađđit	o ɑ̯ ð ð iː h t
oažži	o ɑ̯ dː d͡ʒ iː
oažžut	o ɑ̯ dː d͡ʒ uː h t
odne	o dː n e
ohca	o h t͡s a
ohcat	o h t͡s a h t
ohpit	o h p iː h t
oide	o jː t e
oidit	o jː t iː h t
oksiida	o kː s i j t a
oksyderet	o kː s y t eː r e h t
oksygena	o kː s y k eː n a
okta	o kː t a
oktanuppelohkái	o kː t a n u p p e l o h k aː j
oktii	o kː t i j
okto	o kː t o
oktovuhtii	o kː t o v u h t i j
oktovuohta	o kː t o v u o̯ h t a
oktovuohtade	o kː t o v u o̯ h t a t e
oktovuohtadet	o kː t o v u o̯ h t a t e h t
oktovuohtame	o kː t o v u o̯ h t a m e
oktovuohtamet	o kː t o v u o̯ h t a m e h t
oktovuohtan	o kː t o v u o̯ h t a n
oktovuohtas	o kː t o v u o̯ h t a s
oktovuohtaset	o kː t o v u o̯ h t a s e h t
oktovuohtaska	o kː t o v u o̯ h t a s k a
oktovuohtat	o kː t o v u o̯ h t a h t
oktovuođa	o kː t o v u o̯ ð a
oktovuođaid	o kː t o v u o̯ ð a j t
oktovuođaide	o kː t o v u o̯ ð a j t e
oktovuođaiguin	o kː t o v u o̯ ð a j k u j n
oktovuođain	o kː t o v u o̯ ð a j n
oktovuođas	o kː t o v u o̯ ð a s
oktovuođat	o kː t o v u o̯ ð a h t
ole	o l e
olgeš	o lː k e ʃ
olggos	o lː k k o s
olgun	o lː k uː n
olii	o l i j
oliide	o l i j t e
oliidet	o l i j t e h t
oliiga	o l i j k a
oliime	o l i j m e
oliimet	o l i j m e h t
oliiva	o l i j v a
olis	o l iː s
olju	o lː j uː
olle	o l l e
ollen	o l l e n
ollet	o l l e h t
olli	o l l iː
olli	o lː l iː
olliba	o l l iː p a
ollibeahtti	o l l iː p e a̯ hː t iː
ollibehtet	o l l iː p eː h t e h t
ollis	o l l iː s
ollislaš	o l l iː s l a ʃ
ollit	o l l iː h t
ollo	oː l l o
ollon	o l l o n
ollon	oː l l o n
ollos	o l l o s
ollos	oː l l o s
olloset	o l l o s e h t
olloska	o l l o s k a
ollot	o l l o h t
ollu	o l l uː
ollu	o lː l uː
ollugat	o l l uː k a h t
ollut	o lː l uː h t
ollá	o l l aː
ollán	o l l aː n
olmmoš	o l m m o ʃ
olmmái	o l m m aː j
ološ	oː l o ʃ
olán	o l aː n
olát	o l aː h t
on	oː n
oppa	o p p a
oppal	o p p a l
optimisma	o pː t iː m i sː m a
optimista	o pː t iː m i sː t a
orda	o rː t a
ordi	o rː t iː
oro	o r o
orro	o r r o
orrut	o r r uː h t
oránša	o r aː n ʃ a
oseania	o s e a̯ n i a
osku	o sː k uː
oskut	o sː k uː h t
oste	oː sː t e
osten	oː sː t e n
oston	oː sː t o n
ostos	oː sː t o s
ostot	oː sː t o h t
ovcci	o v t t͡s iː
ovccát	o v t t͡s aː h t
ovdagovva	o vː t a k o v v a
ovdal	o vː t a l
ovdalaš	o vː t a l a ʃ
ovdamearka	o vː t a m e a̯ rː k a
ovddal	o vː t t a l
ovdánit	o vː t aː n i h t
ovllá	o v l l aː
ovttas	o v t t a s
ovttasbargat	o v t t a s p a rː k a h t
ovttastuvvat	o v t t a s t u v v a h t
oza	o t͡s a
ozan	o t͡s a n
ođas	o ð a s
ođasmahttit	o ð a s m a hː t iː h t
ođasmit	o ð a s m i h t
ođut	o ð uː h t
ođđa	o ð ð a
ođđadárogiella	o ð ð a t aˑ r o k i e̯ l l a
ođđajagimánnu	o ð ð a j a k iː m aː n n uː
ođđajahki	o ð ð a j a h k iː
ođđaseamos	o ð ð a s e̯ a m o s
ođđasit	o ð ð a s i h t
palestinalačča	pʰ a l e s t i n a l a t t͡ʃ a
palestinalaččaid	pʰ a l e s t i n a l a t t͡ʃ a j t
palestinalaččaide	pʰ a l e s t i n a l a t t͡ʃ a j t e
palestinalaččaiguin	pʰ a l e s t i n a l a t t͡ʃ a j k u j n
palestinalaččain	pʰ a l e s t i n a l a t t͡ʃ a j n
palestinalaččas	pʰ a l e s t i n a l a t t͡ʃ a s
palestinalaččat	pʰ a l e s t i n a l a t t͡ʃ a h t
palestinalaš	pʰ a l e s t i n a l a ʃ
palestinalažžan	pʰ a l e s t i n a l a dː d͡ʒ a n
palestinalažžii	pʰ a l e s t i n a l a dː d͡ʒ i j
paradiisa	pʰ a r a t i jː s a
partihkal	pʰ a rː t iː h k a l
peanna	pʰ e a̯ nː n a
peara	pʰ e a̯ r a
pessimisma	pʰ e s s iː m i sː m a
pessimista	pʰ e s s iː m i sː t a
piáno	pʰ i aː n o
planehta	p l a n eː h t a
platiidná	p l a tʰ i j t n aː
platina	p l a tʰ iː n a
poasta	pʰ o ɑ̯ sː t a
polen	pʰ o l e n
portugála	pʰ o rː t uː k aː l a
positiiva	pʰ o s iː tʰ i jː v a
predikatiiva	p r e t iː kʰ a tʰ i j v a
párka	pʰ aː rː k a
párra	pʰ aː r r a
párragaskavuohta	pʰ aː r r a k a sː k a v u o̯ h t a
raba	r a p a
raban	r a p a n
rabas	r a p a s
rabat	r a p a h t
raddi	r a dː d iː
rahkadis	r a h k a t i s
rahkat	r a h k a h t
rahkkes	r a hː k e s
rahpat	r a h p a h t
rahčat	r a h t͡ʃ a h t
rakeahtta	r a kʰ e a̯ hː t a
raksa	r a kː s a
ramas	r a m a s
rančát	r a nː t͡ʃ aː h t
rasisma	r a s iː s m a
rasista	r a s iː s t a
rassat	r a s s a h t
ratni	r a t n iː
ratti	r a t t iː
rattis	r a t t iː s
ravgat	r a vː k a h t
rašši	r a ʃ ʃ iː
raŧŧi	r a θ θ iː
reabbá	r e a̯ bː b aː
readnját	r e a̯ dː ɲ aː h t
reahcas	r e a̯ h t͡s a s
reahcci	r e a̯ hː t͡s iː
reahccut	r e a̯ hː t͡s uː h t
reahkut	r e a̯ h k uː h t
reahpen	r e a̯ h p e n
reaisu	r e a̯ jː s uː
reakci	r e a̯ kː t͡s iː
reakcut	r e a̯ kː t͡s uː h t
reavgit	r e a̯ vː k iː h t
reavgut	r e a̯ vː k uː h t
reavri	r e a̯ vː r iː
reavrut	r e a̯ vː r uː h t
reavrát	r e a̯ vː r aː h t
reavvat	r e a̯ v v a h t
reaŋga	r e a̯ ŋː k a
reašmi	r e a̯ ʃː m iː
reddjo	r e ɟː ɟ o
regole	r eː k o l e
rehppo	r e hː p o
reive	r e jː v e
reŋgot	r e ŋː k o h t
reŋko	r e ŋː k o
riddu	r i dː d uː
rieban	r i e̯ p a n
riedja	r i e̯ ɟ ɟ a
riegádanbeaivi	r i e̯ k aː t a nː p e a̯ j v i
riegádit	r i e̯ k aː t i h t
riehpat	r i e̯ h p a h t
riehpu	r i e̯ h p uː
riektat	r i e̯ kː t a h t
riekti	r i e̯ kː t iː
riepmat	r i e̯ p m a h t
riessat	r i e̯ s s a h t
rievdadit	r i e̯ vː t a t i h t
rievdadus	r i e̯ vː t a t u s
rievdat	r i e̯ vː t a h t
rievdnu	r i e̯ vː t n uː
rievnnu	r i e̯ v n n uː
rievssat	r i e̯ v s s a h t
rievtti	r i e̯ v t t iː
riggat	r i ɡː ɡ a h t
riggi	r i ɡː ɡ iː
riggut	r i ɡː ɡ uː h t
rihccut	r i hː t͡s uː h t
rihcit	r i h t͡s iː h t
rihpa	r i h p a
rihpat	r i h p a h t
rihta	r i h t a
rihtu	r i h t uː
riibat	r i jː p a h t
riidu	r i jː t uː
riika	r i jː k a
riikkat	r i j k k a h t
riipu	r i jː p uː
riitát	r i jː t aː h t
rikkes	r i k k e s
rikkis	r i k k iː s
riktes	r iː kː t e s
rimsi	r i mː s iː
rinči	r i nː t͡ʃ iː
rinčát	r i nː t͡ʃ aː h t
rissi	r i sː s iː
risten	r i sː t e n
risttalaš	r i s t a l a ʃ
ritni	r i t n iː
rivgu	r i vː k uː
rišša	r i ʃ ʃ a
rišša	r i ʃː ʃ a
riššu	r i ʃ ʃ uː
roabát	r o ɑ̯ p aː h t
roadda	r o ɑ̯ dː d a
roahttu	r o ɑ̯ hː t uː
roaibut	r o ɑ̯ jː p uː h t
roakči	r o ɑ̯ kː t͡ʃ iː
roandit	r o ɑ̯ nː t iː h t
roavgu	r o ɑ̯ vː k uː
roađđi	r o ɑ̯ ð ð iː
roggat	r o ɡː ɡ a h t
rogge	r o ɡː ɡ e
roggen	r o ɡː ɡ e n
roggi	r o ɡː ɡ iː
rohttu	r o hː t uː
rohtu	r o h t uː
rohči	r o h t͡ʃ iː
rokkan	r o k k a n
romeo	r o m e o
romes	r o m e s
romi	r o m iː
romimus	r o m iː m u s
romis	r o m iː s
romit	r o m iː h t
romsa	r o mː s a
ropmi	r o p m iː
rotnu	r o t n uː
roŋge	r o ŋː k e
ruhta	r u h t a
ruhttu	r u hː t uː
ruibi	r u jː p iː
ruitu	r u jː t uː
ruivi	r u jː v iː
rujosmit	r uː j o s m i h t
rukses	r uː kː s e s
rumaš	r u m a ʃ
ruobbi	r u o̯ bː b iː
ruobbut	r u o̯ bː b uː h t
ruodjat	r u o̯ ɟ ɟ a h t
ruodnát	r u o̯ dː n aː h t
ruohtas	r u o̯ h t a s
ruohtat	r u o̯ h t a h t
ruohtta	r u o̯ hː t a
ruohttat	r u o̯ hː t a h t
ruoida	r u o̯ jː t a
ruoidna	r u o̯ jː t n a
ruoidnat	r u o̯ jː t n a h t
ruoidnát	r u o̯ jː t n aː h t
ruoinnas	r u o̯ j n n a s
ruoivát	r u o̯ jː v aː h t
ruojus	r u o̯ j uː s
ruoksadeamos	r u o̯ kː s a t e̯ a m o s
ruoksadit	r u o̯ kː s a t i h t
ruoksat	r u o̯ kː s a h t
ruoksi	r u o̯ kː s iː
ruoksát	r u o̯ kː s aː h t
ruoktot	r u̯ o kː t o h t
ruoktu	r u o̯ kː t uː
ruokŋa	r u o̯ t ɲ a
ruolla	r u o̯ lː l a
ruonas	r u o̯ n a s
ruoná	r u o̯ n aː
ruonámus	r u o̯ n aː m u s
ruonát	r u o̯ n aː h t
ruopma	r u o̯ p m a
ruossa	r u o̯ sː s a
ruossat	r u o̯ s s a h t
ruossut	r u o̯ s s uː h t
ruosta	r u o̯ sː t a
ruovda	r u o̯ vː t a
ruovddi	r u o̯ vː t t iː
ruovdi	r u o̯ vː t iː
ruovgat	r u o̯ vː k a h t
ruovji	r u o̯ vː j iː
ruovttoluotta	r u̯ o v t t o l u o̯ t t a
ruoškit	r u o̯ ʃː k iː h t
ruošša	r u o̯ ʃː ʃ a
ruoššastit	r u o̯ ʃ ʃ a s t i h t
ruošši	r u o̯ ʃ ʃ iː
ruoŧagiella	r u o̯ θ a k i e̯ l l a
ruoŧŧa	r u o̯ θ θ a
ruoŧŧelaš	r u̯ o θ θ e l a ʃ
rusena	r u s e n a
ruskat	r u sː k a h t
russat	r u s s a h t
russo	r uː s s o
russos	r uː s s o s
rusta	r u sː t a
rustát	r u sː t aː h t
ruvdet	r u vː t e h t
ruvdet	r uː vː t e h t
ruvke	r u vː k e
ruvvet	r u vː v e h t
ruŋkit	r u ŋː k iː h t
ruškadeamos	r u ʃː k a t e̯ a m o s
ruškadit	r u ʃː k a t i h t
ruškat	r u ʃː k a h t
ruškes	r u ʃː k e s
ruškkut	r u ʃ k uː h t
rušpi	r u ʃː p iː
ruššat	r u ʃ ʃ a h t
ráddi	r aː dː d iː
ráddut	r aː dː d uː h t
rádio	r aː t iː o
rádjat	r aː ɟ ɟ a h t
rádji	r aː ɟ ɟ iː
rádju	r aː ɟ ɟ uː
rádná	r aː dː n aː
ráfi	r aː f iː
ráhkadit	r aː h k a t i h t
ráhkes	r aˑ h k e s
ráhkestit	r aˑ h k e s t i h t
ráhkesvuohta	r aː h k e s v u o̯ h t a
ráhkis	r aː h k iː s
ráhkistit	r aː h k iː s t i h t
ráhkistuvvat	r aː h k iː s t u v v a h t
ráhkisvuohta	r aː h k iː s v u o̯ h t a
ráhkkáseamos	r aː hː k aː s e̯ a m o s
ráhkkásit	r aː hː k aː s i h t
ráhpis	r aː h p iː s
ráhput	r aː h p uː h t
ráhpásmit	r aː h p aː s m i h t
ráhččat	r aː hː t͡ʃ a h t
ráidu	r aː jː t uː
ráigi	r aː jː k iː
rájes	r aˑ j e s
ráksá	r aː kː s aː
rámbi	r aː mː p iː
rámbut	r aː mː p uː h t
ránes	r aˑ n e s
ránis	r aː n iː s
rápmi	r aː p m iː
rássi	r aː s s iː
rásttis	r aː s t iː s
rátkit	r aː tː k iː h t
rátnu	r aː t n uː
rátnáseamos	r aː t n aː s e̯ a m o s
rátnásit	r aː t n aː s i h t
rávdná	r aː vː t n aː
rávdu	r aː vː t uː
rávis	r aː v iː s
rávkat	r aː vː k a h t
rávki	r aː vː k iː
ráššu	r aː ʃ ʃ uː
rážžat	r aː dː d͡ʒ a h t
sabet	s a p e h t
sadden	s a dː d e n
saddit	s a dː d iː h t
saddos	s a dː d o s
sadje	s a ɟ ɟ e
sadji	s a ɟ ɟ iː
sadjit	s a ɟ ɟ iː h t
sahkanit	s a h k a n i h t
sahkat	s a h k a h t
sahá	s a h aː
sahát	s a h aː h t
sahčat	s a h t͡ʃ a h t
saje	s a j e
saját	s a j aː h t
sakka	s a k k a
salgat	s a lː k a h t
salla	s a l l a
salla	s a lː l a
sallit	s a l l iː h t
sallut	s a l l uː h t
salomonsullot	s a l o m o nː s uː l l o h t
sarcut	s a rː t͡s uː h t
sarri	s a r r iː
sarrit	s a r r iː h t
sarva	s a rː v a
sarvva	s a r v v a
satmi	s a tː m iː
satte	s a t t e
save	s a v e
savu	s a v uː
savvi	s a vː v iː
savvit	s a v v iː h t
saŋas	s a ɲ a s
seaggi	s e a̯ ɡː ɡ iː
seahkka	s e a̯ hː k a
seaibi	s e a̯ jː p iː
seaidni	s e a̯ jː t n iː
seailut	s e a̯ jː l uː h t
seakti	s e a̯ kː t iː
sealgi	s e a̯ lː k iː
searvevuohta	s e̯ a rː v e v u o̯ h t a
searvi	s e a̯ rː v iː
seassat	s e a̯ s s a h t
seavvit	s e a̯ v v iː h t
sehkket	s eː hː k e h t
seksa	s e kː s a
sekunda	s e kʰ uː n t a
sekšuvdna	s e kː ʃ uː v t n a
senet	s eː n e h t
sevdnjes	s eː vː t ɲ e s
sevnnjodeapmi	s eː v ɲ ɲ o t e a̯ p m iː
sevnnjodit	s eː v ɲ ɲ o t i h t
seychellsullot	s e yː t͡s h e l l s u l l o h t
siedja	s i e̯ ɟ ɟ a
siehppa	s i e̯ hː p a
siekŋa	s i e̯ t ɲ a
siellu	s i e̯ l l uː
siessá	s i e̯ s s aː
sieđga	s i e̯ ðː k a
sihke	s i h k e
sihkkut	s i hː k uː h t
sihtat	s i h t a h t
sii	s i j
siida	s i jː t a
siidu	s i jː t uː
siivu	s i jː v uː
sikta	s i kː t a
silba	s i lː p a
sildi	s i lː t iː
silisium	s i l iː s i uː m
silki	s i lː k iː
silkin	s i lː k iː n
silkki	s i l k k iː
silli	s i l l iː
silli	s i lː l iː
sisa	s i s a
sisdoallat	s i sː t o ɑ̯ l l a h t
sisdoallu	s i sː t o ɑ̯ l l u
sitnu	s i t n uː
sivlu	s i vː l uː
skaipi	s k a jː p iː
skuolfi	s k u o̯ lː f iː
skurtnjas	s k u r t ɲ a s
skuvla	s k u vː l a
skuvladállu	s k u vː l a t aː l l uː
skábma	s k aː bː m a
skábmamánnu	s k aː bː m a m aː n n uː
slovákia	s l o v aː kʰ i a
smáhket	s m aː h k e h t
snielut	s n i e̯ l uː h t
snávggut	s n aː vː k k uː h t
soabbi	s o ɑ̯ bː b iː
soabbut	s o ɑ̯ bː b uː h t
soadji	s o ɑ̯ ɟ ɟ iː
soahki	s o ɑ̯ h k iː
soahpat	s o ɑ̯ h p a h t
soahti	s o ɑ̯ h t iː
soai	s o ɑ̯ j
soallut	s o ɑ̯ l l uː h t
soarvi	s o ɑ̯ rː v iː
soavli	s o ɑ̯ vː l iː
soađis	s o ɑ̯ ð iː s
soddjil	s o ɟː ɟ iː l
sodjat	s o ɟ ɟ a h t
sohka	s o h k a
sohkar	s o h k a r
sohpat	s o h p a h t
sopmu	s o p m uː
sorbmi	s o rː p m iː
sorjavaš	s o rː j a v a ʃ
sotnabeaivi	s o t n a p e a̯ jː v iː
speadjal	s p e a̯ ɟ ɟ a l
speažži	s p e a̯ dː d͡ʒ iː
speažžut	s p e a̯ dː d͡ʒ uː h t
spiidni	s p i jː t n iː
spiral	s p i r a l
spábba	s p aː bː b a
spáillit	s p aː j l l iː h t
spártu	s p aː rː t uː
stašuvdna	s t a ʃ uː v t n a
stetoskohppa	s t e t o s k o h pː ɑ
stoagus	s t o ɑ̯ k uː s
stoahkat	s t o ɑ̯ h k a h t
stoarbma	s t o ɑ̯ rː p m a
studio	s t u t iː o
stuorra	s t u o̯ rː r a
stuđeret	s t u ð eː r e h t
stáđásmit	s t aː ð aː s m i h t
submi	s u bː m iː
suddat	s u dː d a h t
suddit	s u dː d iː h t
sudja	s u ɟ ɟ a
suffá	s u f f aː
suga	s u k a
sugai	s u k a j
sugan	s u k a n
sugat	s u k a h t
suhkat	s u h k a h t
suhkkes	s uː hː k e s
suhkkát	s u hː k aː h t
suhpi	s u h p iː
suhttat	s u hː t a h t
suhči	s u h t͡ʃ iː
sulla	s u l l a
sullii	s u l l i j
suodji	s u o̯ ɟ ɟ iː
suoggat	s u o̯ ɡː ɡ a h t
suohkan	s u o̯ h k a n
suohkandearvvašvuođabálvalus	s u o̯ h k a n t e a̯ r v v a ʃ v u o̯ ð a p aː lː v a l u s
suohkat	s u o̯ h k a h t
suohkku	s u o̯ hː k uː
suohpput	s u o̯ hː p uː h t
suohtas	s u o̯ h t a s
suoidnemánnu	s u̯ o jː t n e m aː n n uː
suoidni	s u o̯ jː t n iː
suoksa	s u o̯ kː s a
suola	s u o̯ l a
suoldni	s u o̯ lː t n iː
suollit	s u o̯ l l iː h t
suolu	s u o̯ l uː
suomagiella	s u o̯ m a k i e̯ l l a
suomastit	s u o̯ m a s t i h t
suonjar	s u o̯ ɲ a r
suonjardeapmi	s u o̯ ɲ a r t e a̯ p m iː
suonjardit	s u o̯ ɲ a r t i h t
suopma	s u o̯ p m a
suorbma	s u o̯ rː p m a
suorgi	s u o̯ rː k iː
suossa	s u o̯ s s a
suossat	s u o̯ s s a h t
suotna	s u o̯ t n a
suotnju	s u o̯ t ɲ uː
suovdi	s u o̯ vː t iː
suovdnji	s u o̯ vː t ɲ iː
suovnnji	s u o̯ v ɲ ɲ iː
suovssa	s u o̯ v s s a
suovva	s u o̯ v v a
suovvi	s u o̯ v v iː
suovvi	s u o̯ vː v iː
suovvái	s u o̯ vː v aː j
suođđat	s u o̯ ð ð a h t
suvri	s u vː r iː
suvrra	s u v r r a
suvrris	s u v r r iː s
symmetria	s y m m e tː r iː a
sábin	s aː p iː n
sáddet	s aː dː d e h t
sága	s aː k a
sággat	s aː ɡː ɡ a h t
sággi	s aː ɡː ɡ iː
sáhcu	s aː h t͡s uː
sáhcut	s aː h t͡s uː h t
sáhka	s aː h k a
sáhkohit	s aˑ h k o h i h t
sáhppadeamos	s aː hː p a t e̯ a m o s
sáhppadit	s aː hː p a t i h t
sáhppat	s aː hː p a h t
sáhppes	s aː hː p e s
sáhppi	s aː hː p iː
sáhpán	s aː h p aː n
sáhte	s aˑ h t e
sáhtii	s aː h t i j
sáhttit	s aː hː t iː h t
sáibma	s aː jː p m a
sáibu	s aː jː p uː
sáidi	s aː jː t iː
sáiti	s aː jː t iː
sáiva	s aː jː v a
sáivi	s aː jː v iː
sákta	s aː kː t a
sálbma	s aː lː p m a
sálga	s aː lː k a
sálti	s aː lː t iː
sámegiel	s aˑ m e k i e̯ l
sámegielat	s aˑ m e k i e̯ l a h t
sámegiella	s aˑ m e k i e̯ l l a
sámi	s aː m iː
sámmol	s aː m m o l
sámástit	s aː m aː s t i h t
sápmelaš	s aˑ p m e l a ʃ
sápmi	s aː p m iː
sárdni	s aː rː t n iː
sárdnideaddji	s aː rː t n iː t e a̯ ɟː ɟ iː
sárdnideapmi	s aː rː t n iː t e a̯ p m iː
sárdnidit	s aː rː t n iː t i h t
sárdnut	s aː rː t n uː h t
sárggis	s aː rː k k iː s
sárgi	s aː rː k iː
sárgun	s aː rː k uː n
sárgut	s aː rː k uː h t
sárrat	s aː r r a h t
sárá	s aː r aː
sátnegirji	s aˑ t n e k i rː j iː
sátni	s aː t n iː
sáttoáhpi	s aˑ t t o aː h p iː
sáttu	s aː t t uː
sávaldat	s aː v a l t a h t
sávri	s aː vː r iː
sávvat	s aː v v a h t
sávza	s aː vː t͡s a
sávzza	s aː vː t t͡s a
sáđđat	s aː ð ð a h t
tatoveret	tʰ a tʰ o v eː r e h t
teaksta	tʰ e a̯ kː s t a
teavsttat	tʰ e a̯ v s t a h t
teknologiija	tʰ e kː n o l o k i j j a
tellur	tʰ e l l uː r
teret	tʰ eː r e h t
terminologiija	tʰ e rː m iː n o l o k i j j a
thaieana	tʰ a j e a̯ n a
toardna	tʰ o ɑ̯ rː t n a
toga	tʰ oː k a
távval	tʰ aː v v a l
táŋka	tʰ aː ŋː k a
ubmi	u bː m iː
uhcci	u hː t͡s iː
uhkki	u hː k iː
uksa	u kː s a
ullu	u lː l uː
ungár	u nː k aː r
uniovdna	u n iː o vː t n a
unni	u nː n iː
unnán	u nː n aː n
urána	u r aː n a
vadjat	v a ɟ ɟ a h t
vahca	v a h t͡s a
vahcut	v a h t͡s uː h t
vahkat	v a h k a h t
vahkku	v a hː k uː
vai	v a j
vaikko	v a j k k o
vajálduhttit	v a j aː l t u hː t iː h t
vajálduvvat	v a j aː l t u v v a h t
valli	v a l l iː
vallji	v a ʎː ʎ iː
valvi	v a lː v iː
vanas	v a n a s
vardit	v a rː t iː h t
vardát	v a rː t aː h t
varra	v a r r a
varraliiki	v a r r a l i jː k iː
varraserum	v a r r a s e r uː m
vatikána	v a tʰ iː kʰ aː n a
vatnat	v a t n a h t
vađđa	v a ð ð a
vašálaččamus	v a ʃ aː l a t t͡ʃ a m u s
vašálaččat	v a ʃ aː l a t t͡ʃ a h t
vašálaš	v a ʃ aː l a ʃ
vašáleamos	v a ʃ aː l e̯ a m o s
vašálit	v a ʃ aː l i h t
vašši	v a ʃ ʃ iː
veaddi	v e a̯ dː d iː
veaddit	v e a̯ dː d iː h t
veadjemeahttun	v e̯ a ɟ ɟ e m e a̯ hː t uː n
veadjemeahttunvuohta	v e̯ a ɟ ɟ e m e a̯ hː t uː n v u o̯ h t a
veadjit	v e a̯ ɟ ɟ iː h t
veadju	v e a̯ ɟ ɟ uː
veahka	v e a̯ h k a
veahkehit	v e̯ a h k e h i h t
veahkki	v e a̯ hː k iː
veahá	v e a̯ h aː
veaháš	v e a̯ h aː ʃ
veahčir	v e a̯ h t͡ʃ iː r
veaigi	v e a̯ jː k iː
veaiki	v e a̯ jː k iː
veaittalas	v e a̯ j t t a l a s
veaiva	v e a̯ jː v a
veaksi	v e a̯ kː s iː
veakta	v e a̯ kː t a
vealgi	v e a̯ lː k iː
veallát	v e a̯ lː l aː h t
vealčut	v e a̯ lː t͡ʃ uː h t
veardi	v e a̯ rː t iː
vearju	v e a̯ rː j uː
vearri	v e a̯ r r iː
vearru	v e a̯ r r uː
veažir	v e a̯ t͡ʃ iː r
vejolaš	v eː j o l a ʃ
vejolašvuohta	v eː j o l a ʃː v u o̯ h t a
venus	v e n uː s
veret	v eː r e h t
video	v i t e o
viehkat	v i e̯ h k a h t
vielgat	v i e̯ lː k a h t
vieljabárdni	v i e̯ ʎ ʎ a p aː rː t n iː
viellja	v i e̯ ʎː ʎ a
vielppis	v i e̯ l p p iː s
vielti	v i e̯ lː t iː
viergi	v i e̯ rː k iː
vieris	v i e̯ r iː s
viertu	v i e̯ rː t uː
viessat	v i e̯ s s a h t
viessu	v i e̯ s s uː
viesttar	v i e̯ s t a r
vietka	v i e̯ tː k a
viežžat	v i e̯ dː d͡ʒ a h t
viggat	v i ɡː ɡ a h t
vihki	v i h k iː
vihpat	v i h p a h t
vihtta	v i hː t a
viiddidit	v i jː t t iː t i h t
viidni	v i jː t n iː
viisses	v i j s s e s
viissis	v i j s s iː s
vilges	v iː lː k e s
villat	v i lː l a h t
virgi	v i rː k iː
vismut	v i sː m uː h t
vivva	v i v v a
vizardit	v i t͡s a r t i h t
viđji	v i ðː j iː
viššat	v i ʃ ʃ a h t
vokatiiva	v o kʰ a tʰ i jː v a
volta	v o lː t a
vovdna	v o vː t n a
vuiges	v uː jː k e s
vuoddji	v u o̯ ɟː ɟ iː
vuoddját	v u o̯ ɟː ɟ aː h t
vuodja	v u o̯ ɟ ɟ a
vuodjaláibi	v u o̯ ɟ ɟ a l aː jː p iː
vuodjat	v u o̯ ɟ ɟ a h t
vuodjit	v u o̯ ɟ ɟ iː h t
vuodjut	v u o̯ ɟ ɟ uː h t
vuogas	v u o̯ k a s
vuogga	v u o̯ ɡː ɡ a
vuohes	v u o̯ h e s
vuohki	v u o̯ h k iː
vuohppa	v u o̯ hː p a
vuohppi	v u o̯ hː p iː
vuohpput	v u o̯ hː p uː h t
vuohttit	v u o̯ hː t iː h t
vuohčit	v u o̯ h t͡ʃ iː h t
vuohčut	v u o̯ h t͡ʃ uː h t
vuohčču	v u o̯ hː t͡ʃ uː
vuoi	v u o̯ j
vuoidat	v u o̯ jː t a h t
vuoiddadit	v u o̯ jː t t a t i h t
vuoiddas	v u o̯ jː t t a s
vuoiga	v u o̯ jː k a
vuoigat	v u o̯ jː k a h t
vuoigŋa	v u o̯ jː t ɲ a
vuoigŋat	v u o̯ jː t ɲ a h t
vuoitit	v u o̯ jː t iː h t
vuoitu	v u o̯ jː t uː
vuoivvas	v u o̯ j v v a s
vuoivvasoažži	v u o̯ j v v a s o ɑ̯ dː d͡ʒ iː
vuoiŋŋadit	v u o̯ j ŋ ɲ a t i h t
vuoján	v u o̯ j aː n
vuoksa	v u o̯ kː s a
vuoksá	v u o̯ kː s aː
vuokta	v u o̯ kː t a
vuol	v u o̯ l
vuola	v u o̯ l a
vuolde	v u o̯ lː t e
vuole	v u̯ o l e
vuolgit	v u o̯ lː k iː h t
vuolla	v u o̯ l l a
vuollai	v u o̯ l l a j
vuollat	v u o̯ l l a h t
vuolleeatnamat	v u o̯ l l e e a̯ t n a m a h t
vuolli	v u o̯ l l iː
vuollin	v u o̯ l l iː n
vuollái	v u o̯ l l aː j
vuollánit	v u o̯ l l aː n i h t
vuolpu	v u o̯ lː p uː
vuoni	v u o̯ n iː
vuonjal	v u o̯ ɲ a l
vuonjas	v u o̯ ɲ a s
vuopmi	v u o̯ p m iː
vuoras	v u o̯ r a s
vuoražas	v u o̯ r a t͡ʃ a s
vuorbi	v u o̯ rː p iː
vuorjat	v u o̯ rː j a h t
vuorru	v u o̯ r r uː
vuos	v u o̯ s
vuoskku	v u o̯ s k uː
vuossa	v u o̯ s s a
vuossi	v u o̯ sː s iː
vuossu	v u o̯ sː s uː
vuossárga	v u o̯ s s aː r k a
vuosttaš	v u o̯ s t a ʃ
vuostá	v u o̯ sː t aː
vuot	v u o̯ h t
vuotna	v u o̯ t n a
vuotta	v u o̯ t t a
vuovda	v u o̯ vː t a
vuovdi	v u o̯ vː t iː
vuovdin	v u o̯ vː t iː n
vuovdinhaddi	v u o̯ vː t iː n h a dː d iː
vuovdit	v u o̯ vː t iː h t
vuovssá	v u o̯ v s s aː
vuođđu	v u o̯ ð ð uː
vuoŋas	v u o̯ ɲ a s
vuoššat	v u o̯ ʃː ʃ a h t
vurket	v uː rː k e h t
váddut	v aː dː d uː h t
váhnen	v aː n̥ e n
váibmosuotna	v aː jː p m o s u o̯ t n a
váibmu	v aː jː p m uː
váidalit	v aː jː t a l i h t
váidit	v aː jː t iː h t
váilut	v aː jː l uː h t
váivi	v aː jː v iː
váldit	v aː lː t iː h t
válká	v aː lː k aː
vánhen	v aː nː h e n
vára	v aː r a
várat	v aː r a h t
várdát	v aː rː t aː h t
várggát	v aː rː k k aː h t
várju	v aː rː j uː
várri	v aː r r iː
váso	v aː s o
vássit	v aː s s iː h t
vástidit	v aː sː t iː t i h t
vátnat	v aː t n a h t
váttes	v aˑ t t e s
váttis	v aː t t iː s
vávdno	v aː vː t n o
vázzit	v aː dː d͡z iː h t
vázzát	v aː dː d͡z aː h t
xenon	x eː n o n
zámbia	t͡s aː mː p iː a
ábbut	aː bː b uː h t
ádde	aː dː d e
áddehahtti	aː dː d e h a hː t iː
áddet	aː dː d e h t
áddjut	aː ɟː ɟ uː h t
áddjá	aː ɟː ɟ aː
ádji	aː ɟ ɟ iː
ádjit	aː ɟ ɟ iː h t
ádjánit	aː ɟ ɟ aː n i h t
áfáiduvvat	aː f aː j t u v v a h t
ágga	aː ɡː ɡ a
áhci	aː h t͡s iː
áhkalakkis	aˑ h k a l a k k iː s
áhkkil	aː hː k iː l
áhkku	aː hː k uː
áhkkut	aː hː k uː h t
áhkká	aː hː k aː
áhpi	aː h p iː
áhppi	aː hː p iː
áhpásmahttit	aː h p aː s m a hː t iː h t
áhpásmit	aː h p aː s m i h t
áhtat	aː h t a h t
áhčči	aː hː t͡ʃ iː
áibat	aː jː p a h t
áibbas	aː jː p p a s
áibbašit	aː jː p p a ʃ i h t
áibmat	aː jː p m a h t
áibmi	aː jː p m iː
áibmu	aː jː p m uː
áicat	aː jː t͡s a h t
áiccastat	aː j t t͡s a s t a h t
áiccastit	aː j t t͡s a s t i h t
áices	aː jː t͡s e s
áidi	aː jː t iː
áidna	aː jː t n a
áidnu	aː jː t n uː
áidut	aː jː t uː h t
áigečála	aː jː k e t͡ʃ aː l a
áigge	aˑ jː k k e
áiggi	aː jː k k iː
áigi	aː jː k iː
áigodat	aː jː k o t a h t
áigut	aː jː k uː h t
áigá	aː jː k aː
áika	aː jː k a
áilu	aː jː l uː
áinnut	aː j n n uː h t
áiru	aː jː r uː
áisá	aː jː s aː
áite	aː jː t e
áiti	aː jː t iː
áitit	aː jː t iː h t
áittar	aː j t t a r
ája	aː j a
ájihit	aː j iː h i h t
ájáhallat	aː j aː h a l l a h t
áksi	aː kː s iː
áksil	aː kː s iː l
áktit	aː kː t iː h t
ákŋu	aː t ɲ uː
ákšu	aː kː ʃ uː
álbmot	aː lː p m o h t
álbmotbeaivi	aː lː p m o t p e a̯ jː v iː
álbmotjienasteapmi	aː lː p m o t j i e̯ n a s t e a̯ p m iː
álddagas	aː lː t t a k a s
áldu	aː lː t uː
álgga	aː lː k k a
álggahit	aː lː k k a h i h t
álgit	aː lː k iː h t
álgu	aː lː k uː
áli	aː l iː
álkes	aˑ lː k e s
álki	aː lː k iː
álkimus	aː lː k iː m u s
álkit	aː lː k iː h t
állat	aː l l a h t
állut	aː lː l uː h t
állát	a lː l aː h t
álo	aː l o
áltá	aː lː t aː
áltár	aː lː t aː r
álás	aː l aː s
ándagassii	aː nː t a k a s s i j
ándaras	aː nː t a r a s
ánde	aː nː t e
ánne	aː nː n e
ánná	aː nː n aː
áno	aː n o
ánte	aː nː t e
áppes	aː p p e s
árbi	aː rː p iː
árbmu	aː rː p m uː
árga	aː rː k a
árgges	aˑ rː k k e s
árggimus	aː rː k k iː m u s
árggit	aː rː k k iː h t
árgi	aː rː k iː
árja	aː rː j a
árjja	aː r j j a
áron	aː r o n
árpa	aː rː p a
árpu	aː rː p uː
árrat	aː r r a h t
árrit	aː r r iː h t
árrot	aː r r o h t
ártnut	aː r t n uː h t
árves	aː rː v e s
árvidit	aː rː v iː t i h t
árvu	aː rː v uː
árvvas	aː r v v a s
ásahit	aː s a h i h t
ásia	aː s iː a
áslat	aː sː l a h t
ásllat	aː s l a h t
ássat	aː s s a h t
ássi	aː sː s iː
átnjal	aː t ɲ a l
átnut	aː t n uː h t
ávki	aː vː k iː
ávus	aː v uː s
ávvudeame	aː v v uː t e̯ a m e
ávvudeami	aː v v uː t e a̯ m iː
ávvudeamis	aː v v uː t e a̯ m iː s
ávvudeamit	aː v v uː t e a̯ m iː h t
ávvudeapmi	aː v v uː t e a̯ p m iː
ávvudeapmin	aː v v uː t e a̯ p m iː n
ávvudeapmái	aː v v uː t e a̯ p m aː j
ávvudemiid	aː v v uː t eː m i j t
ávvudemiide	aː v v uː t eː m i j t e
ávvudemiiguin	aː v v uː t e m i j k u j n
ávvudemiin	aː v v uː t eː m i j n
ávži	aː vː t͡ʃ iː
áššeheapme	aˑ ʃ ʃ e h e̯ a p m e
ášši	aː ʃː ʃ iː
áššu	aː ʃ ʃ uː
čagar	t͡ʃ a k a r
čagardit	t͡ʃ a k a r t i h t
čahki	t͡ʃ a h k iː
čahrrat	t͡ʃ a r̥ r̥ a h t
čaibmat	t͡ʃ a jː p m a h t
čaimmas	t͡ʃ a j m m a s
čakča	t͡ʃ a kː t͡ʃ a
čakčamánnu	t͡ʃ a kː t͡ʃ a m aː n n uː
čakčat	t͡ʃ a kː t͡ʃ a h t
čala	t͡ʃ a l a
čalbmi	t͡ʃ a lː p m iː
čallat	t͡ʃ a l l a h t
čalmmas	t͡ʃ a l m m a s
čalmmeheamos	t͡ʃ a l m m e h e̯ a m o s
čalmmeheapme	t͡ʃ a l m m e h e̯ a p m e
čalmmehit	t͡ʃ a l m m e h i h t
čalán	t͡ʃ a l aː n
časkit	t͡ʃ a sː k iː h t
čatnat	t͡ʃ a t n a h t
čavga	t͡ʃ a vː k a
čavgadeamos	t͡ʃ a vː k a t e̯ a m o s
čavgadit	t͡ʃ a vː k a t i h t
čavgat	t͡ʃ a vː k a h t
čavges	t͡ʃ a vː k e s
čavggamus	t͡ʃ a vː k k a m u s
čavggat	t͡ʃ a vː k k a h t
čađa	t͡ʃ a ð a
čađat	t͡ʃ a ð a h t
čađđa	t͡ʃ a ð ð a
čeabehastit	t͡ʃ e̯ a p e h a sː t iː h t
čeabet	t͡ʃ e̯ a p e h t
čeahci	t͡ʃ e a̯ h t͡s iː
čeahkka	t͡ʃ e a̯ hː k a
čeahpes	t͡ʃ e̯ a h p e s
čeahpimus	t͡ʃ e a̯ h p iː m u s
čeahpit	t͡ʃ e a̯ h p iː h t
čeahppi	t͡ʃ e a̯ hː p iː
čeaksa	t͡ʃ e a̯ kː s a
čealluladdat	t͡ʃ e a̯ l l uː l a dː d a h t
čeallulit	t͡ʃ e a̯ l l uː l i h t
čeallut	t͡ʃ e a̯ l l uː h t
čeargat	t͡ʃ e a̯ rː k a h t
čearguladdat	t͡ʃ e a̯ rː k uː l a dː d a h t
čeargulit	t͡ʃ e a̯ rː k uː l i h t
čeargut	t͡ʃ e a̯ rː k uː h t
čearret	t͡ʃ e̯ a r r e h t
čearrit	t͡ʃ e a̯ r r iː h t
čearru	t͡ʃ e a̯ r r uː
čeaskkut	t͡ʃ e a̯ s k uː h t
čeavlái	t͡ʃ e a̯ vː l aː j
čeavlámus	t͡ʃ e a̯ vː l aː m u s
čeavlás	t͡ʃ e a̯ vː l aː s
čeavlát	t͡ʃ e a̯ vː l aː h t
čeavrris	t͡ʃ e a̯ v r r iː s
čeavži	t͡ʃ e a̯ vː t͡ʃ iː
čelo	t͡ʃ eː l o
čelččen	t͡ʃ eː l t t͡ʃ e n
čeret	t͡ʃ eː r e h t
čeŋkkeš	t͡ʃ eː ŋ k k e ʃ
čibbi	t͡ʃ i bː b iː
čiegar	t͡ʃ i e̯ k a r
čiegus	t͡ʃ i e̯ k uː s
čiehka	t͡ʃ i e̯ h k a
čiehkat	t͡ʃ i e̯ h k a h t
čiehká	t͡ʃ i e̯ h k aː
čiehppa	t͡ʃ i e̯ hː p a
čiehppat	t͡ʃ i e̯ hː p a h t
čiekčat	t͡ʃ i e̯ kː t͡ʃ a h t
čiekčá	t͡ʃ i e̯ kː t͡ʃ aː
čiekŋaleamos	t͡ʃ i e̯ t ɲ a l e̯ a m o s
čiekŋalis	t͡ʃ i e̯ t ɲ a l i s
čiekŋalit	t͡ʃ i e̯ t ɲ a l i h t
čielga	t͡ʃ i e̯ lː k a
čielgaseamos	t͡ʃ i e̯ lː k a s e̯ a m o s
čielgasit	t͡ʃ i e̯ lː k a s i h t
čielgat	t͡ʃ i e̯ lː k a h t
čielggas	t͡ʃ i e̯ lː k k a s
čielgi	t͡ʃ i e̯ lː k iː
čierastit	t͡ʃ i e̯ r a s t i h t
čierrut	t͡ʃ i e̯ r r uː h t
čierrá	t͡ʃ i e̯ rː r aː
čieskat	t͡ʃ i e̯ sː k a h t
čieŋal	t͡ʃ i e̯ ɲ a l
čieža	t͡ʃ i e̯ t͡ʃ a
čigŋát	t͡ʃ i dː ɲ aː h t
čihkoseamos	t͡ʃ iː h k o s e̯ a m o s
čihkosit	t͡ʃ iː h k o s i h t
čihččet	t͡ʃ iː hː t͡ʃ e h t
čiktit	t͡ʃ i kː t iː h t
čilget	t͡ʃ iː lː k e h t
čipma	t͡ʃ i p m a
čirrat	t͡ʃ i r r a h t
čitnut	t͡ʃ i t n uː h t
čivga	t͡ʃ i vː k a
čivhli	t͡ʃ i vː l̥ iː
čivrrus	t͡ʃ i v r r uː s
čičči	t͡ʃ i t t͡ʃ iː
čižži	t͡ʃ i dː d͡ʒ iː
čoaggit	t͡ʃ o ɑ̯ ɡː ɡ iː h t
čoahkkanit	t͡ʃ o ɑ̯ hː k a n i h t
čoalbmi	t͡ʃ o ɑ̯ lː p m iː
čoalli	t͡ʃ o ɑ̯ l l iː
čoamohas	t͡ʃ o̯ ɑ m o h a s
čoarrut	t͡ʃ o ɑ̯ r r uː h t
čoarrát	t͡ʃ o ɑ̯ rː r aː h t
čoarvi	t͡ʃ o ɑ̯ rː v iː
čoaska	t͡ʃ o ɑ̯ sː k a
čoaskkis	t͡ʃ o ɑ̯ s k iː s
čoaskámus	t͡ʃ o ɑ̯ sː k aː m u s
čoaskát	t͡ʃ o ɑ̯ sː k aː h t
čoavdda	t͡ʃ o ɑ̯ vː t t a
čoavdit	t͡ʃ o ɑ̯ vː t iː h t
čoavji	t͡ʃ o ɑ̯ vː j iː
čoavččis	t͡ʃ o ɑ̯ v t t͡ʃ iː s
čoađgi	t͡ʃ o ɑ̯ ðː k iː
čohkat	t͡ʃ o h k a h t
čohkka	t͡ʃ o hː k a
čohkket	t͡ʃ o hː k e h t
čohkkát	t͡ʃ o hː k aː h t
čohkut	t͡ʃ o h k uː h t
čolga	t͡ʃ o lː k a
čolgat	t͡ʃ o lː k a h t
čollut	t͡ʃ o l l uː h t
čopma	t͡ʃ o p m a
čora	t͡ʃ o r a
čorbma	t͡ʃ o rː p m a
čorga	t͡ʃ o rː k a
čorgadeamos	t͡ʃ o rː k a t e̯ a m o s
čorgadit	t͡ʃ o rː k a t i h t
čorgat	t͡ʃ o rː k a h t
čorgejeaddji	t͡ʃ o rː k e j e a̯ ɟː ɟ iː
čorges	t͡ʃ o rː k e s
čorget	t͡ʃ o rː k e h t
čorggut	t͡ʃ o rː k k uː h t
čorru	t͡ʃ o r r uː
čoska	t͡ʃ o sː k a
čotta	t͡ʃ o t t a
čovvát	t͡ʃ o vː v aː h t
čujuhus	t͡ʃ u j uː h u s
čukčá	t͡ʃ u kː t͡ʃ aː
čulggon	t͡ʃ u lː k k o n
čulkit	t͡ʃ u lː k iː h t
čuodjat	t͡ʃ u o̯ ɟ ɟ a h t
čuoggut	t͡ʃ u o̯ ɡː ɡ uː h t
čuohcat	t͡ʃ u o̯ h t͡s a h t
čuohcit	t͡ʃ u o̯ h t͡s iː h t
čuohkat	t͡ʃ u o̯ h k a h t
čuohki	t͡ʃ u o̯ h k iː
čuohppat	t͡ʃ u o̯ hː p a h t
čuohti	t͡ʃ u o̯ h t iː
čuoigat	t͡ʃ u o̯ jː k a h t
čuoigát	t͡ʃ u o̯ jː k aː h t
čuoika	t͡ʃ u o̯ jː k a
čuoivvat	t͡ʃ u o̯ j v v a h t
čuokkis	t͡ʃ u o̯ k k iː s
čuolbma	t͡ʃ u o̯ lː p m a
čuolbmat	t͡ʃ u o̯ lː p m a h t
čuolda	t͡ʃ u o̯ lː t a
čuoldit	t͡ʃ u o̯ lː t iː h t
čuolggu	t͡ʃ u o̯ lː k k uː
čuollat	t͡ʃ u o̯ l l a h t
čuollát	t͡ʃ u o̯ lː l aː h t
čuolmma	t͡ʃ u o̯ l m m a
čuonjá	t͡ʃ u o̯ ɲ aː
čuopma	t͡ʃ u o̯ p m a
čuopmat	t͡ʃ u o̯ p m a h t
čuorgadeamos	t͡ʃ u o̯ rː k a t e̯ a m o s
čuorgadit	t͡ʃ u o̯ rː k a t i h t
čuorgat	t͡ʃ u o̯ rː k a h t
čuorggut	t͡ʃ u o̯ rː k k uː h t
čuorpmas	t͡ʃ u o̯ r p m a s
čuorvut	t͡ʃ u o̯ rː v uː h t
čuoskut	t͡ʃ u o̯ sː k uː h t
čuovga	t͡ʃ u o̯ vː k a
čuovgadeamos	t͡ʃ u o̯ vː k a t e̯ a m o s
čuovgadit	t͡ʃ u o̯ vː k a t i h t
čuovgat	t͡ʃ u o̯ vː k a h t
čuovgatoardna	t͡ʃ u o̯ vː k a tʰ o ɑ̯ rː t n a
čuovgga	t͡ʃ u o̯ vː k k a
čuovggahit	t͡ʃ u o̯ vː k k a h i h t
čuovvut	t͡ʃ u o̯ v v uː h t
čuovža	t͡ʃ u o̯ vː t͡ʃ a
čuođi	t͡ʃ u o̯ ð iː
čuođát	t͡ʃ u o̯ ð aː h t
čuođđit	t͡ʃ u o̯ ð ð iː h t
čuožžut	t͡ʃ u o̯ dː d͡ʒ uː h t
čurge	t͡ʃ u rː k e
čurges	t͡ʃ uː rː k e s
čurti	t͡ʃ u rː t iː
čurtát	t͡ʃ u rː t aː h t
čurvet	t͡ʃ uː rː v e h t
čuvdi	t͡ʃ u vː t iː
čuvges	t͡ʃ uː vː k e s
čuvggodit	t͡ʃ uː vː k k o t i h t
čužot	t͡ʃ u t͡ʃ o h t
čábbe	t͡ʃ aː bː b e
čábbut	t͡ʃ aː bː b uː h t
čábbámus	t͡ʃ aː bː b aː m u s
čábbáseamos	t͡ʃ aː bː b aː s e̯ a m o s
čábbásit	t͡ʃ aː bː b aː s i h t
čábbát	t͡ʃ aː bː b aː h t
čádjidit	t͡ʃ aː ɟ ɟ iː t i h t
čáhccái	t͡ʃ aː hː t͡s aː j
čáhci	t͡ʃ aː h t͡s iː
čáhkat	t͡ʃ aː h k a h t
čáhppadeamos	t͡ʃ aː hː p a t e̯ a m o s
čáhppadit	t͡ʃ aː hː p a t i h t
čáhppat	t͡ʃ aː hː p a h t
čáhppes	t͡ʃ aː hː p e s
čáhppát	t͡ʃ aː hː p aː h t
čáihmi	t͡ʃ aː jː m̥ iː
čáihni	t͡ʃ aː jː n̥ iː
čájehit	t͡ʃ aˑ j e h i h t
čájihit	t͡ʃ aː j iː h i h t
čájáhus	t͡ʃ aː j aː h u s
čákŋat	t͡ʃ aː t ɲ a h t
čála	t͡ʃ aː l a
čálli	t͡ʃ aː lː l iː
čállin	t͡ʃ aː l l iː n
čállit	t͡ʃ aː l l iː h t
čáppa	t͡ʃ aː p p a
čáppat	t͡ʃ aː p p a h t
čárvut	t͡ʃ aː rː v uː h t
čáskat	t͡ʃ aː sː k a h t
čátná	t͡ʃ aː t n aː
čávdit	t͡ʃ aː vː t iː h t
čávgŋi	t͡ʃ aː vː t ɲ iː
čávvat	t͡ʃ aː v v a h t
čáđbmi	t͡ʃ aː ðː p m iː
đ	ð
ŋ	ŋ
šaddanbeaivi	ʃ a dː d a n p e a̯ jː v iː
šaddat	ʃ a dː d a h t
šaddu	ʃ a dː d uː
šalbmi	ʃ a lː p m iː
šaldi	ʃ a lː t iː
šallat	ʃ a l l a h t
šalles	ʃ a lː l e s
šallju	ʃ a ʎː ʎ uː
šearfa	ʃ e a̯ rː f a
šelges	ʃ eː lː k e s
šerres	ʃ eː rː r e s
šibit	ʃ i p iː h t
šibitdoavttir	ʃ i p iː t t o ɑ̯ v t t iː r
šiega	ʃ i e̯ k a
šiehttat	ʃ i e̯ hː t a h t
šieđđat	ʃ i e̯ ð ð a h t
šiggut	ʃ i ɡː ɡ uː h t
širrat	ʃ i r r a h t
šlahtti	ʃ l a hː t iː
šleađga	ʃ l e a̯ ðː k a
šlietnjut	ʃ l i e̯ t ɲ uː h t
šloahtta	ʃ l o ɑ̯ hː t a
šohkut	ʃ o h k uː h t
šođbbut	ʃ o ðː p p uː h t
šuohkkit	ʃ u o̯ hː k iː h t
šuvvat	ʃ u v v a h t
šušmi	ʃ u ʃː m iː
šušmmi	ʃ u ʃ m iː
šveica	ʃ v e jː t͡s a
šákša	ʃ aː kː ʃ a
šállo	ʃ aː l l o
šávge	ʃ aː vː k e
ŧ	θ
