ஃ	ɐ hᵄ
ஃக்	kʰ
ஃக்	x
ஃஜிந்தகி	z ɪ n̪ d̪ ɐ ɡ ɪ
ஃஜ்	z
ஃபோன்	f oː n
ஃப்	f
ஃஸ்	k s
அ	ɐ
அஃகம்	əʰ ɦ a m
அஃது	ɐ ɦ d̪ u
அஃறிணை	ə ɦ r ɪ ɳ ə ɪ̯
அகங்காரம்	ɐ ɡ ɐ ŋ ɡ aː ɾ ɐ m
அகங்கை	ɐ ɡ ɐ ŋ ɡ ɐ ɪ̯
அகண்டன்	ɐ ɡ ɐ ɳ ɖ ɐ n
அகதி	ɐ ɡ ɐ d̪ ɪ
அகதிகள்	ɐ ɡ ɐ d̪ ɪ ɡ ɐ ɭ
அகத்தாழம்	ɐ ɡ ɐ t̪ː aː ɻ ɐ m
அகத்துக்காரர்	ɐ ɡ ɐ t̪ː ʊ kː aː ɾ ɐ ɾ
அகத்துக்காரி	ɐ ɡ ɐ t̪ː ʊ kː aː ɾ ɪ
அகந்தை	ɐ ɡ ɐ n̪ d̪ ɐ ɪ̯
அகனன்	ɐ ɡ ɐ n ɐ n
அகனள்	ɐ ɡ ɐ n ɐ ɭ
அகப்படு	ɐ ɡ ɐ pː ɐ ɖ ʊ
அகப்பா	ɐ ɡ ɐ pː aː
அகப்பு	ɐ ɡ ɐ pː ʊ
அகப்பை	ɐ ɡ ɐ pː ɐ ɪ̯
அகம்	ɐ ɡ ɐ m
அகரமுதலி	ɐ ɡ ɐ ɾ ɐ m ʊ d̪ ɐ l ɪ
அகரம்	ɐ ɡ ɐ ɾ ɐ m
அகரவரிசை	ɐ ɡ ɐ ɾ ɐ ʋ ɐ ɾ ɪ t͡ɕ ɐ ɪ̯
அகராதி	ɐ ɡ ɐ ɾ aː d̪ ɪ
அகரு	ɐ ɡ ɐ ɾ ʊ
அகற்சி	ɐ ɡ ɐ r t͡ɕ ɪ
அகற்று	ɐ ɡ ɐ rː ʊ
அகலம்	ɐ ɡ ɐ l ɐ m
அகல்	ɐ ɡ ɐ l
அகழி	ɐ ɡ ɐ ɻ ɪ
அகழ்	ɐ ɡ ɐ ɻ
அகவன்மகள்	ɐ ɡ ɐ ʋ ɐ n m ɐ ɡ ɐ ɭ
அகவை	ɐ ɡ ɐ ʋ ɐ ɪ̯
அகிபுசம்	ɐ ɡ ɪ b ʊ t͡ɕ ɐ m
அகிலம்	ɐ h ɪ l ɐ m
அகிலம்	ɐ ɡ ɪ l ɐ m
அகில்	ɐ ɡ ɪ l
அகை	ɐ ɡ ɐ ɪ̯
அக்கச்சி	ɐ kː ɐ t͡ɕː ɪ
அக்கரை	ɐ kː ɐ ɾ ɐ ɪ̯
அக்களிப்பு	ɐ kː ɐ ɭ ɪ pː ʊ
அக்கா	ɐ kː aː
அக்காமார்	ɐ kː aː m aː ɾ
அக்காள்	ɐ kː aː ɭ
அக்கி	ɐ kː ɪ
அக்கினி	ɐ kː ɪ n ɪ
அக்கினிகர்ப்பம்	ɐ kː ɪ n ɪ ɡ ɐ ɾ pː ɐ m
அக்கினிகுண்டம்	ɐ kː ɪ n ɪ ɡ ʊ ɳ ɖ ɐ m
அக்கினிகோத்திரம்	ɐ kː ɪ n ɪ ɡ oː t̪ː ɪ ɾ ɐ m
அக்கினிச்சுவாலை	ɐ kː ɪ n ɪ t͡ɕː ʊ ʋ aː l ɐ ɪ̯
அக்கினித்தம்பம்	ɐ kː ɪ n ɪ t̪ː ɐ m b ɐ m
அக்கினியாஸ்திரம்	ɐ kː ɪ n ɪ j aː s t̪ ɪ ɾ ɐ m
அக்கினிஸ்நானம்	ɐ kː ɪ n ɪ s n̪ aː n ɐ m
அக்கிரமம்	ɐ kː ɪ ɾ ɐ m ɐ m
அக்கு	ɐ kː ʊ
அக்குள்	ɐ kː ʊ ɭ
அக்கை	ɐ kː ɐ ɪ̯
அக்கைச்சி	ɐ kː ɐ ɪ̯ t͡ɕː ɪ
அக்டோபர்	ɐ k ʈ oː b ɐ ɾ
அங்கக	ɐ ŋ ɡ ɐ ɡ ɐ
அங்கண்	ɐ ŋ ɡ ɐ ɳ
அங்கதம்	ɐ ŋ ɡ ɐ d̪ ɐ m
அங்கன்வாடி	ɐ ŋ ɡ ɐ n ʋ aː ɖ ɪ
அங்கம்	ɐ ŋ ɡ ɐ m
அங்கயற்கண்ணி	ɐ ŋ ɡ ɐ j ɐ r k ɐ ɳː ɪ
அங்காடி	ɐ ŋ ɡ aː ɖ ɪ
அங்காலே	ɐ ŋ ɡ aː l eː
அங்கிட்டு	ɐ ŋ ɡ ɪ ʈː ʊ
அங்கு	ɐ ŋ ɡ ʊ
அங்குத்தை	ɐ ŋ ɡ ʊ t̪ː ɐ ɪ̯
அங்குலி	ɐ ŋ ɡ ʊ l ɪ
அங்கூசம்	ɐ ŋ ɡ uː t͡ɕ ɐ m
அங்கே	ɐ ŋ ɡ eː
அங்கோடிங்கோடு	ɐ ŋ ɡ oː ɖ ɪ ŋ ɡ oː ɖ ʊ
அங்ஙனம்	ɐ ŋː ɐ n ɐ m
அசர்	ɐ t͡ɕ ɐ ɾ
அசர்த்து	ɐ t͡ɕ ɐ ɾ t̪ː ʊ
அசாம்	ɐ t͡ɕ aː m
அசிங்கம்	ɐ t͡ɕ ɪ ŋ ɡ ɐ m
அசும்பு	ɐ t͡ɕ ʊ m b ʊ
அசை	ɐ t͡ɕ ɐ ɪ̯
அசைவம்	ɐ t͡ɕ ɐ ɪ̯ ʋ ɐ m
அச்சன்	ɐ t͡ɕː ɐ n
அச்சம்	ɐ t͡ɕː ɐ m
அச்சார்	ɐ t͡ɕː aː ɾ
அச்சி	ɐ t͡ɕː ɪ
அச்சு	ɐ t͡ɕː ʊ
அச்சுமரம்	ɐ t͡ɕː ʊ m ɐ ɾ ɐ m
அச்சுவினி	ɐ t͡ɕː ʊ ʋ ɪ n ɪ
அஜினோமோட்டோ	ɐ d͡ʑ ɪ n oː m oː ʈː oː
அஞ்சலகம்	ɐ ɲ d͡ʑ ɐ l ɐ ɡ ɐ m
அஞ்சல்	ɐ ɲ d͡ʑ ɐ l
அஞ்சு	ɐ ɲ d͡ʑ ʊ
அஞ்ஞானம்	ɐ ɲː aː n ɐ m
அஞ்ஞை	ɐ ɲː ɐ ɪ̯
அடக்கம்	ɐ ɖ ɐ kː ɐ m
அடக்கு	ɐ ɖ ɐ kː ʊ
அடங்கு	ɐ ɖ ɐ ŋ ɡ ʊ
அடங்குதல்	ɐ ɖ ɐ ŋ ɡ ʊ d̪ ɐ l
அடர்	ɐ ɖ ɐ ɾ
அடர்த்தி	ɐ ɖ ɐ ɾ t̪ː ɪ
அடவி	ɐ ɖ ɐ ʋ ɪ
அடி	ɐ ɖ ɪ
அடிகள்	ɐ ɖ ɪ ɡ ɐ ɭ
அடிகேயா	ɐ ɖ ɪ ɡ eː j aː
அடிக்கடி	ɐ ɖ ɪ kː ɐ ɖ ɪ
அடிக்கொருக்கால்	ɐ ɖ ɪ kː ɔ ɾ ʊ kː aː l
அடிக்கோடு	ɐ ɖ ɪ kː oː ɖ ʊ
அடிச்சுவடு	ɐ ɖ ɪ t͡ɕː ʊ ʋ ɐ ɖ ʊ
அடித்தட்டு	ɐ ɖ ɪ t̪ː ɐ ʈː ʊ
அடித்தளம்	ɐ ɖ ɪ t̪ː ɐ ɭ ɐ m
அடிநிலை	ɐ ɖ ɪ n̪ ɪ l ɐ ɪ̯
அடிபந்தாட்டம்	ʔ a ɖ i p a n̪ d̪ aː ʈː a m
அடிப்பகுதி	ɐ ɖ ɪ pː ɐ ɡ ʊ d̪ ɪ
அடிப்பாகம்	ɐ ɖ ɪ pː aː ɡ ɐ m
அடிப்பொளி	ɐ ɖ ɪ pː ɔ ɭ ɪ
அடிமுடி	ɐ ɖ ɪ m ʊ ɖ ɪ
அடிமை	ɐ ɖ ɪ m ɐ ɪ̯
அடு	ɐ ɖ ʊ
அடுத்த	ɐ ɖ ʊ t̪ː ɐ
அடுத்து	ɐ ɖ ʊ t̪ː ʊ
அடுப்பு	ɐ ɖ ʊ pː ʊ
அடுமனை	ɐ ɖ ʊ m ɐ n ɐ ɪ̯
அடுமனைகள்	ɐ ɖ ʊ m ɐ n ɐ ɪ̯ ɡ ɐ ɭ
அடை	ɐ ɖ ɐ ɪ̯
அடைகஷாயம்	ɐ ɖ ɐ ɪ̯ ɡ ɐ ʂ aː j ɐ m
அடைக்கலக்குருவி	ɐ ɖ ɐ ɪ̯ kː ɐ l ɐ kː ʊ ɾ ʊ ʋ ɪ
அடைக்கலம்	ɐ ɖ ɐ ɪ̯ kː ɐ l ɐ m
அடைக்காய்	ɐ ɖ ɐ ɪ̯ kː aː j
அடைச்சு	ɐ ɖ ɐ ɪ̯ t͡ɕː ʊ
அடைந்தோர்	ɐ ɖ ɐ ɪ̯ n̪ d̪ oː ɾ
அடைப்பு	ɐ ɖ ɐ ɪ̯ pː ʊ
அடைமொழி	ɐ ɖ ɐ ɪ̯ m ɔ ɻ ɪ
அடைய	ɐ ɖ ɐ ɪ̯ j ɐ
அடையாளம்	ɐ ɖ ɐ ɪ̯ j aː ɭ ɐ m
அட்சரம்	ɐ ʈ t͡ɕ ɐ ɾ ɐ m
அட்டம்	ɐ ʈː ɐ m
அட்டவண்ணைத்திருக்கை	ɐ ʈː ɐ ʋ ɐ ɳː ɐ ɪ̯ t̪ː ɪ ɾ ʊ kː ɐ ɪ̯
அட்டை	ɐ ʈː ɐ ɪ̯
அணங்கம்	ɐ ɳ ɐ ŋ ɡ ɐ m
அணங்கு	ɐ ɳ ɐ ŋ ɡ ʊ
அணங்குகள்	ɐ ɳ ɐ ŋ ɡ ʊ ɡ ɐ ɭ
அணாவு	ɐ ɳ aː ʋ ʊ
அணி	ɐ ɳ ɪ
அணிகம்	ɐ ɳ ɪ ɡ ɐ m
அணிச்சல்	ɐ ɳ ɪ t͡ɕː ɐ l
அணிந்துரை	ɐ ɳ ɪ n̪ d̪ ʊ ɾ ɐ ɪ̯
அணிமை	ɐ ɳ ɪ m ɐ ɪ̯
அணியம்	ɐ ɳ ɪ j ɐ m
அணில்	ɐ ɳ ɪ l
அணிவகு	ɐ ɳ ɪ ʋ ɐ ɡ ʊ
அணு	ɐ ɳ ʊ
அணுகு	ɐ ɳ ʊ ɡ ʊ
அணுக்கன்	ɐ ɳ ʊ kː ɐ n
அணுக்கம்	ɐ ɳ ʊ kː ɐ m
அணுதரிசினி	ɐ ɳ ʊ d̪ ɐ ɾ ɪ t͡ɕ ɪ n ɪ
அணை	ɐ ɳ ɐ ɪ̯
அணைக்கட்டு	ɐ ɳ ɐ ɪ̯ kː ɐ ʈː ʊ
அண்டசராசரம்	ɐ ɳ ɖ ɐ t͡ɕ ɐ ɾ aː t͡ɕ ɐ ɾ ɐ m
அண்டம்	ɐ ɳ ɖ ɐ m
அண்டை	ɐ ɳ ɖ ɐ ɪ̯
அண்டையர்	ɐ ɳ ɖ ɐ ɪ̯ j ɐ ɾ
அண்ணன்	ɐ ɳː ɐ n
அண்ணா	ɐ ɳː aː
அண்ணாச்சி	ɐ ɳː aː t͡ɕː ɪ
அண்ணி	ɐ ɳː ɪ
அண்மை	ɐ ɳ m ɐ ɪ̯
அதனால்	ɐ d̪ ɐ n aː l
அதர்	ɐ d̪ ɐ ɾ
அதான்	ɐ d̪ aː n
அதிகமாய்	ɐ d̪ i h ə m ɛː
அதிகமாய்	ɐ d̪ ɪ ɡ ɐ m aː j
அதிகம்	ɐ d̪ ɪ ɡ ɐ m
அதிகரி	ɐ d̪ ɪ ɡ ɐ ɾ ɪ
அதிகாரம்	ɐ d̪ ɪ ɡ aː ɾ ɐ m
அதிகாரி	ɐ d̪ ɪ ɡ aː ɾ ɪ
அதிக்கிரமம்	ɐ d̪ ɪ kː ɪ ɾ ɐ m ɐ m
அதிட்டம்	ɐ d̪ ɪ ʈː ɐ m
அதிதி	ɐ d̪ ɪ d̪ ɪ
அதிதூதன்	ɐ d̪ ɪ d̪ uː d̪ ɐ n
அதிமதுரம்	ɐ d̪ ɪ m ɐ d̪ ʊ ɾ ɐ m
அதிரசம்	ɐ d̪ ɪ ɾ ɐ t͡ɕ ɐ m
அதிருப்தி	ɐ d̪ ɪ ɾ ʊ p t̪ ɪ
அதிர்ச்சி	ɐ d̪ ɪ ɾ t͡ɕː ɪ
அதிர்ஷ்டம்	ɐ d̪ ɪ ɾ ʂ ʈ ɐ m
அதிவிடை	ɐ d̪ ɪ ʋ ɪ ɖ ɐ ɪ̯
அது	ɐ d̪ ʊ
அதோள்	ɐ d̪ oː ɭ
அத்தனை	ɐ t̪ː ɐ n ɐ ɪ̯
அத்தாயம்	ɐ t̪ː aː j ɐ m
அத்தாளம்	ɐ t̪ː aː ɭ ɐ m
அத்தி	ɐ t̪ː ɪ
அத்தியாபகன்	ɐ t̪ː ɪ j aː b ɐ ɡ ɐ n
அத்தியாயங்கள்	ɐ t̪ː ɪ j aː j ɐ ŋ ɡ ɐ ɭ
அத்தியாயம்	ɐ t̪ː ɪ j aː j ɐ m
அத்தை	ɐ t̪ː ɐ ɪ̯
அத்தோ	ɐ t̪ː oː
அந்த	ɐ n̪ d̪ ɐ
அந்தண்டை	ɐ n̪ d̪ ɐ ɳ ɖ ɐ ɪ̯
அந்தந்த	ɐ n̪ d̪ ɐ n̪ d̪ ɐ
அந்தரீயம்	ɐ n̪ d̪ ɐ ɾ iː j ɐ m
அந்நின்று	ɐ n̪ː ɪ n r ʊ
அந்நியபாஷை	ɐ n̪ː ɪ j ɐ b aː ʂ ɐ ɪ̯
அந்நிலை	ɐ n̪ː ɪ l ɐ ɪ̯
அனாதை	ɐ n aː d̪ ɐ ɪ̯
அனாவசியம்	ɐ n aː ʋ ɐ t͡ɕ ɪ j ɐ m
அனுகூலம்	ɐ n ʊ ɡ uː l ɐ m
அனுபவம்	ɐ n ʊ b ɐ ʋ ɐ m
அனுபவி	ɐ n ʊ b ɐ ʋ ɪ
அனுப்பு	ɐ n ʊ pː ʊ
அனுமதி	ɐ n ʊ m ɐ d̪ ɪ
அனுமன்	ɐ n ʊ m ɐ n
அனுராதபுர	ɐ n ʊ ɾ aː d̪ ɐ b ʊ ɾ ɐ
அனுராதபுரம்	ɐ n ʊ ɾ aː d̪ ɐ b ʊ ɾ ɐ m
அனுவர	ɐ n ʊ ʋ ɐ ɾ ɐ
அனை	ɐ n ɐ ɪ̯
அனைத்து	ɐ n ɐ ɪ̯ t̪ː ʊ
அனைய	ɐ n ɐ ɪ̯ j ɐ
அனைவரும்	ɐ n ɐ ɪ̯ ʋ ɐ ɾ ʊ m
அன்னணம்	ɐ nː ɐ ɳ ɐ m
அன்னம்	ɐ nː ɐ m
அன்னவூர்தி	ɐ nː ɐ ʋ uː ɾ d̪ ɪ
அன்னை	ɐ nː ɐ ɪ̯
அன்பளிப்பு	ɐ n b ɐ ɭ ɪ pː ʊ
அன்பு	ɐ n b ʊ
அன்மொழித்தொகை	ɐ n m ɔ ɻ ɪ t̪ː ɔ ɡ ɐ ɪ̯
அன்றியில்	ɐ n r ɪ j ɪ l
அன்றியும்	ɐ n r ɪ j ʊ m
அன்றில்	ɐ n r ɪ l
அன்று	ɐ n r ʊ
அபராதம்	ɐ b ɐ ɾ aː d̪ ɐ m
அபர்யாப்தகம்	ɐ b ɐ ɾ j aː p t̪ ɐ ɡ ɐ m
அபாமார்க்கம்	ɐ b aː m aː ɾ kː ɐ m
அபாயம்	ɐ b aː j ɐ m
அபாரம்	ɐ b aː ɾ ɐ m
அபாலீர்ப்பு	a p aː l iː ɾ pː u
அபிமன்னு	ɐ b ɪ m ɐ nː ʊ
அபிமானம்	ɐ b ɪ m aː n ɐ m
அபிவிருத்தி	ɐ b ɪ ʋ ɪ ɾ ʊ t̪ː ɪ
அபிஷேகம்	ɐ b ɪ ʂ eː ɡ ɐ m
அப்படி	ɐ pː ɐ ɖ ɪ
அப்பன்	ɐ pː ɐ n
அப்பம்	ɐ pː ɐ m
அப்பா	ɐ pː aː
அப்பால்	ɐ pː aː l
அப்புறம்	ɐ pː ʊ r ɐ m
அப்பொழுது	ɐ pː ɔ ɻ ʊ d̪ ʊ
அமரம்	ɐ m ɐ ɾ ɐ m
அமர்	ɐ m ɐ ɾ
அமானுஷ்யம்	ɐ m aː n ʊ ʂ j ɐ m
அமிர்தம்	ɐ m ɪ ɾ d̪ ɐ m
அமிலம்	ɐ m ɪ l ɐ m
அமுக்கு	ɐ m ʊ kː ʊ
அமுதம்	ɐ m ʊ d̪ ɐ m
அமெரிக்கா	ɐ m ɛ ɾ ɪ kː aː
அமை	ɐ m ɐ ɪ̯
அமைச்சன்	ɐ m ɐ ɪ̯ t͡ɕː ɐ n
அமைச்சர்	ɐ m ɐ ɪ̯ t͡ɕː ɐ ɾ
அமைச்சு	ɐ m ɐ ɪ̯ t͡ɕː ʊ
அமைதி	ɐ m ɐ ɪ̯ d̪ ɪ
அமையம்	ɐ m ɐ ɪ̯ j ɐ m
அம்பட்டன்	ɐ m b ɐ ʈː ɐ n
அம்பரம்	ɐ m b ɐ ɾ ɐ m
அம்பர்	ɐ m b ɐ ɾ
அம்பலகாரன்	ɐ m b ɐ l ɐ ɡ aː ɾ ɐ n
அம்பாந்தோட்டை	ɐ m b aː n̪ d̪ oː ʈː ɐ ɪ̯
அம்பாரி	ɐ m b aː ɾ ɪ
அம்பி	ɐ m b ɪ
அம்பு	ɐ m b ʊ
அம்புலி	ɐ m b ʊ l ɪ
அம்மன்	ɐ mː ɐ n
அம்மா	ɐ mː aː
அம்மான்	ɐ mː aː n
அம்மாய்	ɐ mː aː j
அம்மாள்	ɐ mː aː ɭ
அம்மி	ɐ mː ɪ
அம்மை	ɐ mː ɐ ɪ̯
அயனமண்டலம்	ɐ j ɐ n ɐ m ɐ ɳ ɖ ɐ l ɐ m
அயனம்	ɐ j ɐ n ɐ m
அயர்	ɐ j ɐ ɾ
அயர்ச்சி	ɐ j ɐ ɾ t͡ɕː ɪ
அயலான்	ɐ j ɐ l aː n
அயல்	ɐ j ɐ l
அயிங்கிசை	ɐ j ɪ ŋ ɡ ɪ t͡ɕ ɐ ɪ̯
அயோத்தி	ɐ j oː t̪ː ɪ
அய்யா	ɐ jː aː
அரக்கன்	ɐ ɾ ɐ kː ɐ n
அரக்கி	ɐ ɾ ɐ kː ɪ
அரக்கு	ɐ ɾ ɐ kː ʊ
அரங்கம்	ɐ ɾ ɐ ŋ ɡ ɐ m
அரசன்	ɐ ɾ ɐ t͡ɕ ɐ n
அரசமரபு	ɐ ɾ ɐ t͡ɕ ɐ m ɐ ɾ ɐ b ʊ
அரசவை	ɐ ɾ ɐ t͡ɕ ɐ ʋ ɐ ɪ̯
அரசாங்கம்	ɐ ɾ ɐ t͡ɕ aː ŋ ɡ ɐ m
அரசி	ɐ ɾ ɐ t͡ɕ ɪ
அரசியல்	ɐ ɾ ɐ t͡ɕ ɪ j ɐ l
அரசியும்	ɐ ɾ ɐ t͡ɕ ɪ j ʊ m
அரசு	ɐ ɾ ɐ t͡ɕ ʊ
அரண்	ɐ ɾ ɐ ɳ
அரண்மனை	ɐ ɾ ɐ ɳ m ɐ n ɐ ɪ̯
அரத்தை	ɐ ɾ ɐ t̪ː ɐ ɪ̯
அரளி	ɐ ɾ ɐ ɭ ɪ
அரவம்	ɐ ɾ ɐ ʋ ɐ m
அரவிந்தம்	ɐ ɾ ɐ ʋ ɪ n̪ d̪ ɐ m
அராவாரம்	ɐ ɾ aː ʋ aː ɾ ɐ m
அரி	ɐ ɾ ɪ
அரிசி	ɐ ɾ ɪ t͡ɕ ɪ
அரிச்சுவடி	ɐ ɾ ɪ t͡ɕː ʊ ʋ ɐ ɖ ɪ
அரிமா	ɐ ɾ ɪ m aː
அரியணை	ɐ ɾ ɪ j ɐ ɳ ɐ ɪ̯
அரியலூர்	ɐ ɾ ɪ j ɐ l uː ɾ
அரியானா	ɐ ɾ ɪ j aː n aː
அரிவாள்	ɐ ɾ ɪ ʋ aː ɭ
அரிவாள்மணை	ɐ ɾ ɪ ʋ aː ɭ m ɐ ɳ ɐ ɪ̯
அருகதிகம்	ɐ ɾ ʊ ɡ ɐ d̪ ɪ ɡ ɐ m
அருகலை	ɐ ɾ ʊ ɡ ɐ l ɐ ɪ̯
அருகல்	ɐ ɾ ʊ ɡ ɐ l
அருகில்	ɐ ɾ ʊ ɡ ɪ l
அருகு	ɐ ɾ ʊ ɡ ʊ
அருக்கன்	ɐ ɾ ʊ kː ɐ n
அருக்கன்வீதி	ɐ ɾ ʊ kː ɐ n ʋ iː d̪ ɪ
அருங்காட்சியகம்	ɐ ɾ ʊ ŋ ɡ aː ʈ t͡ɕ ɪ j ɐ ɡ ɐ m
அருச்சி	ɐ ɾ ʊ t͡ɕː ɪ
அருஞ்சொற்பொருள்	ɐ ɾ ʊ ɲ d͡ʑ ɔ r p ɔ ɾ ʊ ɭ
அருந்து	ɐ ɾ ʊ n̪ d̪ ʊ
அருப்பம்	ɐ ɾ ʊ pː ɐ m
அருமை	ɐ ɾ ʊ m ɐ ɪ̯
அருளுரை	ɐ ɾ ʊ ɭ ʊ ɾ ɐ ɪ̯
அருளுரைகள்	ɐ ɾ ʊ ɭ ʊ ɾ ɐ ɪ̯ ɡ ɐ ɭ
அருள்	ɐ ɾ ʊ ɭ
அருள்மிகு	ɐ ɾ ʊ ɭ m ɪ ɡ ʊ
அருள்வாக்கு	ɐ ɾ ʊ ɭ ʋ aː kː ʊ
அருவி	ɐ ɾ ʊ ʋ ɪ
அரை	ɐ ɾ ɐ ɪ̯
அரைகல்	ɐ ɾ ɐ ɪ̯ ɡ ɐ l
அரைக்கச்சு	ɐ ɾ ɐ ɪ̯ kː ɐ t͡ɕː ʊ
அரைஞாண்	ɐ ɾ ɐ ɪ̯ ɲ aː ɳ
அரைநெல்லி	ɐ ɾ ɐ ɪ̯ n̪ ɛ l l ɪ
அரைப்பட்டிகை	ɐ ɾ ɐ ɪ̯ pː ɐ ʈː ɪ ɡ ɐ ɪ̯
அர்க்கார்	ɐ ɾ kː aː ɾ
அர்ச்சிதன்	ɐ ɾ t͡ɕː ɪ d̪ ɐ n
அர்ஜுனன்	ɐ ɾ d͡ʑ ʊ n ɐ n
அர்ப்பணம்	ɐ ɾ pː ɐ ɳ ɐ m
அர்ப்பணி	ɐ ɾ pː ɐ ɳ ɪ
அர்ப்பணிப்பு	ɐ ɾ pː ɐ ɳ ɪ pː ʊ
அறக்கட்டளை	ɐ r ɐ kː ɐ ʈː ɐ ɭ ɐ ɪ̯
அறம்	ɐ r ɐ m
அறி	ɐ r ɪ
அறிகுறி	ɐ r ɪ ɡ ʊ r ɪ
அறிக்கை	ɐ r ɪ kː ɐ ɪ̯
அறிக்கைபண்ணு	ɐ r ɪ kː ɐ ɪ̯ b ɐ ɳː ʊ
அறிக்கைப்பத்திரம்	ɐ r ɪ kː ɐ ɪ̯ pː ɐ t̪ː ɪ ɾ ɐ m
அறிஞர்	ɐ r ɪ ɲ ɐ ɾ
அறிப்பு	ɐ r ɪ pː ʊ
அறிவாய்வியல்	ɐ r ɪ ʋ aː j ʋ ɪ j ɐ l
அறிவி	ɐ r ɪ ʋ ɪ
அறிவிப்பு	ɐ r ɪ ʋ ɪ pː ʊ
அறிவியல்	ɐ r ɪ ʋ ɪ j ɐ l
அறிவு	ɐ r ɪ ʋ ʊ
அறு	ɐ r ʊ
அறுகம்புல்	ɐ r ʊ ɡ ɐ m b ʊ l
அறுகு	ɐ r ʊ ɡ ʊ
அறுகோணம்	ɐ r ʊ ɡ oː ɳ ɐ m
அறுதி	ɐ r ʊ d̪ ɪ
அறுநூறு	ɐ r ʊ n̪ uː r ʊ
அறுபது	ɐ r ʊ b ɐ d̪ ʊ
அறுப்பு	ɐ r ʊ pː ʊ
அறுவடை	ɐ r ʊ ʋ ɐ ɖ ɐ ɪ̯
அறை	ɐ r ɐ ɪ̯
அற்பகதம்	ɐ r p ɐ ɡ ɐ d̪ ɐ m
அற்புதம்	ɐ r p ʊ d̪ ɐ m
அலகு	ɐ l ɐ ɡ ʊ
அலகை	ɐ l ɐ ɡ ɐ ɪ̯
அலங்கரணம்	ɐ l ɐ ŋ ɡ ɐ ɾ ɐ ɳ ɐ m
அலங்கரி	ɐ l ɐ ŋ ɡ ɐ ɾ ɪ
அலங்காரமாடம்	ɐ l ɐ ŋ ɡ aː ɾ ɐ m aː ɖ ɐ m
அலங்காரம்	ɐ l ɐ ŋ ɡ aː ɾ ɐ m
அலமாரி	ɐ l ɐ m aː ɾ ɪ
அலம்பு	ɐ l ɐ m b ʊ
அலர்த்தி	ɐ l ɐ ɾ t̪ː ɪ
அலறு	ɐ l ɐ r ʊ
அலாதி	ɐ l aː d̪ ɪ
அலாஸ்கா	ɐ l aː s k aː
அலி	ɐ l ɪ
அலுப்பு	ɐ l ʊ pː ʊ
அலுவம்	ɐ l ʊ ʋ ɐ m
அலுவலகம்	ɐ l ʊ ʋ ɐ l ɐ ɡ ɐ m
அலுவல்	ɐ l ʊ ʋ ɐ l
அலை	ɐ l ɐ ɪ̯
அலைதாடி	ɐ l ɐ ɪ̯ d̪ aː ɖ ɪ
அலைப்பு	ɐ l ɐ ɪ̯ pː ʊ
அலைப்பேசி	ɐ l ɐ ɪ̯ pː eː t͡ɕ ɪ
அல்	ɐ l
அல்குல்	ɐ l ɡ ʊ l
அல்ல	ɐ l l ɐ
அல்லது	ɐ l l ɐ d̪ ʊ
அல்லதை	ɐ l l ɐ d̪ ɐ ɪ̯
அல்லறம்	ɐ l l ɐ r ɐ m
அல்லல்	ɐ l l ɐ l
அல்லேலூயா	ɐ l l eː l uː j aː
அள	ɐ ɭ ɐ
அளம்	ɐ ɭ ɐ m
அளவர்	ɐ ɭ ɐ ʋ ɐ ɾ
அளவளாவு	ɐ ɭ ɐ ʋ ɐ ɭ aː ʋ ʊ
அளவில்	ɐ ɭ ɐ ʋ ɪ l
அளவு	ɐ ɭ ɐ ʋ ʊ
அளவுகோல்	ɐ ɭ ɐ ʋ ʊ ɡ oː l
அளவை	ɐ ɭ ɐ ʋ ɐ ɪ̯
அளி	ɐ ɭ ɪ
அளேரியம்	ɐ ɭ eː ɾ ɪ j ɐ m
அள்ளு	ɐ ɭː ʊ
அழகன்	ɐ ɻ ɐ ɡ ɐ n
அழகு	ɐ ɻ ɐ ɡ ʊ
அழி	ɐ ɻ ɪ
அழிஞ்சில்	ɐ ɻ ɪ ɲ d͡ʑ ɪ l
அழிபு	ɐ ɻ ɪ b ʊ
அழிப்பு	ɐ ɻ ɪ pː ʊ
அழிவாய்	ɐ ɻ ɪ ʋ aː j
அழிவு	ɐ ɻ ɪ ʋ ʊ
அழு	ɐ ɻ ʊ
அழுக்கு	ɐ ɻ ʊ kː ʊ
அழுத்தம்	ɐ ɻ ʊ t̪ː ɐ m
அழுத்து	ɐ ɻ ʊ t̪ː ʊ
அழை	ɐ ɻ ɐ ɪ̯
அழைப்பு	ɐ ɻ ɐ ɪ̯ pː ʊ
அவகாசம்	ɐ ʋ ɐ ɡ aː t͡ɕ ɐ m
அவசியம்	ɐ ʋ ɐ t͡ɕ ɪ j ɐ m
அவண்	ɐ ʋ ɐ ɳ
அவதாரம்	ɐ ʋ ɐ d̪ aː ɾ ɐ m
அவதி	ɐ ʋ ɐ d̪ ɪ
அவதூறு	ɐ ʋ ɐ d̪ uː r ʊ
அவனி	ɐ ʋ ɐ n ɪ
அவன்	ɐ ʋ ɐ n
அவமதிப்பு	ɐ ʋ ɐ m ɐ d̪ ɪ pː ʊ
அவமானம்	ɐ ʋ ɐ m aː n ɐ m
அவரை	ɐ ʋ ɐ ɾ ɐ ɪ̯
அவரோகணம்	ɐ ʋ ɐ ɾ oː ɡ ɐ ɳ ɐ m
அவர்	ɐ ʋ ɐ ɾ
அவர்கள்	ɐ ʋ ɐ ɾ ɡ ɐ ɭ
அவல்	ɐ ʋ ɐ l
அவள்	ɐ ʋ ɐ ɭ
அவா	ɐ ʋ aː
அவாந்தரம்	ɐ ʋ aː n̪ d̪ ɐ ɾ ɐ m
அவி	ɐ ʋ ɪ
அவித்துருமம்	ɐ ʋ ɪ t̪ː ʊ ɾ ʊ m ɐ m
அவிழ்	ɐ ʋ ɪ ɻ
அவுரி	ɐ ʋ ʊ ɾ ɪ
அவுஸ்திரேலியா	ɐ ʋ ʊ s t̪ ɪ ɾ eː l ɪ j aː
அவை	ɐ ʋ ɐ ɪ̯
அவ்	ɐ ʋ
அவ்வண்ணம்	ɐ ʋː ɐ ɳː ɐ m
அவ்வது	ɐ ʋː ɐ d̪ ʊ
அவ்வருகு	ɐ ʋː ɐ ɾ ʊ ɡ ʊ
அவ்வழி	ɐ ʋː ɐ ɻ ɪ
அவ்வாறு	ɐ ʋː aː r ʊ
அவ்விடம்	ɐ ʋː ɪ ɖ ɐ m
அவ்வோ	ɐ ʋː oː
அவ்வோன்	ɐ ʋː oː n
அஸ்தமனம்	ɐ s t̪ ɐ m ɐ n ɐ m
அஸ்தி	ɐ s t̪ ɪ
அஹம்	ɐ h ɐ m
ஆ	aː
ஆகடியம்	aː ɡ ɐ ɖ ɪ j ɐ m
ஆகஸ்டு	aː ɡ ɐ s ʈ ʊ
ஆகாசம்	aː ɡ aː t͡ɕ ɐ m
ஆகாதே	aː ɡ aː d̪ eː
ஆகாயதந்தம்	aː ɡ aː j ɐ d̪ ɐ n̪ d̪ ɐ m
ஆகாயம்	aː ɡ aː j ɐ m
ஆகு	aː ɡ ʊ
ஆகுபெயர்	ʔ aː ɡ u p e j a ɾ̪
ஆகைச்சுட்டி	aː ɡ ɐ ɪ̯ t͡ɕː ʊ ʈː ɪ
ஆகையால்	aː ɡ ɐ ɪ̯ j aː l
ஆக்கன்	aː kː ɐ n
ஆக்கம்	aː kː ɐ m
ஆக்கவினை	aː kː ɐ ʋ ɪ n ɐ ɪ̯
ஆக்கினை	aː kː ɪ n ɐ ɪ̯
ஆக்கு	aː kː ʊ
ஆக்ஸிஜன்	aː k s ɪ d͡ʑ ɐ n
ஆங்க	aː ŋ ɡ ɐ
ஆங்கண்	aː ŋ ɡ ɐ ɳ
ஆங்கனம்	aː ŋ ɡ ɐ n ɐ m
ஆங்கிலம்	aː ŋ ɡ ɪ l ɐ m
ஆங்கு	aː ŋ ɡ ʊ
ஆங்ஙனம்	aː ŋː ɐ n ɐ m
ஆசனம்	aː t͡ɕ ɐ n ɐ m
ஆசயம்	aː t͡ɕ ɐ j ɐ m
ஆசற	aː t͡ɕ ɐ r ɐ
ஆசான்	aː t͡ɕ aː n
ஆசினி	aː t͡ɕ ɪ n ɪ
ஆசியா	aː t͡ɕ ɪ j aː
ஆசிரியர்	aː t͡ɕ ɪ ɾ ɪ j ɐ ɾ
ஆசிருந்தம்	aː t͡ɕ ɪ ɾ ʊ n̪ d̪ ɐ m
ஆசீர்வசனம்	aː t͡ɕ iː ɾ ʋ ɐ t͡ɕ ɐ n ɐ m
ஆசீர்வதி	aː t͡ɕ iː ɾ ʋ ɐ d̪ ɪ
ஆசை	aː t͡ɕ ɐ ɪ̯
ஆச்ச	aː t͡ɕː ɐ
ஆச்சரியம்	aː t͡ɕː ɐ ɾ ɪ j ɐ m
ஆடம்பரம்	aː ɖ ɐ m b ɐ ɾ ɐ m
ஆடல்	aː ɖ ɐ l
ஆடவை	aː ɖ ɐ ʋ ɐ ɪ̯
ஆடாதோடை	aː ɖ aː d̪ oː ɖ ɐ ɪ̯
ஆடி	aː ɖ ɪ
ஆடிக்காற்று	aː ɖ ɪ kː aː rː ʊ
ஆடு	aː ɖ ʊ
ஆடுமாடு	aː ɖ ʊ m aː ɖ ʊ
ஆடை	aː ɖ ɐ ɪ̯
ஆட்சி	aː ʈ t͡ɕ ɪ
ஆட்சை	aː ʈ t͡ɕ ɐ ɪ̯
ஆட்டன்	aː ʈː ɐ n
ஆட்டம்	aː ʈː ɐ m
ஆட்டி	aː ʈː ɪ
ஆட்டு	aː ʈː ʊ
ஆட்டுக்கல்	aː ʈː ʊ kː ɐ l
ஆட்டுப்பால்	aː ʈː ʊ pː aː l
ஆணவம்	aː ɳ ɐ ʋ ɐ m
ஆணி	aː ɳ ɪ
ஆணிமுத்து	aː ɳ ɪ m ʊ t̪ː ʊ
ஆணிவேர்	aː ɳ ɪ ʋ eː ɾ
ஆணை	aː ɳ ɐ ɪ̯
ஆணையம்	aː ɳ ɐ ɪ̯ j ɐ m
ஆணையிடு	aː ɳ ɐ ɪ̯ j ɪ ɖ ʊ
ஆண்	aː ɳ
ஆண்கள்	aː ɳ ɡ ɐ ɭ
ஆண்குறி	aː ɳ ɡ ʊ r ɪ
ஆண்டவன்	aː ɳ ɖ ɐ ʋ ɐ n
ஆண்டான்	aː ɳ ɖ aː n
ஆண்டு	aː ɳ ɖ ʊ
ஆண்டுகள்ளடவு	aː ɳ ɖ ʊ ɡ ɐ ɭː ɐ ɖ ɐ ʋ ʊ
ஆண்பால்	aː ɳ b aː l
ஆண்மை	aː ɳ m ɐ ɪ̯
ஆதாம்	aː d̪ aː m
ஆதாயம்	aː d̪ aː j ɐ m
ஆதாரம்	aː d̪ aː ɾ ɐ m
ஆதி	aː d̪ ɪ
ஆதியாகமம்	aː d̪ ɪ j aː ɡ ɐ m ɐ m
ஆந்தை	aː n̪ d̪ ɐ ɪ̯
ஆனால்	aː n aː l
ஆனி	aː n ɪ
ஆனை	aː n ɐ ɪ̯
ஆனைக்கொன்றான்	aː n ɐ ɪ̯ kː ɔ n r aː n
ஆனைக்கொம்பு	aː n ɐ ɪ̯ kː ɔ m b ʊ
ஆனைமுகன்	aː n ɐ ɪ̯ m ʊ ɡ ɐ n
ஆன்மீகம்	aː n m iː ɡ ɐ m
ஆபகூக்	aː b ɐ ɡ uː k
ஆபத்து	aː b ɐ t̪ː ʊ
ஆபரணம்	aː b ɐ ɾ ɐ ɳ ɐ m
ஆபிச்	aː b ɪ t͡ɕ
ஆபிரகாம்	aː b ɪ ɾ ɐ ɡ aː m
ஆபிரகாம்	aː b ɾ ɐ h aː m
ஆபீசு	aː b iː t͡ɕ ʊ
ஆப்காரி	aː p k aː ɾ ɪ
ஆப்பம்	aː pː ɐ m
ஆப்பிரிக்கா	aː pː ɪ ɾ ɪ kː aː
ஆப்பு	aː pː ʊ
ஆமாம்	aː m aː m
ஆமை	aː m ɐ ɪ̯
ஆமைகள்	aː m ɐ ɪ̯ ɡ ɐ ɭ
ஆம்	aː m
ஆம்பல்	aː m b ɐ l
ஆம்பி	aː m b ɪ
ஆயத்தம்	aː j ɐ t̪ː ɐ m
ஆயன்	aː j ɐ n
ஆயர்	aː j ɐ ɾ
ஆயா	aː j aː
ஆயிட்டு	aː j ɪ ʈː ʊ
ஆயிரம்	aː j ɪ ɾ ɐ m
ஆயிழை	aː j ɪ ɻ ɐ ɪ̯
ஆயுசு	aː j ʊ t͡ɕ ʊ
ஆயுட்காலம்	aː j ʊ ʈ k aː l ɐ m
ஆயுதம்	aː j ʊ d̪ ɐ m
ஆயுள்	aː j ʊ ɭ
ஆய்	aː j
ஆய்ச்சி	aː j t͡ɕː ɪ
ஆய்தம்	aː j d̪ ɐ m
ஆய்வு	aː j ʋ ʊ
ஆரம்	aː ɾ ɐ m
ஆரம்பம்	aː ɾ ɐ m b ɐ m
ஆரம்பி	aː ɾ ɐ m b ɪ
ஆராய்	aː ɾ aː j
ஆராய்ச்சி	aː ɾ aː j t͡ɕː ɪ
ஆரியம்	aː ɾ ɪ j ɐ m
ஆரிருள்	aː ɾ ɪ ɾ ʊ ɭ
ஆரோக்கியம்	aː ɾ oː kː ɪ j ɐ m
ஆரோக்கியம்	aː ɾ oː ɡ ɡ ɪ j ɐ m
ஆர்	aː ɾ
ஆர்கனோ	aː ɾ ɡ ɐ n oː
ஆர்ட்டின்	aː ɾ ʈː ɪ n
ஆர்ட்டின்கள்	aː ɾ ʈː ɪ n ɡ ɐ ɭ
ஆர்த்தி	aː ɾ t̪ː ɪ
ஆர்மதி	aː ɾ m ɐ d̪ ɪ
ஆர்மீனியா	aː ɾ m iː n ɪ j aː
ஆர்வம்	aː ɾ ʋ ɐ m
ஆறாவது	aː r aː ʋ ɐ d̪ ʊ
ஆறு	aː r ʊ
ஆறுமணிப்பூ	aː r ʊ m ɐ ɳ ɪ pː uː
ஆற்றங்கரை	aː rː ɐ ŋ ɡ ɐ ɾ ɐ ɪ̯
ஆற்றல்	aː rː ɐ l
ஆற்று	aː rː ʊ
ஆற்றுச்செருப்படி	aː rː ʊ t͡ɕː ɛ ɾ ʊ pː ɐ ɖ ɪ
ஆலக்கொடி	aː l ɐ kː ɔ ɖ ɪ
ஆலசம்	aː l ɐ t͡ɕ ɐ m
ஆலப்புழா	aː l ɐ pː ʊ ɻ aː
ஆலமரம்	aː l ɐ m ɐ ɾ ɐ m
ஆலம்	aː l ɐ m
ஆலயம்	aː l ɐ j ɐ m
ஆலா	aː l aː
ஆலாபனம்	aː l aː b ɐ n ɐ m
ஆலை	aː l ɐ ɪ̯
ஆலோசனை	aː l oː t͡ɕ ɐ n ɐ ɪ̯
ஆலோசி	aː l oː t͡ɕ ɪ
ஆல்	aː l
ஆளாபம்	aː ɭ aː b ɐ m
ஆளி	aː ɭ ɪ
ஆளுகை	aː ɭ ʊ ɡ ɐ ɪ̯
ஆளுங்கணம்	aː ɭ ʊ ŋ ɡ ɐ ɳ ɐ m
ஆளுநர்	aː ɭ ʊ n̪ ɐ ɾ
ஆளுமை	aː ɭ ʊ m ɐ ɪ̯
ஆளுவல்லி	aː ɭ ʊ ʋ ɐ l l ɪ
ஆள்	aː ɭ
ஆழம்	aː ɻ ɐ m
ஆழி	aː ɻ ɪ
ஆழிப்பேரலை	aː ɻ ɪ pː eː ɾ ɐ l ɐ ɪ̯
ஆழ்கடல்	aː ɻ ɡ ɐ ɖ ɐ l
ஆழ்மயக்கம்	aː ɻ m ɐ j ɐ kː ɐ m
ஆழ்வார்	aː ɻ ʋ aː ɾ
ஆவணப்படம்	aː ʋ ɐ ɳ ɐ pː ɐ ɖ ɐ m
ஆவணம்	aː ʋ ɐ ɳ ɐ m
ஆவணி	aː ʋ ɐ ɳ ɪ
ஆவலி	aː ʋ ɐ l ɪ
ஆவல்	aː ʋ ɐ l
ஆவி	aː ʋ ɪ
ஆவுளியா	aː ʋ ʊ ɭ ɪ j aː
ஆஸ்திரேலியா	aː s t̪ ɪ ɾ eː l ɪ j aː
ஆஸ்பத்திரி	aː s p ɐ t̪ː ɪ ɾ ɪ
இ	ɪ
இகழ்ச்சி	ɪ ɡ ɐ ɻ t͡ɕː ɪ
இகுலாசு	ɪ ɡ ʊ l aː t͡ɕ ʊ
இகுவான்	ɪ ɡ ʊ ʋ aː n
இக்கு	ɪ kː ʊ
இக்தியார்	ɪ k t̪ ɪ j aː ɾ
இக்லூ	ɪ k l uː
இக்லூ	ɪ ɡ l uː
இங்கண்	ɪ ŋ ɡ ɐ ɳ
இங்கிட்டு	ɪ ŋ ɡ ɪ ʈː ʊ
இங்கிலாந்து	ɪ ŋ ɡ ɪ l aː n̪ d̪ ʊ
இங்கு	ɪ ŋ ɡ ʊ
இங்குத்தை	ɪ ŋ ɡ ʊ t̪ː ɐ ɪ̯
இங்குஷேத்தியா	ɪ ŋ ɡ ʊ ʂ eː t̪ː ɪ j aː
இங்கே	ɪ ŋ ɡ eː
இங்ஙனம்	ɪ ŋː ɐ n ɐ m
இசப்கோல்	ɪ t͡ɕ ɐ p k oː l
இசுபேடு	ɪ t͡ɕ ʊ b eː ɖ ʊ
இசுபேடுக்கள்	ɪ t͡ɕ ʊ b eː ɖ ʊ kː ɐ ɭ
இசுலாம்	ɪ t͡ɕ ʊ l aː m
இசை	ɪ t͡ɕ ɐ ɪ̯
இசைக்கருவி	ɪ t͡ɕ ɐ ɪ̯ kː ɐ ɾ ʊ ʋ ɪ
இசைப்பாட்டு	ɪ t͡ɕ ɐ ɪ̯ pː aː ʈː ʊ
இசைவு	ɪ t͡ɕ ɐ ɪ̯ ʋ ʊ
இச்சகம்	ɪ t͡ɕː ɐ ɡ ɐ m
இச்சை	ɪ t͡ɕː ɐ ɪ̯
இச்சையடக்கம்	ɪ t͡ɕː ɐ ɪ̯ j ɐ ɖ ɐ kː ɐ m
இஞ்சி	ɪ ɲ d͡ʑ ɪ
இஞ்சிமாங்காய்	ɪ ɲ d͡ʑ ɪ m aː ŋ ɡ aː j
இஞ்சீல்	ɪ ɲ d͡ʑ iː l
இடக்கரடக்கல்	ɪ ɖ ɐ kː ɐ ɾ ɐ ɖ ɐ kː ɐ l
இடக்கர்	ɪ ɖ ɐ kː ɐ ɾ
இடக்கு	ɪ ɖ ɐ kː ʊ
இடங்கர்	ɪ ɖ ɐ ŋ ɡ ɐ ɾ
இடது	ɪ ɖ ɐ d̪ ʊ
இடபம்	ɪ ɖ ɐ b ɐ m
இடப்பு	ɪ ɖ ɐ pː ʊ
இடப்பெயர்	ɪ ɖ ɐ pː ɛ j ɐ ɾ
இடம்	ɪ ɖ ɐ m
இடாய்ச்சு	ɪ ɖ aː j t͡ɕː ʊ
இடி	ɪ ɖ ɪ
இடியப்பம்	ɪ ɖ ɪ j ɐ pː ɐ m
இடியாப்பம்	ɪ ɖ ɪ j aː pː ɐ m
இடு	ɪ ɖ ʊ
இடுகுறி	ʔ i ɖ u k u r i
இடுக்கி	ɪ ɖ ʊ kː ɪ
இடுப்பு	ɪ ɖ ʊ pː ʊ
இடை	ɪ ɖ ɐ ɪ̯
இடைச்சொல்	ɪ ɖ ɐ ɪ̯ t͡ɕː ɔ l
இடையாட்டம்	ɪ ɖ ɐ ɪ̯ j aː ʈː ɐ m
இடையிடு	ɪ ɖ ɐ ɪ̯ j ɪ ɖ ʊ
இடையினம்	ɪ ɖ ɐ ɪ̯ j ɪ n ɐ m
இடையீடு	ɪ ɖ ɐ ɪ̯ j iː ɖ ʊ
இடையூறு	ɪ ɖ ɐ ɪ̯ j uː r ʊ
இடையெழுத்து	ɪ ɖ ɐ ɪ̯ j ɛ ɻ ʊ t̪ː ʊ
இட்டம்	ɪ ʈː ɐ m
இட்டிடை	ɪ ʈː ɪ ɖ ɐ ɪ̯
இட்டிடைஞ்சல்	ɪ ʈː ɪ ɖ ɐ ɪ̯ ɲ d͡ʑ ɐ l
இட்டு	ɪ ʈː ʊ
இட்லி	ɪ ɖ l ɪ
இட்லி	ɪ ʈ l ɪ
இணக்கம்	ɪ ɳ ɐ kː ɐ m
இணக்கு	ɪ ɳ ɐ kː ʊ
இணர்	ɪ ɳ ɐ ɾ
இணை	ɪ ɳ ɐ ɪ̯
இணையதளம்	ɪ ɳ ɐ ɪ̯ j ɐ d̪ ɐ ɭ ɐ m
இதயம்	ɪ d̪ ɐ j ɐ m
இதலை	ɪ d̪ ɐ l ɐ ɪ̯
இதழ்	ɪ d̪ ɐ ɻ
இதிகாசம்	ɪ d̪ ɪ ɡ aː t͡ɕ ɐ m
இது	ɪ d̪ ʊ
இத்தனை	ɪ t̪ː ɐ n ɐ ɪ̯
இத்தால்	ɪ t̪ː aː l
இத்திஹாத்தான	ɪ t̪ː ɪ h aː t̪ː aː n ɐ
இத்ரீஸ்	ɪ t̪ ɾ iː s
இந்த	ɪ n̪ d̪ ɐ
இந்தி	ɪ n̪ d̪ ɪ
இந்தியர்	ɪ n̪ d̪ ɪ j ɐ ɾ
இந்தியா	ɪ n̪ d̪ ɪ j aː
இந்திரன்	ɪ n̪ d̪ ɪ ɾ ɐ n
இந்து	ɪ n̪ d̪ ʊ
இந்தோனேசியா	ɪ n̪ d̪ oː n eː t͡ɕ ɪ j aː
இனப்படுகொலை	ɪ n ɐ pː ɐ ɖ ʊ ɡ ɔ l ɐ ɪ̯
இனம்	ɪ n ɐ m
இனவெழுத்து	ɪ n ɐ ʋ ɛ ɻ ʊ t̪ː ʊ
இனி	ɪ n ɪ
இனிப்பு	ɪ n ɪ pː ʊ
இனிமை	ɪ n ɪ m ɐ ɪ̯
இனிய	ɪ n ɪ j ɐ
இன்	ɪ n
இன்கண்	ɪ n ɡ ɐ ɳ
இன்ன	ɪ nː ɐ
இன்னணம்	ɪ nː ɐ ɳ ɐ m
இன்னது	ɪ nː ɐ d̪ ʊ
இன்னல்	ɪ nː ɐ l
இன்னுமின்னும்	ɪ nː ʊ m ɪ nː ʊ m
இன்னும்	ɪ nː ʊ m
இன்னே	ɪ nː eː
இன்பம்	ɪ n b ɐ m
இன்றிரவு	ɪ n r ɪ ɾ ɐ ʋ ʊ
இன்று	ɪ n r ʊ
இபங்கம்	ɪ b ɐ ŋ ɡ ɐ m
இபுதார்	ɪ b ʊ d̪ aː ɾ
இப்படி	ɪ pː ɐ ɖ ɪ
இப்புறம்	ɪ pː ʊ r ɐ m
இப்பொழுது	ɪ pː ɔ ɻ ʊ d̪ ʊ
இப்போது	ɪ pː oː d̪ ʊ
இப்ராஹிம்	ɪ b ɾ aː h ɪ m
இமம்	ɪ m ɐ m
இமாம்	ɪ m aː m
இம்சை	ɪ m t͡ɕ ɐ ɪ̯
இயக்கங்கள்	ɪ j ɐ kː ɐ ŋ ɡ ɐ ɭ
இயக்கம்	ɪ j ɐ kː ɐ m
இயக்கு	ɪ j ɐ kː ʊ
இயக்குனர்	ɪ j ɐ kː ʊ n ɐ ɾ
இயக்குரோதம்	ɪ j ɐ kː ʊ ɾ oː d̪ ɐ m
இயங்கு	ɪ j ɐ ŋ ɡ ʊ
இயங்குதளம்	ɪ j ɐ ŋ ɡ ʊ d̪ ɐ ɭ ɐ m
இயந்திரம்	ɪ j ɐ n̪ d̪ ɪ ɾ ɐ m
இயம்	ɪ j ɐ m
இயற்கணிதம்	ɪ j ɐ r k ɐ ɳ ɪ d̪ ɐ m
இயற்கை	ɪ j ɐ r k ɐ ɪ̯
இயற்கைப்பொருள்	ɪ j ɐ r k ɐ ɪ̯ pː ɔ ɾ ʊ ɭ
இயல்	ɪ j ɐ l
இயல்பு	ɪ j ɐ l b ʊ
இயல்புகணம்	ɪ j ɐ l b ʊ ɡ ɐ ɳ ɐ m
இயாத்திரை	ɪ j aː t̪ː ɪ ɾ ɐ ɪ̯
இயேசு	ɪ j eː t͡ɕ ʊ
இயைபு	ɪ j ɐ ɪ̯ b ʊ
இரக்கம்	ɪ ɾ ɐ kː ɐ m
இரங்கு	ɪ ɾ ɐ ŋ ɡ ʊ
இரசாயனம்	ɪ ɾ ɐ t͡ɕ aː j ɐ n ɐ m
இரசிதம்	ɪ ɾ ɐ t͡ɕ ɪ d̪ ɐ m
இரட்சி	ɪ ɾ ɐ ʈ t͡ɕ ɪ
இரட்டகத்துத்தி	ɪ ɾ ɐ ʈː ɐ ɡ ɐ t̪ː ʊ t̪ː ɪ
இரட்டி	ɪ ɾ ɐ ʈː ɪ
இரட்டு	ɪ ɾ ɐ ʈː ʊ
இரட்டை	ɪ ɾ ɐ ʈː ɐ ɪ̯
இரட்டைக்கிளவி	ɪ ɾ ɐ ʈː ɐ ɪ̯ kː ɪ ɭ ɐ ʋ ɪ
இரட்டையர்	ɪ ɾ ɐ ʈː ɐ ɪ̯ j ɐ ɾ
இரணியம்	ɪ ɾ ɐ ɳ ɪ j ɐ m
இரணை	ɪ ɾ ɐ ɳ ɐ ɪ̯
இரண்டு	ɪ ɾ ɐ ɳ ɖ ʊ
இரண்டை	ɪ ɾ ɐ ɳ ɖ ɐ ɪ̯
இரதம்	ɪ ɾ ɐ d̪ ɐ m
இரத்தம்	ɪ ɾ ɐ t̪ː ɐ m
இரத்தினபுரி	ɪ ɾ ɐ t̪ː ɪ n ɐ b ʊ ɾ ɪ
இரத்தினம்	ɪ ɾ ɐ t̪ː ɪ n ɐ m
இரந்தை	ɪ ɾ ɐ n̪ d̪ ɐ ɪ̯
இரப்பு	ɪ ɾ ɐ pː ʊ
இரயில்	ɪ ɾ ɐ j ɪ l
இரவு	ɪ ɾ ɐ ʋ ʊ
இராகம்	ɪ ɾ aː ɡ ɐ m
இராகவன்	ɪ ɾ aː ɡ ɐ ʋ ɐ n
இராசகுமாரி	ɪ ɾ aː t͡ɕ ɐ ɡ ʊ m aː ɾ ɪ
இராசன்	ɪ ɾ aː t͡ɕ ɐ n
இராசபத்திரம்	ɪ ɾ aː t͡ɕ ɐ b ɐ t̪ː ɪ ɾ ɐ m
இராசபுத்திரன்	ɪ ɾ aː t͡ɕ ɐ b ʊ t̪ː ɪ ɾ ɐ n
இராசி	ɪ ɾ aː t͡ɕ ɪ
இராச்சியம்	ɪ ɾ aː t͡ɕː ɪ j ɐ m
இராஜாளி	ɪ ɾ aː d͡ʑ aː ɭ ɪ
இராத்திரி	ɪ ɾ aː t̪ː ɪ ɾ ɪ
இராமச்சந்திரன்	ɪ ɾ aː m ɐ t͡ɕː ɐ n̪ d̪ ɪ ɾ ɐ n
இராமநாதபுரம்	ɪ ɾ aː m ɐ n̪ aː d̪ ɐ b ʊ ɾ ɐ m
இராமன்	ɪ ɾ aː m ɐ n
இராமமுழியன்	ɪ ɾ aː m ɐ m ʊ ɻ ɪ j ɐ n
இராமர்	ɪ ɾ aː m ɐ ɾ
இராமானுசன்	ɪ ɾ aː m aː n ʊ t͡ɕ ɐ n
இராமாயணம்	ɪ ɾ aː m aː j ɐ ɳ ɐ m
இரு	ɪ ɾ ʊ
இருக்கை	ɪ ɾ ʊ kː ɐ ɪ̯
இருட்டு	ɪ ɾ ʊ ʈː ʊ
இருதயம்	ɪ ɾ ʊ d̪ ɐ j ɐ m
இருநூறு	ɪ ɾ ʊ n̪ uː r ʊ
இருந்து	ɪ ɾ ʊ n̪ d̪ ʊ
இருபது	ɪ ɾ ʊ b ɐ d̪ ʊ
இருபாலீர்ப்பு	i ɾ u p aː l iː ɾ pː u
இருபால்சேர்க்கை	i ɾ u p aː l t͡ɕ eː ɾ kː a ɪ̯
இருபிறப்பாளன்	ɪ ɾ ʊ b ɪ r ɐ pː aː ɭ ɐ n
இருப்பன	ɪ ɾ ʊ pː ɐ n ɐ
இருப்பிடம்	ɪ ɾ ʊ pː ɪ ɖ ɐ m
இருப்பு	ɪ ɾ ʊ pː ʊ
இருப்புப்பாதை	ɪ ɾ ʊ pː ʊ pː aː d̪ ɐ ɪ̯
இருப்பை	ɪ ɾ ʊ pː ɐ ɪ̯
இருமல்	ɪ ɾ ʊ m ɐ l
இருமு	ɪ ɾ ʊ m ʊ
இருமை	ɪ ɾ ʊ m ɐ ɪ̯
இருமையின்மை	ɪ ɾ ʊ m ɐ ɪ̯ j ɪ n m ɐ ɪ̯
இரும்பு	ɪ ɾ ʊ m b ʊ
இருளா	ɪ ɾ ʊ ɭ aː
இருளுவா	ɪ ɾ ʊ ɭ ʊ ʋ aː
இருளை	ɪ ɾ ʊ ɭ ɐ ɪ̯
இருள்	ɪ ɾ ʊ ɭ
இரேவதி	ɪ ɾ eː ʋ ɐ d̪ ɪ
இரேவற்சின்னி	ɪ ɾ eː ʋ ɐ r t͡ɕ ɪ nː ɪ
இரை	ɪ ɾ ɐ ɪ̯
இரைச்சல்	ɪ ɾ ɐ ɪ̯ t͡ɕː ɐ l
இரைப்பை	ɪ ɾ ɐ ɪ̯ pː ɐ ɪ̯
இற	ɪ r ɐ
இறகர்	ɪ r ɐ ɡ ɐ ɾ
இறகு	ɪ r ɐ ɡ ʊ
இறக்கு	ɪ r ɐ kː ʊ
இறக்கை	ɪ r ɐ kː ɐ ɪ̯
இறங்கு	ɪ r ɐ ŋ ɡ ʊ
இறப்பு	ɪ r ɐ pː ʊ
இறால்	ɪ r aː l
இறுகு	ɪ r ʊ ɡ ʊ
இறுக்கு	ɪ r ʊ kː ʊ
இறுதி	ɪ r ʊ d̪ ɪ
இறுமாப்பு	ɪ r ʊ m aː pː ʊ
இறை	ɪ r ɐ ɪ̯
இறைச்சி	ɪ r ɐ ɪ̯ t͡ɕː ɪ
இறையியல்	ɪ r ɐ ɪ̯ j ɪ j ɐ l
இறைவன்	ɪ r ɐ ɪ̯ ʋ ɐ n
இறைவாக்கினர்	ɪ r ɐ ɪ̯ ʋ aː kː ɪ n ɐ ɾ
இறைவாக்கு	ɪ r ɐ ɪ̯ ʋ aː kː ʊ
இறைவி	ɪ r ɐ ɪ̯ ʋ ɪ
இலகு	ɪ l ɐ ɡ ʊ
இலக்கணம்	ɪ l ɐ kː ɐ ɳ ɐ m
இலக்கம்	ɪ l ɐ kː ɐ m
இலக்கிய	ɪ l ɐ kː ɪ j ɐ
இலக்கியம்	ɪ l ɐ kː ɪ j ɐ m
இலக்கு	ɪ l ɐ kː ʊ
இலக்குமி	ɪ l ɐ kː ʊ m ɪ
இலங்கை	ɪ l ɐ ŋ ɡ ɐ ɪ̯
இலட்சத்தீவுகள்	ɪ l ɐ ʈ t͡ɕ ɐ t̪ː iː ʋ ʊ ɡ ɐ ɭ
இலட்சம்	ɪ l ɐ ʈ t͡ɕ ɐ m
இலட்சுமணன்	ɪ l ɐ ʈ t͡ɕ ʊ m ɐ ɳ ɐ n
இலண்டன்	ɪ l ɐ ɳ ɖ ɐ n
இலத்தீன்	ɪ l ɐ t̪ː iː n
இலம்பகம்	ɪ l ɐ m b ɐ ɡ ɐ m
இலயம்	ɪ l ɐ j ɐ m
இலயை	ɪ l ɐ j ɐ ɪ̯
இலவசம்	ɪ l ɐ ʋ ɐ t͡ɕ ɐ m
இலாபம்	ɪ l aː b ɐ m
இலுமு	ɪ l ʊ m ʊ
இலை	ɪ l ɐ ɪ̯
இலைக்கறி	ɪ l ɐ ɪ̯ kː ɐ r ɪ
இலையுதிர்	ɪ l ɐ ɪ̯ j ʊ d̪ ɪ ɾ
இல்	ɪ l
இல்லகம்	ɪ l l ɐ ɡ ɐ m
இல்லக்கிழத்தி	ɪ l l ɐ kː ɪ ɻ ɐ t̪ː ɪ
இல்லத்தரசி	ɪ l l ɐ t̪ː ɐ ɾ ɐ t͡ɕ ɪ
இல்லம்	ɪ l l ɐ m
இல்லறம்	ɪ l l ɐ r ɐ m
இல்லாக்காட்டில்	ɪ l l aː kː aː ʈː ɪ l
இல்லாள்	ɪ l l aː ɭ
இல்லிடம்	ɪ l l ɪ ɖ ɐ m
இல்லை	ɪ l l ɐ ɪ̯
இள	ɪ ɭ ɐ
இளங்காய்	ɪ ɭ ɐ ŋ ɡ aː j
இளங்கோ	ɪ ɭ ɐ ŋ ɡ oː
இளஞ்சி	ɪ ɭ ɐ ɲ d͡ʑ ɪ
இளஞ்சிவப்பு	ɪ ɭ ɐ ɲ d͡ʑ ɪ ʋ ɐ pː ʊ
இளநீர்	ɪ ɭ ɐ n̪ iː ɾ
இளநீலம்	ɪ ɭ ɐ n̪ iː l ɐ m
இளந்தாரி	ɪ ɭ ɐ n̪ d̪ aː ɾ ɪ
இளமை	ɪ ɭ ɐ m ɐ ɪ̯
இளம்	ɪ ɭ ɐ m
இளம்பிறை	ɪ ɭ ɐ m b ɪ r ɐ ɪ̯
இளம்பிள்ளைவாதம்	ɪ ɭ ɐ m b ɪ ɭː ɐ ɪ̯ ʋ aː d̪ ɐ m
இளவேனில்	ɪ ɭ ɐ ʋ eː n ɪ l
இளைஞன்	ɪ ɭ ɐ ɪ̯ ɲ ɐ n
இளைப்பாறு	ɪ ɭ ɐ ɪ̯ pː aː r ʊ
இளைப்பாறுதல்	ɪ ɭ ɐ ɪ̯ pː aː r ʊ d̪ ɐ l
இளைப்பாற்று	ɪ ɭ ɐ ɪ̯ pː aː rː ʊ
இளைப்பு	ɪ ɭ ɐ ɪ̯ pː ʊ
இழ	ɪ ɻ ɐ
இழப்பீடு	ɪ ɻ ɐ pː iː ɖ ʊ
இழப்பு	ɪ ɻ ɐ pː ʊ
இழவு	ɪ ɻ ɐ ʋ ʊ
இழவுகொண்டாடு	ɪ ɻ ɐ ʋ ʊ ɡ ɔ ɳ ɖ aː ɖ ʊ
இழி	ɪ ɻ ɪ
இழிகை	ɪ ɻ ɪ ɡ ɐ ɪ̯
இழிசு	ɪ ɻ ɪ t͡ɕ ʊ
இழிதகவு	ɪ ɻ ɪ d̪ ɐ ɡ ɐ ʋ ʊ
இழிப்பு	ɪ ɻ ɪ pː ʊ
இழிவு	ɪ ɻ ɪ ʋ ʊ
இழு	ɪ ɻ ʊ
இழுகு	ɪ ɻ ʊ ɡ ʊ
இழுக்கம்	ɪ ɻ ʊ kː ɐ m
இழுக்கு	ɪ ɻ ʊ kː ʊ
இழுது	ɪ ɻ ʊ d̪ ʊ
இழுதை	ɪ ɻ ʊ d̪ ɐ ɪ̯
இழுப்பறை	ɪ ɻ ʊ pː ɐ r ɐ ɪ̯
இழை	ɪ ɻ ɐ ɪ̯
இவன்	ɪ ʋ ɐ n
இவர்	ɪ ʋ ɐ ɾ
இவர்கள்	ɪ ʋ ɐ ɾ ɡ ɐ ɭ
இவள்	ɪ ʋ ɐ ɭ
இவை	ɪ ʋ ɐ ɪ̯
இஷ்டம்	ɪ ʂ ʈ ɐ m
இஸ்லாமாபாத்	ɪ s l aː m aː b aː d̪
ஈ	iː
ஈகை	iː ɡ ɐ ɪ̯
ஈசன்	iː t͡ɕ ɐ n
ஈசல்	iː t͡ɕ ɐ l
ஈசல்கொட்டு	iː t͡ɕ ɐ l ɡ ɔ ʈː ʊ
ஈசுவரன்	iː t͡ɕ ʊ ʋ ɐ ɾ ɐ n
ஈச்சு	iː t͡ɕː ʊ
ஈடு	iː ɖ ʊ
ஈடேறு	iː ɖ eː r ʊ
ஈட்டி	iː ʈː ɪ
ஈட்டு	iː ʈː ʊ
ஈந்து	iː n̪ d̪ ʊ
ஈனம்	iː n ɐ m
ஈனில்	iː n ɪ l
ஈமம்	iː m ɐ m
ஈமான்	iː m aː n
ஈயம்	iː j ɐ m
ஈரமான	iː ɾ ɐ m aː n ɐ
ஈரம்	iː ɾ ɐ m
ஈரர்	iː ɾ ɐ ɾ
ஈரல்	iː ɾ ɐ l
ஈரோடு	iː ɾ oː ɖ ʊ
ஈர்ப்பு	iː ɾ pː ʊ
ஈறு	iː r ʊ
ஈற்றயல்	iː rː ɐ j ɐ l
ஈளை	iː ɭ ɐ ɪ̯
ஈழம்	iː ɻ ɐ m
உ	ʊ
உஃப	ʊ f aː
உஃப	ʊ f ɐ
உகளம்	ʊ ɡ ɐ ɭ ɐ m
உகவர்	ʊ ɡ ɐ ʋ ɐ ɾ
உகிர்	ʊ ɡ ɪ ɾ
உக்கம்பருத்தி	ʊ kː ɐ m b ɐ ɾ ʊ t̪ː ɪ
உசுபெக்கிசுத்தான்	ʊ t͡ɕ ʊ b ɛ kː ɪ t͡ɕ ʊ t̪ː aː n
உச்சரிப்பு	ʊ t͡ɕː ɐ ɾ ɪ pː ʊ
உச்சவம்	ʊ t͡ɕː ɐ ʋ ɐ m
உச்சி	ʊ t͡ɕː ɪ
உடனடியாக	ʊ ɖ ɐ n ɐ ɖ ɪ j aː ɡ ɐ
உடனே	ʊ ɖ ɐ n eː
உடன்	ʊ ɖ ɐ n
உடம்பு	ʊ ɖ ɐ m b ʊ
உடலிலான்	ʊ ɖ ɐ l ɪ l aː n
உடலுறவு	ʊ ɖ ɐ l ʊ r ɐ ʋ ʊ
உடல்	ʊ ɖ ɐ l
உடுக்குறி	ʊ ɖ ʊ kː ʊ r ɪ
உடுக்கை	ʊ ɖ ʊ kː ɐ ɪ̯
உடுப்பு	ʊ ɖ ʊ pː ʊ
உடை	ʊ ɖ ɐ ɪ̯
உடைமை	ʊ ɖ ɐ ɪ̯ m ɐ ɪ̯
உடையவன்	ʊ ɖ ɐ ɪ̯ j ɐ ʋ ɐ n
உட்கருத்து	ʊ ʈ k ɐ ɾ ʊ t̪ː ʊ
உட்கார்	ʊ ʈ k aː ɾ
உட்கோட்டை	ʊ ʈ k oː ʈː ɐ ɪ̯
உட்டொளை	ʊ ʈː ɔ ɭ ɐ ɪ̯
உட்பொருள்	ʊ ʈ p ɔ ɾ ʊ ɭ
உணர்	ʊ ɳ ɐ ɾ
உணர்ச்சி	ʊ ɳ ɐ ɾ t͡ɕː ɪ
உணர்த்தி	ʊ ɳ ɐ ɾ t̪ː ɪ
உணர்ப்பு	ʊ ɳ ɐ ɾ pː ʊ
உணர்வு	ʊ ɳ ɐ ɾ ʋ ʊ
உணவகம்	ʊ ɳ ɐ ʋ ɐ ɡ ɐ m
உணவு	ʊ ɳ ɐ ʋ ʊ
உண்	ʊ ɳ
உண்டா	ʊ ɳ ɖ aː
உண்டாக	ʊ ɳ ɖ aː ɡ ɐ
உண்டாக்கு	ʊ ɳ ɖ aː kː ʊ
உண்டியல்	ʊ ɳ ɖ ɪ j ɐ l
உண்டுபடு	ʊ ɳ ɖ ʊ b ɐ ɖ ʊ
உண்டுபடுத்து	ʊ ɳ ɖ ʊ b ɐ ɖ ʊ t̪ː ʊ
உண்டுபண்ணிவை	ʊ ɳ ɖ ʊ b ɐ ɳː ɪ ʋ ɐ ɪ̯
உண்டுபண்ணு	ʊ ɳ ɖ ʊ b ɐ ɳː ʊ
உண்டை	ʊ ɳ ɖ ɐ ɪ̯
உண்ணாட்டம்	ʊ ɳː aː ʈː ɐ m
உண்ணி	ʊ ɳː ɪ
உண்ணிக்கொக்கு	ʊ ɳː ɪ kː ɔ kː ʊ
உண்ணீர்	ʊ ɳː iː ɾ
உண்ணோக்கல்	ʊ ɳː oː kː ɐ l
உண்மை	ʊ ɳ m ɐ ɪ̯
உதகஞ்செய்	ʊ d̪ ɐ ɡ ɐ ɲ d͡ʑ ɛ j
உதகதாரைசெய்	ʊ d̪ ɐ ɡ ɐ d̪ aː ɾ ɐ ɪ̯ t͡ɕ ɛ j
உதகமண்டலம்	ʊ d̪ ɐ ɡ ɐ m ɐ ɳ ɖ ɐ l ɐ m
உதகமுய்	ʊ d̪ ɐ ɡ ɐ m ʊ j
உதகம்	ʊ d̪ ɐ ɡ ɐ m
உதகம்பண்ணு	ʊ d̪ ɐ ɡ ɐ m b ɐ ɳː ʊ
உதகை	ʊ d̪ ɐ ɡ ɐ ɪ̯
உதடு	ʊ d̪ ɐ ɖ ʊ
உதறு	ʊ d̪ ɐ r ʊ
உதள்	ʊ d̪ ɐ ɭ
உதவி	ʊ d̪ ɐ ʋ ɪ
உதவு	ʊ d̪ ɐ ʋ ʊ
உதாரணம்	ʊ d̪ aː ɾ ɐ ɳ ɐ m
உதாரத்துவம்	ʊ d̪ aː ɾ ɐ t̪ː ʊ ʋ ɐ m
உதிரம்	ʊ d̪ ɪ ɾ ɐ m
உதிரவேங்கை	ʊ d̪ ɪ ɾ ɐ ʋ eː ŋ ɡ ɐ ɪ̯
உதிர்	ʊ d̪ ɪ ɾ
உது	ʊ d̪ ʊ
உதை	ʊ d̪ ɐ ɪ̯
உத்தரம்	ʊ t̪ː ɐ ɾ ɐ m
உத்தரவு	ʊ t̪ː ɐ ɾ ɐ ʋ ʊ
உத்தராகண்டம்	ʊ t̪ː ɐ ɾ aː ɡ ɐ ɳ ɖ ɐ m
உத்தரி	ʊ t̪ː ɐ ɾ ɪ
உத்தரீயம்	ʊ t̪ː ɐ ɾ iː j ɐ m
உந்த	ʊ n̪ d̪ ɐ
உந்தி	ʊ n̪ d̪ ɪ
உந்திபூத்தோன்	ʊ n̪ d̪ ɪ b uː t̪ː oː n
உன்	ʊ n
உன்னதபாட்டு	u nː ɐ d̪ ɐ p aː ʈː u
உன்னதம்	ʊ nː ɐ d̪ ɐ m
உன்னம்	ʊ nː ɐ m
உன்னல்	ʊ nː ɐ l
உன்னு	ʊ nː ʊ
உபகாரம்	ʊ b ɐ ɡ aː ɾ ɐ m
உபத்திரவம்	ʊ b ɐ t̪ː ɪ ɾ ɐ ʋ ɐ m
உபநிடதம்	ʊ b ɐ n̪ ɪ ɖ ɐ d̪ ɐ m
உபயோகம்	ʊ b ɐ j oː ɡ ɐ m
உபயோகி	ʊ b ɐ j oː ɡ ɪ
உபவாசம்	ʊ b ɐ ʋ aː t͡ɕ ɐ m
உபாயம்	ʊ b aː j ɐ m
உபோதம்	ʊ b oː d̪ ɐ m
உப்பளம்	ʊ pː ɐ ɭ ɐ m
உப்பு	ʊ b b ʊ
உப்பு	ʊ pː ʊ
உப்புமா	ʊ pː ʊ m aː
உப்புவாயு	ʊ pː ʊ ʋ aː j ʊ
உமரி	ʊ m ɐ ɾ ɪ
உம்	ʊ m
உம்மைக்குறி	ʊ mː ɐ ɪ̯ kː ʊ r ɪ
உயரமான	ʊ j ɐ ɾ ɐ m aː n ɐ
உயரம்	ʊ j ɐ ɾ ɐ m
உயர்	ʊ j ɐ ɾ
உயர்ச்சி	ʊ j ɐ ɾ t͡ɕː ɪ
உயர்திணை	ʊ j ɐ ɾ d̪ ɪ ɳ ɐ ɪ̯
உயர்பு	ʊ j ɐ ɾ b ʊ
உயர்வு	ʊ j ɐ ɾ ʋ ʊ
உயிரணு	ʊ j ɪ ɾ ɐ ɳ ʊ
உயிரியல்	ʊ j ɪ ɾ ɪ j ɐ l
உயிரிழப்பு	ʊ j ɪ ɾ ɪ ɻ ɐ pː ʊ
உயிரெழுத்து	ʊ j ɪ ɾ ɛ ɻ ʊ t̪ː ʊ
உயிர்	ʊ j ɪ ɾ
உயிர்த்தெழு	ʊ j ɪ ɾ t̪ː ɛ ɻ ʊ
உயிர்ப்பு	ʊ j ɪ ɾ pː ʊ
உயிர்ப்புனல்	ʊ j ɪ ɾ pː ʊ n ɐ l
உயிர்மெய்யெழுத்து	ʊ j ɪ ɾ m ɛ jː ɛ ɻ ʊ t̪ː ʊ
உயிர்வளி	ʊ j ɪ ɾ ʋ ɐ ɭ ɪ
உயிர்வாழ்	ʊ j ɪ ɾ ʋ aː ɻ
உயிர்வேதியியல்	ʊ j ɪ ɾ ʋ eː d̪ ɪ j ɪ j ɐ l
உய்	ʊ j
உய்கை	ʊ j ɡ ɐ ɪ̯
உரங்காட்டு	ʊ ɾ ɐ ŋ ɡ aː ʈː ʊ
உரங்குத்து	ʊ ɾ ɐ ŋ ɡ ʊ t̪ː ʊ
உரி	ʊ ɾ ɪ
உரிமை	ʊ ɾ ɪ m ɐ ɪ̯
உரிமைக்கடன்	ʊ ɾ ɪ m ɐ ɪ̯ kː ɐ ɖ ɐ n
உரிய	ʊ ɾ ɪ j ɐ
உரு	ʊ ɾ ʊ
உருகு	ʊ ɾ ʊ ɡ ʊ
உருக்கம்	ʊ ɾ ʊ kː ɐ m
உருக்கு	ʊ ɾ ʊ kː ʊ
உருசியா	ʊ ɾ ʊ t͡ɕ ɪ j aː
உருட்டு	ʊ ɾ ʊ ʈː ʊ
உருண்ட	ʊ ɾ ʊ ɳ ɖ ɐ
உருது	ʊ ɾ ʊ d̪ ʊ
உருத்திரன்	ʊ ɾ ʊ t̪ː ɪ ɾ ɐ n
உருப்பம்	ʊ ɾ ʊ pː ɐ m
உருப்பு	ʊ ɾ ʊ pː ʊ
உருமேறு	ʊ ɾ ʊ m eː r ʊ
உரும்	ʊ ɾ ʊ m
உருளைக்கிழங்கு	ʊ ɾ ʊ ɭ ɐ ɪ̯ kː ɪ ɻ ɐ ŋ ɡ ʊ
உருள்	ʊ ɾ ʊ ɭ
உருவம்	ʊ ɾ ʊ ʋ ɐ m
உருவாக்கம்	ʊ ɾ ʊ ʋ aː kː ɐ m
உரை	ʊ ɾ ɐ ɪ̯
உரோகிணி	ʊ ɾ oː ɡ ɪ ɳ ɪ
உரோமம்	ʊ ɾ oː m ɐ m
உரோம்	ʊ ɾ oː m
உறக்கம்	ʊ r ɐ kː ɐ m
உறங்கு	ʊ r ɐ ŋ ɡ ʊ
உறப்பு	ʊ r ɐ pː ʊ
உறல்	ʊ r ɐ l
உறழ்	ʊ r ɐ ɻ
உறழ்ச்சி	ʊ r ɐ ɻ t͡ɕː ɪ
உறழ்வு	ʊ r ɐ ɻ ʋ ʊ
உறவினர்	ʊ r ɐ ʋ ɪ n ɐ ɾ
உறவு	ʊ r ɐ ʋ ʊ
உறி	ʊ r ɪ
உறிஞ்சி	ʊ r ɪ ɲ d͡ʑ ɪ
உறிஞ்சு	ʊ r ɪ ɲ d͡ʑ ʊ
உறு	ʊ r ʊ
உறுகண்	ʊ r ʊ ɡ ɐ ɳ
உறுகோள்	ʊ r ʊ ɡ oː ɭ
உறுதி	ʊ r ʊ d̪ ɪ
உறுதிக்கட்டுரை	ʊ r ʊ d̪ ɪ kː ɐ ʈː ʊ ɾ ɐ ɪ̯
உறுதிபூசுதல்	ʊ r ʊ d̪ ɪ b uː t͡ɕ ʊ d̪ ɐ l
உறுதிப்படுத்து	ʊ r ʊ d̪ ɪ pː ɐ ɖ ʊ t̪ː ʊ
உறுதிப்பாடு	ʊ r ʊ d̪ ɪ pː aː ɖ ʊ
உறுதிமொழி	ʊ r ʊ d̪ ɪ m ɔ ɻ ɪ
உறுத்து	ʊ r ʊ t̪ː ʊ
உறுப்பிசைக்குறி	ʊ r ʊ pː ɪ t͡ɕ ɐ ɪ̯ kː ʊ r ɪ
உறுப்பினர்	ʊ r ʊ pː ɪ n ɐ ɾ
உறுப்பு	ʊ r ʊ pː ʊ
உறுமு	ʊ r ʊ m ʊ
உறை	ʊ r ɐ ɪ̯
உறையுள்	ʊ r ɐ ɪ̯ j ʊ ɭ
உறைவிடம்	ʊ r ɐ ɪ̯ ʋ ɪ ɖ ɐ m
உற்சவம்	ʊ r t͡ɕ ɐ ʋ ɐ m
உற்சாகம்	ʊ r t͡ɕ aː ɡ ɐ m
உலகம்	ʊ l ɐ ɡ ɐ m
உலகு	ʊ l ɐ ɡ ʊ
உலங்கு	ʊ l ɐ ŋ ɡ ʊ
உலர்ச்சி	ʊ l ɐ ɾ t͡ɕː ɪ
உலர்ந்தம்	ʊ l ɐ ɾ n̪ d̪ ɐ m
உலாவி	ʊ l aː ʋ ɪ
உலுவம்	ʊ l ʊ ʋ ɐ m
உலை	ʊ l ɐ ɪ̯
உலோகம்	ʊ l oː ɡ ɐ m
உலோபம்	ʊ l oː b ɐ m
உளறல்	ʊ ɭ ɐ r ɐ l
உளறு	ʊ ɭ ɐ r ʊ
உளவாளி	ʊ ɭ ɐ ʋ aː ɭ ɪ
உளவியல்	ʊ ɭ ɐ ʋ ɪ j ɐ l
உளவு	ʊ ɭ ɐ ʋ ʊ
உளி	ʊ ɭ ɪ
உளியம்	ʊ ɭ ɪ j ɐ m
உளுந்து	ʊ ɭ ʊ n̪ d̪ ʊ
உள்	ʊ ɭ
உள்ள	ʊ ɭː ɐ
உள்ளங்கை	ʊ ɭː ɐ ŋ ɡ ɐ ɪ̯
உள்ளது	ʊ ɭː ɐ d̪ ʊ
உள்ளம்	ʊ ɭː ɐ m
உள்ளா	ʊ ɭː aː
உள்ளாடை	ʊ ɭː aː ɖ ɐ ɪ̯
உள்ளாடைகள்	ʊ ɭː aː ɖ ɐ ɪ̯ ɡ ɐ ɭ
உள்ளாலை	ʊ ɭː aː l ɐ ɪ̯
உள்ளி	ʊ ɭː ɪ
உள்ளிடு	ʊ ɭː ɪ ɖ ʊ
உள்ளுணர்வு	ʊ ɭː ʊ ɳ ɐ ɾ ʋ ʊ
உள்ளுறை	ʊ ɭː ʊ r ɐ ɪ̯
உழவன்	ʊ ɻ ɐ ʋ ɐ n
உழவர்	ʊ ɻ ɐ ʋ ɐ ɾ
உழவு	ʊ ɻ ɐ ʋ ʊ
உழவுகாடு	ʊ ɻ ɐ ʋ ʊ ɡ aː ɖ ʊ
உழவுசால்	ʊ ɻ ɐ ʋ ʊ t͡ɕ aː l
உழி	ʊ ɻ ɪ
உழிஞை	ʊ ɻ ɪ ɲ ɐ ɪ̯
உழு	ʊ ɻ ʊ
உழுந்து	ʊ ɻ ʊ n̪ d̪ ʊ
உழை	ʊ ɻ ɐ ɪ̯
உழைப்பாளி	ʊ ɻ ɐ ɪ̯ pː aː ɭ ɪ
உழைப்பு	ʊ ɻ ɐ ɪ̯ pː ʊ
உவன்	ʊ ʋ ɐ n
உவமை	ʊ ʋ ɐ m ɐ ɪ̯
உவர்	ʊ ʋ ɐ ɾ
உவர்மம்	ʊ ʋ ɐ ɾ m ɐ m
உவள்	ʊ ʋ ɐ ɭ
உவா	ʊ ʋ aː
உஷ்ணம்	ʊ ʂ ɳ ɐ m
ஊ	uː
ஊக்கம்	uː kː ɐ m
ஊசி	uː t͡ɕ ɪ
ஊஞ்சல்	uː ɲ d͡ʑ ɐ l
ஊடகம்	uː ɖ ɐ ɡ ɐ m
ஊடுகதிர்	uː ɖ ʊ ɡ ɐ d̪ ɪ ɾ
ஊடுதாக்கு	uː ɖ ʊ d̪ aː kː ʊ
ஊடுருவு	uː ɖ ʊ ɾ ʊ ʋ ʊ
ஊட்டச்சத்து	uː ʈː ɐ t͡ɕː ɐ t̪ː ʊ
ஊட்டம்	uː ʈː ɐ m
ஊட்டி	uː ʈː ɪ
ஊட்டு	uː ʈː ʊ
ஊண்	uː ɳ
ஊதற்காற்று	uː d̪ ɐ r k aː rː ʊ
ஊதா	uː d̪ aː
ஊதியம்	uː d̪ ɪ j ɐ m
ஊது	uː d̪ ʊ
ஊதைக்காற்று	uː d̪ ɐ ɪ̯ kː aː rː ʊ
ஊத்தப்பம்	uː t̪ː ɐ pː ɐ m
ஊனம்	uː n ɐ m
ஊனுண்ணி	uː n ʊ ɳː ɪ
ஊன்	uː n
ஊரடங்கு	uː ɾ ɐ ɖ ɐ ŋ ɡ ʊ
ஊரல்	uː ɾ ɐ l
ஊரு	uː ɾ ʊ
ஊர்	uː ɾ
ஊர்காவல்	uː ɾ ɡ aː ʋ ɐ l
ஊர்க்கதை	uː ɾ kː ɐ d̪ ɐ ɪ̯
ஊர்தி	uː ɾ d̪ ɪ
ஊர்த்தலைமை	uː ɾ t̪ː ɐ l ɐ ɪ̯ m ɐ ɪ̯
ஊர்வன	uː ɾ ʋ ɐ n ɐ
ஊர்வலம்	uː ɾ ʋ ɐ l ɐ m
ஊறு	uː r ʊ
ஊறுகாய்	uː r ʊ ɡ aː j
ஊற்றம்	uː rː ɐ m
ஊற்றால்	uː rː aː l
ஊற்று	uː rː ʊ
ஊற்றுத்துலை	uː rː ʊ t̪ː ʊ l ɐ ɪ̯
ஊழல்	uː ɻ ɐ l
ஊழி	uː ɻ ɪ
ஊழிநாள்	uː ɻ ɪ n̪ aː ɭ
ஊழியன்	uː ɻ ɪ j ɐ n
ஊழியம்	uː ɻ ɪ j ɐ m
ஊழ்	uː ɻ
ஊழ்வினை	uː ɻ ʋ ɪ n ɐ ɪ̯
ஊவா	uː ʋ aː
எ	ɛ
எஃகு	ɛ x ʊ
எகின்	ɛ ɡ ɪ n
எகிப்து	ɛ ɡ ɪ p t̪ ʊ
எக்கச்சக்கம்	ɛ kː ɐ t͡ɕː ɐ kː ɐ m
எக்கர்	ɛ kː ɐ ɾ
எக்காளம்	ɛ kː aː ɭ ɐ m
எங்கண்	ɛ ŋ ɡ ɐ ɳ
எங்கள்	ɛ ŋ ɡ ɐ ɭ
எங்கித்தை	ɛ ŋ ɡ ɪ t̪ː ɐ ɪ̯
எங்கு	ɛ ŋ ɡ ʊ
எங்கும்	ɛ ŋ ɡ ʊ m
எங்கே	ɛ ŋ ɡ eː
எசுத்தோனியா	ɛ t͡ɕ ʊ t̪ː oː n ɪ j aː
எசேக்கியல்	ɛ t͡ɕ eː kː ɪ j ɐ l
எச்சம்	ɛ t͡ɕː ɐ m
எச்சில்	ɛ t͡ɕː ɪ l
எஜமான்	ɛ d͡ʑ ɐ m aː n
எடு	ɛ ɖ ʊ
எடுக்கல்	ɛ ɖ ʊ kː ɐ l
எடுத்துக்காட்டு	ɛ ɖ ʊ t̪ː ʊ kː aː ʈː ʊ
எட்டப்பார்வை	ɛ ʈː ɐ pː aː ɾ ʋ ɐ ɪ̯
எட்டு	ɛ ʈː ʊ
எட்டுத்தொகை	ɛ ʈː ʊ t̪ː ɔ ɡ ɐ ɪ̯
எண்	ɛ ɳ
எண்கள்	ɛ ɳ ɡ ɐ ɭ
எண்கு	ɛ ɳ ɡ ʊ
எண்ணக்கரு	ɛ ɳː ɐ kː ɐ ɾ ʊ
எண்ணங்கள்	ɛ ɳː ɐ ŋ ɡ ɐ ɭ
எண்ணம்	ɛ ɳː ɐ m
எண்ணிக்கை	ɛ ɳː ɪ kː ɐ ɪ̯
எண்ணு	ɛ ɳː ʊ
எண்ணூறு	ɛ ɳː uː r ʊ
எண்ணெய்	ɛ ɳː ɛ j
எண்ணை	ɛ ɳː ɐ ɪ̯
எண்பது	ɛ ɳ b ɐ d̪ ʊ
எதி	ɛ d̪ ɪ
எதிராளி	ɛ d̪ ɪ ɾ aː ɭ ɪ
எதிரி	ɛ d̪ ɪ ɾ ɪ
எதிரொலி	ɛ d̪ ɪ ɾ ɔ l ɪ
எதிர்	ɛ d̪ ɪ ɾ
எதிர்ச்சி	ɛ d̪ ɪ ɾ t͡ɕː ɪ
எதிர்பார்	ɛ d̪ ɪ ɾ b aː ɾ
எதிர்பாலீர்ப்பு	ɛ d̪ ɪ ɾ b aː l iː ɾ pː ʊ
எதிர்பால்சேர்க்கை	ɛ d̪ ɪ ɾ b aː l t͡ɕ eː ɾ kː ɐ ɪ̯
எதிர்வெட்டு	ɛ d̪ ɪ ɾ ʋ ɛ ʈː ʊ
எது	ɛ d̪ ʊ
எதுக்கு	ɛ d̪ ʊ kː ʊ
எதோள்	ɛ d̪ oː ɭ
எத்தனம்	ɛ t̪ː ɐ n ɐ m
எத்தனை	ɛ t̪ː ɐ n ɐ ɪ̯
எத்தனையாவது	ɛ t̪ː ɐ n ɐ ɪ̯ j aː ʋ ɐ d̪ ʊ
எத்தி	ɛ t̪ː ɪ
எத்து	ɛ t̪ː ʊ
எத்துணை	ɛ t̪ː ʊ ɳ ɐ ɪ̯
எத்துணையும்	ɛ t̪ː ʊ ɳ ɐ ɪ̯ j ʊ m
எத்தும்	ɛ t̪ː ʊ m
எந்த	ɛ n̪ d̪ ɐ
எந்திரங்கள்	ɛ n̪ d̪ ɪ ɾ ɐ ŋ ɡ ɐ ɭ
எந்திரம்	ɛ n̪ d̪ ɪ ɾ ɐ m
எந்து	ɛ n̪ d̪ ʊ
எந்தை	ɛ n̪ d̪ ɐ ɪ̯
எனினும்	ɛ n ɪ n ʊ m
எனைத்தும்	ɛ n ɐ ɪ̯ t̪ː ʊ m
எனைவர்	ɛ n ɐ ɪ̯ ʋ ɐ ɾ
என்	ɛ n
என்கை	ɛ n ɡ ɐ ɪ̯
என்ன	ɛ nː ɐ
என்னணம்	ɛ nː ɐ ɳ ɐ m
என்னது	ɛ nː ɐ d̪ ʊ
என்னதும்	ɛ nː ɐ d̪ ʊ m
என்னர்	ɛ nː ɐ ɾ
என்னவன்	ɛ nː ɐ ʋ ɐ n
என்னுங்காட்டில்	ɛ nː ʊ ŋ ɡ aː ʈː ɪ l
என்னுடைய	ɛ nː ʊ ɖ ɐ ɪ̯ j ɐ
என்னும்	ɛ nː ʊ m
என்னென்ன	ɛ nː ɛ nː ɐ
என்னோரும்	ɛ nː oː ɾ ʊ m
என்பான்	ɛ n b aː n
என்பு	ɛ n b ʊ
என்றவன்	ɛ n r ɐ ʋ ɐ n
என்றால்	ɛ n r aː l
என்றிய	ɛ n r ɪ j ɐ
என்று	ɛ n r ʊ
என்றைக்கும்	ɛ n r ɐ ɪ̯ kː ʊ m
எபிரேயம்	ɛ b ɪ ɾ eː j ɐ m
எப்படி	ɛ pː ɐ ɖ ɪ
எப்பேர்ப்பட்ட	ɛ pː eː ɾ pː ɐ ʈː ɐ
எப்பொழுது	ɛ pː ɔ ɻ ʊ d̪ ʊ
எப்பொழுதும்	ɛ pː ɔ ɻ ʊ d̪ ʊ m
எமன்	ɛ m ɐ n
எம்	ɛ m
எம்டன்	ɛ m ʈ ɐ n
எம்மை	ɛ mː ɐ ɪ̯
எய்	ɛ j
எரி	ɛ ɾ ɪ
எரிமலை	ɛ ɾ ɪ m ɐ l ɐ ɪ̯
எருசலேம்	ɛ ɾ ʊ t͡ɕ ɐ l eː m
எருது	ɛ ɾ ʊ d̪ ʊ
எருமை	ɛ ɾ ʊ m ɐ ɪ̯
எரேமியா	ɛ ɾ eː m ɪ j aː
எர்ணாகுளம்	ɛ ɾ ɳ aː ɡ ʊ ɭ ɐ m
எறி	ɛ r ɪ
எறும்பி	ɛ r ʊ m b ɪ
எறும்பு	ɛ r ʊ m b ʊ
எறுழ்	ɛ r ʊ ɻ
எற்பாடு	ɛ r p aː ɖ ʊ
எற்றை	ɛ rː ɐ ɪ̯
எற்றைக்கும்	ɛ rː ɐ ɪ̯ kː ʊ m
எலி	ɛ l ɪ
எலுமிச்சை	ɛ l ʊ m ɪ t͡ɕː ɐ ɪ̯
எலும்பு	ɛ l ʊ m b ʊ
எல்லாரும்	ɛ l l aː ɾ ʊ m
எல்லை	ɛ l l ɐ ɪ̯
எளிது	ɛ ɭ ɪ d̪ ʊ
எளிமை	ɛ ɭ ɪ m ɐ ɪ̯
எள்	ɛ ɭ
எழால்	ɛ ɻ aː l
எழிலிய	ɛ ɻ ɪ l ɪ j ɐ
எழில்	ɛ ɻ ɪ l
எழு	ɛ ɻ ʊ
எழுச்சி	ɛ ɻ ʊ t͡ɕː ɪ
எழுது	ɛ ɻ ʊ d̪ ʊ
எழுதுகோல்	ɛ ɻ ʊ d̪ ʊ ɡ oː l
எழுதுபடம்	ɛ ɻ ʊ d̪ ʊ b ɐ ɖ ɐ m
எழுத்ததிகாரம்	ɛ ɻ ʊ t̪ː ɐ d̪ ɪ ɡ aː ɾ ɐ m
எழுத்தாணி	ɛ ɻ ʊ t̪ː aː ɳ ɪ
எழுத்தாளன்	ɛ ɻ ʊ t̪ː aː ɭ ɐ n
எழுத்து	ɛ ɻ ʊ t̪ː ʊ
எழுத்துக்கள்	ɛ ɻ ʊ t̪ː ʊ kː ɐ ɭ
எழுத்துப்பிழை	ɛ ɻ ʊ t̪ː ʊ pː ɪ ɻ ɐ ɪ̯
எழுத்துவாசனை	ɛ ɻ ʊ t̪ː ʊ ʋ aː t͡ɕ ɐ n ɐ ɪ̯
எழுநூறு	ɛ ɻ ʊ n̪ uː r ʊ
எழுந்தபடி	ɛ ɻ ʊ n̪ d̪ ɐ b ɐ ɖ ɪ
எழுபது	ɛ ɻ ʊ b ɐ d̪ ʊ
எழுபோது	e ɻ u p oː d̪ u
எழுபோது	ɛ ɻ u p oː d̪ ɯ
எழுப்பு	ɛ ɻ ʊ pː ʊ
எழுவாய்	ɛ ɻ ʊ ʋ aː j
எழுவு	ɛ ɻ ʊ ʋ ʊ
எவண்	ɛ ʋ ɐ ɳ
எவன்	ɛ ʋ ɐ n
எவர்	ɛ ʋ ɐ ɾ
எவர்கள்	ɛ ʋ ɐ ɾ ɡ ɐ ɭ
எவள்	ɛ ʋ ɐ ɭ
எவை	ɛ ʋ ɐ ɪ̯
எவ்வளவு	ɛ ʋː ɐ ɭ ɐ ʋ ʊ
எவ்வாறு	ɛ ʋː aː r ʊ
எஸ்தர்	ɛ s t̪ ɐ ɾ
எஸ்பெராண்டோ	ɛ s p ɛ ɾ aː ɳ ɖ oː
எஸ்ரா	ɛ s ɾ aː
ஏ	eː
ஏகாந்தம்	eː ɡ aː n̪ d̪ ɐ m
ஏக்கங்கள்	eː kː ɐ ŋ ɡ ɐ ɭ
ஏக்கம்	eː kː ɐ m
ஏங்கு	eː ŋ ɡ ʊ
ஏசாயா	eː t͡ɕ aː j aː
ஏடு	eː ɖ ʊ
ஏணி	eː ɳ ɪ
ஏதடை	eː d̪ ɐ ɖ ɐ ɪ̯
ஏதப்பாடு	eː d̪ ɐ pː aː ɖ ʊ
ஏதின்மை	eː d̪ ɪ n m ɐ ɪ̯
ஏது	eː d̪ ʊ
ஏதோ	eː d̪ oː
ஏத்தாளி	eː t̪ː aː ɭ ɪ
ஏத்து	eː t̪ː ʊ
ஏந்திழை	eː n̪ d̪ ɪ ɻ ɐ ɪ̯
ஏனம்	eː n ɐ m
ஏனென்றால்	eː n ɛ n r aː l
ஏன்	eː n
ஏப்பம்	eː pː ɐ m
ஏப்பியன்	eː pː ɪ j ɐ n
ஏப்ரல்	eː p ɾ ɐ l
ஏமாறு	eː m aː r ʊ
ஏமாற்று	eː m aː rː ʊ
ஏமாற்றுபவன்	eː m aː rː ʊ b ɐ ʋ ɐ n
ஏமாற்றுபவள்	eː m aː rː ʊ b ɐ ʋ ɐ ɭ
ஏமுறு	eː m ʊ r ʊ
ஏரணம்	eː ɾ ɐ ɳ ɐ m
ஏராளம்	eː ɾ aː ɭ ɐ m
ஏரி	eː ɾ ɪ
ஏற	eː r ɐ
ஏறக்குறைய	eː r ɐ kː ʊ r ɐ ɪ̯ j ɐ
ஏறு	eː r ʊ
ஏறுநீர்	eː r ʊ n̪ iː ɾ
ஏற்கவே	eː r k ɐ ʋ eː
ஏற்படு	eː r p ɐ ɖ ʊ
ஏற்றக்கால்	eː rː ɐ kː aː l
ஏற்றியல்	eː rː ɪ j ɐ l
ஏற்று	eː rː ʊ
ஏலக்காய்	eː l ɐ kː aː j
ஏலம்	eː l ɐ m
ஏல்	eː l
ஏழிலைப்பாலை	eː ɻ ɪ l ɐ ɪ̯ pː aː l ɐ ɪ̯
ஏழு	eː ɻ ʊ
ஏழ்நூறு	eː ɻ n̪ uː r ʊ
ஏழ்மை	eː ɻ m ɐ ɪ̯
ஏவாள்	eː ʋ aː ɭ
ஏவுகணை	eː ʋ ʊ ɡ ɐ ɳ ɐ ɪ̯
ஐ	ɐ ɪ̯
ஐகாரக்குறுக்கம்	ɐ ɪ̯ ɡ aː ɾ ɐ kː ʊ r ʊ kː ɐ m
ஐகாரம்	ɐ ɪ̯ ɡ aː ɾ ɐ m
ஐக்கியம்	ɐ ɪ̯ kː ɪ j ɐ m
ஐசுவரியம்	ɐ ɪ̯ t͡ɕ ʊ ʋ ɐ ɾ ɪ j ɐ m
ஐதரசன்	ɐ ɪ̯ d̪ ɐ ɾ ɐ t͡ɕ ɐ n
ஐநூறு	ɐ ɪ̯ n̪ uː r ʊ
ஐந்து	ɐ ɪ̯ n̪ d̪ ʊ
ஐப்பசி	ɐ ɪ̯ pː ɐ t͡ɕ ɪ
ஐம்பது	ɐ ɪ̯ m b ɐ d̪ ʊ
ஐம்பத்தெட்டு	ɐ ɪ̯ m b ɐ t̪ː ɛ ʈː ʊ
ஐம்பொன்	ɐ i̯ m p o n
ஐயங்கார்	ɐ ɪ̯ j ɐ ŋ ɡ aː ɾ
ஐயனார்	ɐ ɪ̯ j ɐ n aː ɾ
ஐயன்	ɐ ɪ̯ j ɐ n
ஐயம்	ɐ ɪ̯ j ɐ m
ஐயர்	ɐ ɪ̯ j ɐ ɾ
ஐயா	ɐ ɪ̯ j aː
ஐயோ	ɐ ɪ̯ j oː
ஐரோப்பா	ɐ ɪ̯ ɾ oː pː aː
ஐரோப்பியன்	ɐ ɪ̯ ɾ oː pː ɪ j ɐ n
ஒ	ɔ
ஒகையோ	ɔ ɡ ɐ ɪ̯ j oː
ஒக்க	ɔ kː ɐ
ஒக்கல்	ɔ kː ɐ l
ஒடி	ɔ ɖ ɪ
ஒடிசா	ɔ ɖ ɪ t͡ɕ aː
ஒடுக்கு	ɔ ɖ ʊ kː ʊ
ஒட்டகச்சிவிங்கி	ɔ ʈː ɐ ɡ ɐ t͡ɕː ɪ ʋ ɪ ŋ ɡ ɪ
ஒட்டகம்	ɔ ʈː ɐ ɡ ɐ m
ஒட்டடை	ɔ ʈː ɐ ɖ ɐ ɪ̯
ஒட்டு	ɔ ʈː ʊ
ஒட்டுச்சுண்ணாம்பு	ɔ ʈː ʊ t͡ɕː ʊ ɳː aː m b ʊ
ஒதுக்கு	ɔ d̪ ʊ kː ʊ
ஒதுங்கு	ɔ d̪ ʊ ŋ ɡ ʊ
ஒத்துக்கொள்	ɔ t̪ː ʊ kː ɔ ɭ
ஒன்பது	ɔ n b ɐ d̪ ʊ
ஒன்றாக	ɔ n r aː ɡ ɐ
ஒன்று	ɔ n r ʊ
ஒபதியா	ɔ b ɐ d̪ ɪ j aː
ஒப்பந்தம்	ɔ pː ɐ n̪ d̪ ɐ m
ஒப்பம்	ɔ pː ɐ m
ஒப்பு	ɔ pː ʊ
ஒப்புகை	ɔ pː ʊ ɡ ɐ ɪ̯
ஒப்புமை	ɔ pː ʊ m ɐ ɪ̯
ஒப்புவி	ɔ pː ʊ ʋ ɪ
ஒரு	ɔ ɾ ʊ
ஒருபாலீர்ப்பு	o ɾ u p aː l iː ɾ pː u
ஒருமை	ɔ ɾ ʊ m ɐ ɪ̯
ஒருவன்	ɔ ɾ ʊ ʋ ɐ n
ஒரே	ɔ ɾ eː
ஒற்றன்	ɔ rː ɐ n
ஒற்றுமை	ɔ rː ʊ m ɐ ɪ̯
ஒற்றை	ɔ rː ɐ ɪ̯
ஒலி	ɔ l ɪ
ஒலிநூல்	ɔ l ɪ n̪ uː l
ஒலிபெயர்ப்பு	o l i p e j a ɾ pː u
ஒலிபெருக்கி	ʔ o l̪ i p e ɾ̪ u k kː i
ஒலிவாங்கி	ɔ l ɪ ʋ aː ŋ ɡ ɪ
ஒலிவாங்கிகள்	ɔ l ɪ ʋ aː ŋ ɡ ɪ ɡ ɐ ɭ
ஒலுங்கு	ɔ l ʊ ŋ ɡ ʊ
ஒலோவு	ɔ l oː ʋ ʊ
ஒளி	ɔ ɭ ɪ
ஒளிச்சீலை	ɔ ɭ ɪ t͡ɕː iː l ɐ ɪ̯
ஒளிச்சேர்க்கை	ɔ ɭ ɪ t͡ɕː eː ɾ kː ɐ ɪ̯
ஒளிநகல்	ɔ ɭ ɪ n̪ ɐ ɡ ɐ l
ஒளியாண்டு	ɔ ɭ ɪ j aː ɳ ɖ ʊ
ஒளிர்	ɔ ɭ ɪ ɾ
ஒழி	ɔ ɻ ɪ
ஒழிப்பு	ɔ ɻ ɪ pː ʊ
ஒழுகு	ɔ ɻ ʊ ɡ ʊ
ஒழுக்கம்	ɔ ɻ ʊ kː ɐ m
ஒழுக்கு	ɔ ɻ ʊ kː ʊ
ஒழுங்கு	ɔ ɻ ʊ ŋ ɡ ʊ
ஒழுங்கை	ɔ ɻ ʊ ŋ ɡ ɐ ɪ̯
ஒவ்வாமை	ɔ ʋː aː m ɐ ɪ̯
ஒவ்வொரு	ɔ ʋː ɔ ɾ ʊ
ஓ	oː
ஓங்கில்	oː ŋ ɡ ɪ l
ஓசை	oː t͡ɕ ɐ ɪ̯
ஓச்சன்	oː t͡ɕː ɐ n
ஓடன்	oː ɖ ɐ n
ஓடம்	oː ɖ ɐ m
ஓடு	oː ɖ ʊ
ஓடை	oː ɖ ɐ ɪ̯
ஓட்டல்	oː ʈː ɐ l
ஓட்டு	oː ʈː ʊ
ஓட்டை	oː ʈː ɐ ɪ̯
ஓணான்	oː ɳ aː n
ஓணான்கள்	oː ɳ aː n ɡ ɐ ɭ
ஓதம்	oː d̪ ɐ m
ஓது	oː d̪ ʊ
ஓத்தி	oː t̪ː ɪ
ஓநாய்	oː n̪ aː j
ஓந்தி	oː n̪ d̪ ɪ
ஓமம்	oː m ɐ m
ஓம்	oː m
ஓம்படு	oː m b ɐ ɖ ʊ
ஓய்	oː j
ஓய்வு	oː j ʋ ʊ
ஓய்வுநாள்	oː j ʋ ʊ n̪ aː ɭ
ஓய்வூதியம்	oː j ʋ uː d̪ ɪ j ɐ m
ஓரம்	oː ɾ ɐ m
ஓரினச்சேர்க்கை	oː ɾ ɪ n ɐ t͡ɕː eː ɾ kː ɐ ɪ̯
ஓர்	oː ɾ
ஓலம்	oː l ɐ m
ஓலை	oː l ɐ ɪ̯
ஓவியம்	oː ʋ ɪ j ɐ m
ஔ	ɐ ʊ̯
ஔகாரக்குறுக்கம்	ɐ ʊ̯ ɡ aː ɾ ɐ kː ʊ r ʊ kː ɐ m
ஔடதம்	ɐ ʊ̯ ɖ ɐ d̪ ɐ m
ஔவியம்	ɐ ʊ̯ ʋ ɪ j ɐ m
ஔவை	ɐ ʊ̯ ʋ ɐ ɪ̯
ஔஷதம்	ɐ ʊ̯ ʂ ɐ d̪ ɐ m
க	k ɐ
ககனம்	k ɐ ɡ ɐ n ɐ m
கக்கம்	k ɐ kː ɐ m
கக்கு	k ɐ kː ʊ
கங்காதரன்	k ɐ ŋ ɡ aː d̪ ɐ ɾ ɐ n
கங்காரு	ɡ ɐ ŋ ɡ aː ɾ ʊ
கங்கு	k ɐ ŋ ɡ ʊ
கங்கை	k ɐ ŋ ɡ ɐ ɪ̯
கச	k ɐ t͡ɕ ɐ
கசப்பு	k ɐ t͡ɕ ɐ pː ʊ
கச்சு	k ɐ t͡ɕː ʊ
கச்சேரி	k ɐ t͡ɕː eː ɾ ɪ
கஜம்	ɡ ɐ d͡ʑ ɐ m
கஜானா	ɡ ɐ d͡ʑ aː n aː
கஞ்சா	k ɐ ɲ d͡ʑ aː
கஞ்சா	ɡ ɐ ɲ d͡ʑ aː
கஞ்சாவை	k ɐ ɲ d͡ʑ aː ʋ ɐ ɪ̯
கஞ்சி	k ɐ ɲ d͡ʑ ɪ
கட	k ɐ ɖ ɐ
கடகம்	k ɐ ɖ ɐ ɡ ɐ m
கடத்து	k ɐ ɖ ɐ t̪ː ʊ
கடந்த	k ɐ ɖ ɐ n̪ d̪ ɐ
கடந்தை	k ɐ ɖ ɐ n̪ d̪ ɐ ɪ̯
கடனாளி	k ɐ ɖ ɐ n aː ɭ ɪ
கடன்	k ɐ ɖ ɐ n
கடமை	k ɐ ɖ ɐ m ɐ ɪ̯
கடற்கன்னி	k ɐ ɖ ɐ r k ɐ nː ɪ
கடற்கரை	k ɐ ɖ ɐ r k ɐ ɾ ɐ ɪ̯
கடற்குதிரை	k ɐ ɖ ɐ r k ʊ d̪ ɪ ɾ ɐ ɪ̯
கடற்கோள்	k ɐ ɖ ɐ r k oː ɭ
கடற்பாசி	k ɐ ɖ ɐ r p aː t͡ɕ ɪ
கடலூர்	k ɐ ɖ ɐ l uː ɾ
கடலை	k ɐ ɖ ɐ l ɐ ɪ̯
கடலோன்	k ɐ ɖ ɐ l oː n
கடல்	k ɐ ɖ ɐ l
கடல்நீர்	k ɐ ɖ ɐ l n̪ iː ɾ
கடவுச்சீட்டு	k ɐ ɖ ɐ ʋ ʊ t͡ɕː iː ʈː ʊ
கடவுச்சொற்கள்	k ɐ ɖ ɐ ʋ ʊ t͡ɕː ɔ r k ɐ ɭ
கடவுச்சொல்	k ɐ ɖ ɐ ʋ ʊ t͡ɕː ɔ l
கடவுள்	k ɐ ɖ ɐ ʋ ʊ ɭ
கடாரம்	k ɐ ɖ aː ɾ ɐ m
கடி	k ɐ ɖ ɪ
கடிகாரம்	k ɐ ɖ ɪ ɡ aː ɾ ɐ m
கடிகாரம்	ɡ ɐ ɖ ɪ ɡ aː ɾ ɐ m
கடிக்கை	k ɐ ɖ ɪ kː ɐ ɪ̯
கடிதம்	k ɐ ɖ ɪ d̪ ɐ m
கடினம்	k ɐ ɖ ɪ n ɐ m
கடிவாளம்	k ɐ ɖ ɪ ʋ aː ɭ ɐ m
கடுகு	k ɐ ɖ ʊ ɡ ʊ
கடுங்கோபம்	k ɐ ɖ ʊ ŋ ɡ oː b ɐ m
கடுதாசி	k ɐ ɖ ʊ d̪ aː t͡ɕ ɪ
கடுமை	k ɐ ɖ ʊ m ɐ ɪ̯
கடும்	k ɐ ɖ ʊ m
கடை	k ɐ ɖ ɐ ɪ̯
கடைசி	k ɐ ɖ a ɪ̯ s i
கடைத்தெரு	k ɐ ɖ ɐ ɪ̯ t̪ː ɛ ɾ ʊ
கடையர்	k ɐ ɖ ɐ ɪ̯ j ɐ ɾ
கடையெழுத்து	k ɐ ɖ ɐ ɪ̯ j ɛ ɻ ʊ t̪ː ʊ
கடைவாய்ப்பல்	k ɐ ɖ ɐ ɪ̯ ʋ aː j pː ɐ l
கட்கம்	k ɐ ʈ k ɐ m
கட்சி	k ɐ ʈ t͡ɕ ɪ
கட்சியார்	k ɐ ʈ t͡ɕ ɪ j aː ɾ
கட்டடம்	k ɐ ʈː ɐ ɖ ɐ m
கட்டமைப்பு	k ɐ ʈː ɐ m ɐ ɪ̯ pː ʊ
கட்டம்	k ɐ ʈː ɐ m
கட்டல்	k ɐ ʈː ɐ l
கட்டளை	k ɐ ʈː ɐ ɭ ɐ ɪ̯
கட்டி	k ɐ ʈː ɪ
கட்டிடக்கலை	k ɐ ʈː ɪ ɖ ɐ kː ɐ l ɐ ɪ̯
கட்டிடம்	k ɐ ʈː ɪ ɖ ɐ m
கட்டிப்பிடி	k ɐ ʈː ɪ pː ɪ ɖ ɪ
கட்டிமை	k ɐ ʈː ɪ m ɐ ɪ̯
கட்டியடுப்பு	k ɐ ʈː ɪ j ɐ ɖ ʊ pː ʊ
கட்டில்	k ɐ ʈː ɪ l
கட்டு	k ɐ ʈː ʊ
கட்டுத்தறி	k ɐ ʈː ʊ t̪ː ɐ r ɪ
கட்டுப்படு	k ɐ ʈː ʊ pː ɐ ɖ ʊ
கட்டுமரங்கள்	k ɐ ʈː ʊ m ɐ ɾ ɐ ŋ ɡ ɐ ɭ
கட்டுமரம்	k ɐ ʈː ʊ m ɐ ɾ ɐ m
கட்டுரை	k ɐ ʈː ʊ ɾ ɐ ɪ̯
கட்டை	k ɐ ʈː ɐ ɪ̯
கட்டையிலை	k ɐ ʈː ɐ ɪ̯ j ɪ l ɐ ɪ̯
கட்டைவிரல்	k ɐ ʈː ɐ ɪ̯ ʋ ɪ ɾ ɐ l
கணக்காளர்	k ɐ ɳ ɐ kː aː ɭ ɐ ɾ
கணக்கியல்	k ɐ ɳ ɐ kː ɪ j ɐ l
கணக்கு	k ɐ ɳ ɐ kː ʊ
கணக்குப்பிள்ளை	k ɐ ɳ ɐ kː ʊ pː ɪ ɭː ɐ ɪ̯
கணபதி	k ɐ ɳ ɐ b ɐ d̪ ɪ
கணம்	k ɐ ɳ ɐ m
கணவன்	k ɐ ɳ ɐ ʋ ɐ n
கணவாய்	k ɐ ɳ ɐ ʋ aː j
கணி	ɡ ɐ ɳ ɪ
கணிகன்	k ɐ ɳ ɪ ɡ ɐ n
கணிதம்	k ɐ ɳ ɪ d̪ ɐ m
கணிதம்	ɡ ɐ ɳ ɪ d̪ ɐ m
கணினி	k ɐ ɳ ɪ n ɪ
கணினியியல்	k ɐ ɳ ɪ n ɪ j ɪ j ɐ l
கணு	k ɐ ɳ ʊ
கணுமருது	k ɐ ɳ ʊ m ɐ ɾ ʊ d̪ ʊ
கணேசன்	k ɐ ɳ eː t͡ɕ ɐ n
கணையாழி	k ɐ ɳ ɐ ɪ̯ j aː ɻ ɪ
கண்	k ɐ ɳ
கண்காணம்	k ɐ ɳ ɡ aː ɳ ɐ m
கண்காணி	k ɐ ɳ ɡ aː ɳ ɪ
கண்காணித்தல்	k ɐ ɳ ɡ aː ɳ ɪ t̪ː ɐ l
கண்டக்கருவி	k ɐ ɳ ɖ ɐ kː ɐ ɾ ʊ ʋ ɪ
கண்டம்	k ɐ ɳ ɖ ɐ m
கண்டரை	k ɐ ɳ ɖ ɐ ɾ ɐ ɪ̯
கண்டி	k ɐ ɳ ɖ ɪ
கண்டிப்பு	k ɐ ɳ ɖ ɪ pː ʊ
கண்டு	k ɐ ɳ ɖ ʊ
கண்டுபிடி	k ɐ ɳ ɖ ʊ b ɪ ɖ ɪ
கண்டெடு	k ɐ ɳ ɖ ɛ ɖ ʊ
கண்டோனீயம்	k ɐ ɳ ɖ oː n iː j ɐ m
கண்ணன்	k ɐ ɳː ɐ n
கண்ணமரம்	k ɐ ɳː ɐ m ɐ ɾ ɐ m
கண்ணய	k ɐ ɳː ɐ j ɐ
கண்ணா	k ɐ ɳː aː
கண்ணாடி	k ɐ ɳː aː ɖ ɪ
கண்ணாடிவிரியன்	k ɐ ɳː aː ɖ ɪ ʋ ɪ ɾ ɪ j ɐ n
கண்ணி	k ɐ ɳː ɪ
கண்ணீர்	k ɐ ɳː iː ɾ
கண்ணூர்	k ɐ ɳː uː ɾ
கண்ணோட்டம்	k ɐ ɳː oː ʈː ɐ m
கண்மணி	k ɐ ɳ m ɐ ɳ ɪ
கண்மாய்	k ɐ ɳ m aː j
கண்விழி	k ɐ ɳ ʋ ɪ ɻ ɪ
கதகளி	k ɐ d̪ ɐ ɡ ɐ ɭ ɪ
கதம்பகம்	k ɐ d̪ ɐ m b ɐ ɡ ɐ m
கதவு	k ɐ d̪ ɐ ʋ ʊ
கதி	k ɐ d̪ ɪ
கதிக்க	k ɐ d̪ ɪ kː ɐ
கதிப்பு	k ɐ d̪ ɪ pː ʊ
கதிமை	k ɐ d̪ ɪ m ɐ ɪ̯
கதிரவன்	k ɐ d̪ ɪ ɾ ɐ ʋ ɐ n
கதிரியக்கம்	k ɐ d̪ ɪ ɾ ɪ j ɐ kː ɐ m
கதிரோன்	k ɐ d̪ ɪ ɾ oː n
கதிர்	k ɐ d̪ ɪ ɾ
கதிர்க்கடவுள்	k ɐ d̪ ɪ ɾ kː ɐ ɖ ɐ ʋ ʊ ɭ
கதிர்க்கட்டு	k ɐ d̪ ɪ ɾ kː ɐ ʈː ʊ
கதிர்ப்பு	k ɐ d̪ ɪ ɾ pː ʊ
கதை	k ɐ d̪ ɐ ɪ̯
கத்தரி	k ɐ t̪ː ɐ ɾ ɪ
கத்தரிக்காய்	k ɐ t̪ː ɐ ɾ ɪ kː aː j
கத்தி	k ɐ t̪ː ɪ
கத்திரி	k ɐ t̪ː ɪ ɾ ɪ
கத்திரிக்காய்	k ɐ t̪ː ɪ ɾ ɪ kː aː j
கத்திரிணி	k ɐ t̪ː ɪ ɾ ɪ ɳ ɪ
கத்திரியன்	k ɐ t̪ː ɪ ɾ ɪ j ɐ n
கத்து	k ɐ t̪ː ʊ
கந்தகம்	k ɐ n̪ d̪ ɐ ɡ ɐ m
கந்தகம்	ɡ ɐ n̪ d̪ ɐ ɡ ɐ m
கந்தன்	k ɐ n̪ d̪ ɐ n
கந்தம்	k ɐ n̪ d̪ ɐ m
கந்தரம்	k ɐ n̪ d̪ ɐ ɾ ɐ m
கந்தல்	k ɐ n̪ d̪ ɐ l
கந்தி	k ɐ n̪ d̪ ɪ
கந்து	k ɐ n̪ d̪ ʊ
கனடா	k ɐ n ɐ ɖ aː
கனமழை	k ɐ n ɐ m ɐ ɻ ɐ ɪ̯
கனம்	k ɐ n ɐ m
கனவு	k ɐ n ɐ ʋ ʊ
கனா	k ɐ n aː
கனி	k ɐ n ɪ
கனிமம்	k ɐ n ɪ m ɐ m
கன்னட	k ɐ nː ɐ ɖ ɐ
கன்னடம்	k ɐ nː ɐ ɖ ɐ m
கன்னம்	k ɐ nː ɐ m
கன்னல்	k ɐ nː ɐ l
கன்னி	k ɐ nː ɪ
கன்னியாகுமரி	k a nː i j aː k u m a ɾ i
கன்னியாகுமரி	k ɐ nː i j aː k u m ɐ ɾ i
கன்று	k ɐ n r ʊ
கபடம்	k ɐ b ɐ ɖ ɐ m
கபாலம்	k ɐ b aː l ɐ m
கபிலம்	k ɐ b ɪ l ɐ m
கபுரம்	k ɐ b ʊ ɾ ɐ m
கபோதகம்	k ɐ b oː d̪ ɐ ɡ ɐ m
கபோதம்	k ɐ b oː d̪ ɐ m
கப்பம்	k ɐ pː ɐ m
கப்பற்சண்டை	k ɐ pː ɐ r t͡ɕ ɐ ɳ ɖ ɐ ɪ̯
கப்பற்சேதம்	k ɐ pː ɐ r t͡ɕ eː d̪ ɐ m
கப்பல்	k ɐ pː ɐ l
கப்பு	ɡ ɐ b b ʊ
கமகம	ɡ ɐ m ɐ ɡ ɐ m ɐ
கமலம்	k ɐ m ɐ l ɐ m
கம்பம்	k ɐ m b ɐ m
கம்பளம்	k ɐ m b ɐ ɭ ɐ m
கம்பி	k ɐ m b ɪ
கம்பு	k ɐ m b ʊ
கம்போடியா	k ɐ m b oː ɖ ɪ j aː
கம்மார்வெற்றிலை	k ɐ mː aː ɾ ʋ ɛ rː ɪ l ɐ ɪ̯
கயம்	k ɐ j ɐ m
கயல்	k ɐ j ɐ l
கயல்விழி	k ɐ j ɐ l ʋ ɪ ɻ ɪ
கயவாய்	k ɐ j ɐ ʋ aː j
கயிரவம்	k ɐ j ɪ ɾ ɐ ʋ ɐ m
கயிறு	k ɐ j ɪ r ʊ
கரடகம்	k ɐ ɾ ɐ ɖ ɐ ɡ ɐ m
கரடி	k ɐ ɾ ɐ ɖ ɪ
கரண்டி	k ɐ ɾ ɐ ɳ ɖ ɪ
கரண்ட்	k ɐ ɾ ɐ ɳ ɖ
கரப்பான்	k ɐ ɾ ɐ pː aː n
கரம்	k ɐ ɾ ɐ m
கரி	k ɐ ɾ ɪ
கரிக்குருவி	k ɐ ɾ ɪ kː ʊ ɾ ʊ ʋ ɪ
கரிச்சலாசத்து	k ɐ ɾ ɪ t͡ɕː ɐ l aː t͡ɕ ɐ t̪ː ʊ
கரிமம்	k ɐ ɾ ɪ m ɐ m
கரியமிலவாயு	k ɐ ɾ ɪ j ɐ m ɪ l ɐ ʋ aː j ʊ
கரிவாளன்கோலா	k ɐ ɾ ɪ ʋ aː ɭ ɐ n ɡ oː l aː
கரு	k ɐ ɾ ʊ
கருக்கு	k ɐ ɾ ʊ kː ʊ
கருக்குவாய்ச்சி	k ɐ ɾ ʊ kː ʊ ʋ aː j t͡ɕː ɪ
கருங்கல்	k ɐ ɾ ʊ ŋ ɡ ɐ l
கருங்காலி	k ɐ ɾ ʊ ŋ ɡ aː l ɪ
கருஞ்சிவப்பு	k ɐ ɾ ʊ ɲ d͡ʑ ɪ ʋ ɐ pː ʊ
கருடன்	k ɐ ɾ ʊ ɖ ɐ n
கருடன்	ɡ ɐ ɾ ʊ ɖ ɐ n
கருணை	k ɐ ɾ ʊ ɳ ɐ ɪ̯
கருது	k ɐ ɾ ʊ d̪ ʊ
கருதுகோள்	k a ɾ u d̪ u k oː ɭ
கருதுகோள்	k ɐ ɾ u d̪ ɯ k oː ɭ
கருத்தியல்	k ɐ ɾ ʊ t̪ː ɪ j ɐ l
கருத்துரு	k ɐ ɾ ʊ t̪ː ʊ ɾ ʊ
கருநாரை	k ɐ ɾ ʊ n̪ aː ɾ ɐ ɪ̯
கருப்பட்டி	k ɐ ɾ ʊ pː ɐ ʈː ɪ
கருப்பநீர்	k ɐ ɾ ʊ pː ɐ n̪ iː ɾ
கருப்பம்	k ɐ ɾ ʊ pː ɐ m
கருப்பிணி	k ɐ ɾ ʊ pː ɪ ɳ ɪ
கருப்பு	k ɐ ɾ ʊ pː ʊ
கருப்பை	k ɐ ɾ ʊ pː ɐ ɪ̯
கருமம்	k ɐ ɾ ʊ m ɐ m
கருமுட்டை	k ɐ ɾ ʊ m ʊ ʈː ɐ ɪ̯
கருமை	k ɐ ɾ ʊ m ɐ ɪ̯
கருமையான	k ɐ ɾ ʊ m ɐ ɪ̯ j aː n ɐ
கரும்பு	k ɐ ɾ ʊ m b ʊ
கருவா	k ɐ ɾ ʊ ʋ aː
கருவாடு	k ɐ ɾ ʊ ʋ aː ɖ ʊ
கருவி	k ɐ ɾ ʊ ʋ ɪ
கருவிழி	k ɐ ɾ ʊ ʋ ɪ ɻ ɪ
கருவீரல்	k ɐ ɾ ʊ ʋ iː ɾ ɐ l
கருவூலம்	k ɐ ɾ ʊ ʋ uː l ɐ m
கரூர்	k ɐ ɾ uː ɾ
கரை	k ɐ ɾ ɐ ɪ̯
கரைப்பு	k ɐ ɾ ɐ ɪ̯ pː ʊ
கர்த்தர்	k ɐ ɾ t̪ː ɐ ɾ
கர்நாடகம்	k ɐ ɾ n̪ aː ɖ ɐ ɡ ɐ m
கர்நாடகா	k ɐ ɾ n̪ aː ɖ ɐ ɡ aː
கர்ப்பிணி	k ɐ ɾ pː ɪ ɳ ɪ
கர்வம்	k ɐ ɾ ʋ ɐ m
கர்வம்	ɡ ɐ ɾ ʋ ɐ m
கறவு	k ɐ r ɐ ʋ ʊ
கறவை	k ɐ r ɐ ʋ ɐ ɪ̯
கறி	k ɐ r ɪ
கறிக்கு	k ɐ r ɪ kː ʊ
கறிவேப்பிலை	k ɐ r ɪ ʋ eː pː ɪ l ɐ ɪ̯
கறு	k ɐ r ʊ
கறுப்பு	k ɐ r ʊ pː ʊ
கறுப்புவெற்றிலை	k ɐ r ʊ pː ʊ ʋ ɛ rː ɪ l ɐ ɪ̯
கறுவா	k ɐ r ʊ ʋ aː
கறுவு	k ɐ r ʊ ʋ ʊ
கற்கண்டு	k ɐ r k ɐ ɳ ɖ ʊ
கற்கம்	k ɐ r k ɐ m
கற்கள்	k ɐ r k ɐ ɭ
கற்குளி	k ɐ r k ʊ ɭ ɪ
கற்பனை	k ɐ r p ɐ n ɐ ɪ̯
கற்பாழி	k ɐ r p aː ɻ ɪ
கற்பி	k ɐ r p ɪ
கற்பு	k ɐ r p ʊ
கற்பூரம்	k ɐ r p uː ɾ ɐ m
கற்றார்	k ɐ rː aː ɾ
கற்றாலை	k ɐ rː aː l ɐ ɪ̯
கற்றாழை	k ɐ rː aː ɻ ɐ ɪ̯
கற்றிருத்து	k ɐ rː ɪ ɾ ʊ t̪ː ʊ
கற்றை	k ɐ rː ɐ ɪ̯
கற்றொட்டி	k ɐ rː ɔ ʈː ɪ
கற்றொழிலோர்	k ɐ rː ɔ ɻ ɪ l oː ɾ
கல	k ɐ l ɐ
கலகம்	k ɐ l ɐ ɡ ɐ m
கலங்கரை	k ɐ l ɐ ŋ ɡ ɐ ɾ ɐ ɪ̯
கலங்கரைவிளக்கம்	k ɐ l ɐ ŋ ɡ ɐ ɾ ɐ ɪ̯ ʋ ɪ ɭ ɐ kː ɐ m
கலங்கு	k ɐ l ɐ ŋ ɡ ʊ
கலசம்	k ɐ l ɐ t͡ɕ ɐ m
கலந்தாய்வு	k ɐ l ɐ n̪ d̪ aː j ʋ ʊ
கலப்பை	k ɐ l ɐ pː ɐ ɪ̯
கலம்	k ɐ l ɐ m
கலயம்	k ɐ l ɐ j ɐ m
கலவி	k ɐ l ɐ ʋ ɪ
கலவை	k ɐ l ɐ ʋ ɐ ɪ̯
கலாய்	k ɐ l aː j
கலாவர்	k ɐ l aː ʋ ɐ ɾ
கலாவர்கள்	k ɐ l aː ʋ ɐ ɾ ɡ ɐ ɭ
கலிங்கல்	k ɐ l ɪ ŋ ɡ ɐ l
கலீஜு	ɡ ɐ l iː d͡ʑ ʊ
கலுழ்ச்சி	k ɐ l ʊ ɻ t͡ɕː ɪ
கலை	k ɐ l ɐ ɪ̯
கலைக்களஞ்சியம்	k ɐ l ɐ ɪ̯ kː ɐ ɭ ɐ ɲ d͡ʑ ɪ j ɐ m
கலைச்சொல்	k ɐ l ɐ ɪ̯ t͡ɕː ɔ l
கலைஞர்	k ɐ l ɐ ɪ̯ ɲ ɐ ɾ
கலையுருக்காட்டி	k ɐ l ɐ ɪ̯ j ʊ ɾ ʊ kː aː ʈː ɪ
கல்	k ɐ l
கல்யாணம்	k ɐ l j aː ɳ ɐ m
கல்லீரல்	k ɐ l l iː ɾ ɐ l
கல்லூரி	k ɐ l l uː ɾ ɪ
கல்லேறு	k ɐ l l eː r ʊ
கல்லோலம்	k ɐ l l oː l ɐ m
கல்வி	k ɐ l ʋ ɪ
கல்விக்கூடம்	k ɐ l ʋ ɪ kː uː ɖ ɐ m
கல்விநிலையம்	k ɐ l ʋ ɪ n̪ ɪ l ɐ ɪ̯ j ɐ m
கல்வெட்டியல்	k ɐ l ʋ ɛ ʈː ɪ j ɐ l
கல்வெட்டு	k ɐ l ʋ ɛ ʈː ʊ
களஞ்சியம்	k ɐ ɭ ɐ ɲ d͡ʑ ɪ j ɐ m
களம்	k ɐ ɭ ɐ m
களவு	k ɐ ɭ ɐ ʋ ʊ
களிகூறு	k a ɭ i k uː r u
களிகூறு	k ə ɭ ɪ k uː r ɯ
களிப்பு	k ɐ ɭ ɪ pː ʊ
களிமண்	k ɐ ɭ ɪ m ɐ ɳ
களிறு	k ɐ ɭ ɪ r ʊ
களை	k ɐ ɭ ɐ ɪ̯
களைப்பு	k ɐ ɭ ɐ ɪ̯ pː ʊ
கள்	k ɐ ɭ
கள்ளக்குறிச்சி	k ɐ ɭː ɐ kː ʊ r ɪ t͡ɕː ɪ
கள்ளம்	k ɐ ɭː ɐ m
கள்ளிச்செடி	k ɐ ɭː ɪ t͡ɕː ɛ ɖ ɪ
கழகம்	k ɐ ɻ ɐ ɡ ɐ m
கழஞ்சு	k ɐ ɻ ɐ ɲ d͡ʑ ʊ
கழட்டு	k ɐ ɻ ɐ ʈː ʊ
கழனி	k ɐ ɻ ɐ n ɪ
கழற்று	k ɐ ɻ ɐ rː ʊ
கழி	k ɐ ɻ ɪ
கழித்தல்	k ɐ ɻ ɪ t̪ː ɐ l
கழிமுட்டான்	k ɐ ɻ ɪ m ʊ ʈː aː n
கழிவு	k ɐ ɻ ɪ ʋ ʊ
கழுகரிப்பரி	k ɐ ɻ ʊ ɡ ɐ ɾ ɪ pː ɐ ɾ ɪ
கழுகு	k ɐ ɻ ʊ ɡ ʊ
கழுதை	k ɐ ɻ ʊ d̪ ɐ ɪ̯
கழுதைப்புலி	k ɐ ɻ ʊ d̪ ɐ ɪ̯ pː ʊ l ɪ
கழுத்து	k ɐ ɻ ʊ t̪ː ʊ
கழுவு	k ɐ ɻ ʊ ʋ ʊ
கவனம்	ɡ ɐ ʋ ɐ n ɐ m
கவனி	ɡ ɐ ʋ ɐ n ɪ
கவர்வு	k ɐ ʋ ɐ ɾ ʋ ʊ
கவற்சி	k ɐ ʋ ɐ r t͡ɕ ɪ
கவலை	k ɐ ʋ ɐ l ɐ ɪ̯
கவல்	k ɐ ʋ ɐ l
கவி	k ɐ ʋ ɪ
கவிகள்	k ɐ ʋ ɪ ɡ ɐ ɭ
கவிஞன்	k ɐ ʋ ɪ ɲ ɐ n
கவிஞர்	k ɐ ʋ ɪ ɲ ɐ ɾ
கவிதை	k ɐ ʋ ɪ d̪ ɐ ɪ̯
கவின்	k ɐ ʋ ɪ n
கவிழ்	k ɐ ʋ ɪ ɻ
கவுதாரி	k ɐ ʋ ʊ d̪ aː ɾ ɪ
கஷாயம்	k ɐ ʂ aː j ɐ m
கஷ்டங்கள்	k ɐ ʂ ʈ ɐ ŋ ɡ ɐ ɭ
கஷ்டம்	k ɐ ʂ ʈ ɐ m
கஸாயி	k ɐ s aː j ɪ
கஸ்தூரிமஞ்சள்	k ɐ s t̪ uː ɾ ɪ m ɐ ɲ d͡ʑ ɐ ɭ
கா	k aː
காகம்	k aː ɡ ɐ m
காகிதம்	k aː ɡ ɪ d̪ ɐ m
காக்காய்	k aː kː aː j
காக்காய்பிடி	k aː kː aː j b ɪ ɖ ɪ
காக்காய்வெருட்சி	k aː kː aː j ʋ ɛ ɾ ʊ ʈ t͡ɕ ɪ
காக்கை	k aː kː ɐ ɪ̯
காக்கைக்கு	k aː kː ɐ ɪ̯ kː ʊ
காசர்கோடு	k aː t͡ɕ ɐ ɾ ɡ oː ɖ ʊ
காசறை	k aː t͡ɕ ɐ r ɐ ɪ̯
காசினி	k aː t͡ɕ ɪ n ɪ
காசினிவிரை	k aː t͡ɕ ɪ n ɪ ʋ ɪ ɾ ɐ ɪ̯
காசு	k aː t͡ɕ ʊ
காசோலை	k aː t͡ɕ oː l ɐ ɪ̯
காஞ்சிபுரம்	k aː ɲ d͡ʑ ɪ b ʊ ɾ ɐ m
காடு	k aː ɖ ʊ
காடை	k aː ɖ ɐ ɪ̯
காடைக்கண்ணி	k aː ɖ ɐ ɪ̯ kː ɐ ɳː ɪ
காட்சி	k aː ʈ t͡ɕ ɪ
காட்டகத்தமிர்து	k aː ʈː ɐ ɡ ɐ t̪ː ɐ m ɪ ɾ d̪ ʊ
காட்டசை	k aː ʈː ɐ t͡ɕ ɐ ɪ̯
காட்டாமணக்கு	k aː ʈː aː m ɐ ɳ ɐ kː ʊ
காட்டிலும்	k aː ʈː ɪ l ʊ m
காட்டு	k aː ʈː ʊ
காட்டுக்காய்ச்சுரை	k aː ʈː ʊ kː aː j t͡ɕː ʊ ɾ ɐ ɪ̯
காட்டுக்கோழி	k aː ʈː ʊ kː oː ɻ ɪ
காட்டுச்சந்தனம்	k aː ʈː ʊ t͡ɕː ɐ n̪ d̪ ɐ n ɐ m
காட்டுப்பயிர்	k aː ʈː ʊ pː ɐ j ɪ ɾ
காட்டுப்புகையிலை	k aː ʈː ʊ pː ʊ ɡ ɐ ɪ̯ j ɪ l ɐ ɪ̯
காட்டுப்பூனை	k aː ʈː ʊ pː uː n ɐ ɪ̯
காட்டுவெண்டை	k aː ʈː ʊ ʋ ɛ ɳ ɖ ɐ ɪ̯
காட்டெருது	k aː ʈː ɛ ɾ ʊ d̪ ʊ
காட்டெருமை	k aː ʈː ɛ ɾ ʊ m ɐ ɪ̯
காணம்	k aː ɳ ɐ m
காணி	k aː ɳ ɪ
காணொளி	k aː ɳ ɔ ɭ ɪ
காண்	k aː ɳ
காண்டம்	k aː ɳ ɖ ɐ m
காண்டாமிருகம்	k aː ɳ ɖ aː m ɪ ɾ ʊ ɡ ɐ m
காண்டீவம்	k aː ɳ ɖ iː ʋ ɐ m
காண்டு	ɡ aː ɳ ɖ ʊ
காதணி	k aː d̪ ɐ ɳ ɪ
காதம்	k aː d̪ ɐ m
காதரம்	k aː d̪ ɐ ɾ ɐ m
காதலன்	k aː d̪ ɐ l ɐ n
காதல்	k aː d̪ ɐ l
காது	k aː d̪ ʊ
காதை	k aː d̪ ɐ ɪ̯
காத்திரம்	k aː t̪ː ɪ ɾ ɐ m
காந்தக்கல்	k aː n̪ d̪ ɐ kː ɐ l
காந்தம்	k aː n̪ d̪ ɐ m
காந்தவண்டி	k aː n̪ d̪ ɐ ʋ ɐ ɳ ɖ ɪ
காந்தாரம்	k aː n̪ d̪ aː ɾ ɐ m
காந்தி	k aː n̪ d̪ ɪ
கானங்கோழி	k aː n ɐ ŋ ɡ oː ɻ ɪ
கானலி	k aː n ɐ l ɪ
கானல்	k aː n ɐ l
கானெறி	k aː n ɛ r ɪ
காபி	k aː b ɪ
காபூல்	k aː b uː l
காப்ச்சா	k aː p t͡ɕː aː
காப்பாற்று	k aː pː aː rː ʊ
காப்பியம்	k aː pː ɪ j ɐ m
காப்பீடு	k aː pː iː ɖ ʊ
காப்பு	k aː pː ʊ
காமமரம்	k aː m ɐ m ɐ ɾ ɐ m
காமம்	k aː m ɐ m
காம்புச்சல்லடை	k aː m b ʊ t͡ɕː ɐ l l ɐ ɖ ɐ ɪ̯
காயம்	k aː j ɐ m
காய்	k aː j
காய்கறி	k aː j ɡ ɐ r ɪ
காய்ச்சல்	k aː j t͡ɕː ɐ l
காய்ச்சு	k aː j t͡ɕː ʊ
காய்த்து	k aː j t̪ː ʊ
காரணப்பெயர்	k aː ɾ ɐ ɳ ɐ pː ɛ j ɐ ɾ
காரணம்	k aː ɾ ɐ ɳ ɐ m
காரம்	k aː ɾ ɐ m
காராமணி	k aː ɾ aː m ɐ ɳ ɪ
காரியசித்தி	k aː ɾ ɪ j ɐ t͡ɕ ɪ t̪ː ɪ
காரியம்	k aː ɾ ɪ j ɐ m
காரீயக்கல்	k aː ɾ iː j ɐ kː ɐ l
காருண்யம்	k aː ɾ ʊ ɳ j ɐ m
கார்	k aː ɾ
கார்த்திகேயன்	k aː ɾ t̪ː ɪ ɡ eː j ɐ n
கார்த்திகை	k aː ɾ t̪ː ɪ ɡ ɐ ɪ̯
கார்த்திகைவாளை	k aː ɾ t̪ː ɪ ɡ ɐ ɪ̯ ʋ aː ɭ ɐ ɪ̯
கார்த்தூம்	k aː ɾ t̪ː uː m
கார்ப்பு	k aː ɾ pː ʊ
கார்மம்	k aː ɾ m ɐ m
கார்முகில்	k aː ɾ m ʊ ɡ ɪ l
காறையெலும்பு	k aː r ɐ ɪ̯ j ɛ l ʊ m b ʊ
காற்றழுத்தமானி	k aː rː ɐ ɻ ʊ t̪ː ɐ m aː n ɪ
காற்றழுத்தம்	k aː rː ɐ ɻ ʊ t̪ː ɐ m
காற்றாடி	k aː rː aː ɖ ɪ
காற்றாலை	k aː rː aː l ɐ ɪ̯
காற்று	k aː rː ʊ
காலணி	k aː l ɐ ɳ ɪ
காலம்	k aː l ɐ m
காலாள்	k aː l aː ɭ
காலி	k aː l ɪ
காலி	ɡ aː l ɪ
காலுறை	k aː l ʊ r ɐ ɪ̯
காலுறைகள்	k aː l ʊ r ɐ ɪ̯ ɡ ɐ ɭ
காலை	k aː l ɐ ɪ̯
கால்	k aː l
கால்நடை	k aː l n̪ ɐ ɖ ɐ ɪ̯
காளவாய்	k aː ɭ ɐ ʋ aː j
காளான்	k aː ɭ aː n
காளை	k aː ɭ ɐ ɪ̯
காவல்	k aː ʋ ɐ l
காவி	k aː ʋ ɪ
காவிக்கல்	k aː ʋ ɪ kː ɐ l
காவு	k aː ʋ ʊ
காவேரி	k aː ʋ eː ɾ ɪ
கிசில்	k ɪ t͡ɕ ɪ l
கிசுகிசு	k i s u k i s u
கிசுகிசு	k i s u k i s ɯ
கிச்சு	k ɪ t͡ɕː ʊ
கிட	k ɪ ɖ ɐ
கிடக்கை	k ɪ ɖ ɐ kː ɐ ɪ̯
கிடங்கு	k ɪ ɖ ɐ ŋ ɡ ʊ
கிடப்பு	k ɪ ɖ ɐ pː ʊ
கிடை	k ɪ ɖ ɐ ɪ̯
கிட்ட	k ɪ ʈː ɐ
கிட்டப்பார்வை	k ɪ ʈː ɐ pː aː ɾ ʋ ɐ ɪ̯
கிட்டு	k ɪ ʈː ʊ
கிணறு	k ɪ ɳ ɐ r ʊ
கிணற்றாமை	k ɪ ɳ ɐ rː aː m ɐ ɪ̯
கிணற்றுக்கட்டு	k ɪ ɳ ɐ rː ʊ kː ɐ ʈː ʊ
கிண்டி	k ɪ ɳ ɖ ɪ
கிண்டி	ɡ ɪ ɳ ɖ ɪ
கிண்ணம்	k ɪ ɳː ɐ m
கித்தார்	k ɪ t̪ː aː ɾ
கித்தில்	k ɪ t̪ː ɪ l
கின்னம்	k ɪ nː ɐ m
கின்னரம்	k ɪ nː ɐ ɾ ɐ m
கின்னிக்கோழி	k ɪ nː ɪ kː oː ɻ ɪ
கிபாயத்து	k ɪ b aː j ɐ t̪ː ʊ
கியானம்	k ɪ j aː n ɐ m
கியால்	k ɪ j aː l
கியாழம்	k ɪ j aː ɻ ɐ m
கிரககதி	k ɪ ɾ ɐ ɡ ɐ ɡ ɐ d̪ ɪ
கிரகபரிவிருத்தி	k ɪ ɾ ɐ ɡ ɐ b ɐ ɾ ɪ ʋ ɪ ɾ ʊ t̪ː ɪ
கிரகம்	k ɪ ɾ ɐ ɡ ɐ m
கிரகி	ɡ ɪ ɾ ɐ h ɪ
கிரகி	ɡ ɪ ɾ ɐ ɡ ɪ
கிரக்கம்	k ɪ ɾ ɐ kː ɐ m
கிரணம்	k ɪ ɾ ɐ ɳ ɐ m
கிரந்தம்	k ɪ ɾ ɐ n̪ d̪ ɐ m
கிரந்தம்	ɡ ɪ ɾ ɐ n̪ d̪ ɐ m
கிரமம்	k ɪ ɾ ɐ m ɐ m
கிரமேண	k ɪ ɾ ɐ m eː ɳ ɐ
கிரயம்	k ɪ ɾ ɐ j ɐ m
கிராமம்	k ɪ ɾ aː m ɐ m
கிராமம்	ɡ ɪ ɾ aː m ɐ m
கிராமம்	ɡ ɾ aː m ɐ m
கிராம்பு	k ɪ ɾ aː m b ʊ
கிரி	k ɪ ɾ ɪ
கிரீடம்	k ɪ ɾ iː ɖ ɐ m
கிருட்டிணன்	k ɪ ɾ ʊ ʈː ɪ ɳ ɐ n
கிருத்திரம்	k ɪ ɾ ʊ t̪ː ɪ ɾ ɐ m
கிருபை	k ɪ ɾ ʊ b ɐ ɪ̯
கிருமி	k ɪ ɾ ʊ m ɪ
கிருஷ்ணகிரி	k ɪ ɾ ʊ ʂ ɳ ɐ ɡ ɪ ɾ ɪ
கிரேக்கம்	ɡ ɪ ɾ eː kː ɐ m
கிறாம்பு	k ɪ r aː m b ʊ
கிறி	k ɪ r ɪ
கிறிஸ்து	k ɪ r ɪ s t̪ ʊ
கிறிஸ்துமஸ்	k ɪ r ɪ s t̪ ʊ m ɐ s
கிறுக்கு	k ɪ r ʊ kː ʊ
கிறுக்கு	ɡ ɪ r ʊ kː ʊ
கிற்பு	k ɪ r p ʊ
கில்	k ɪ l
கில்லாடி	k ɪ l l aː ɖ ɪ
கிளந்தான்	k ɪ ɭ ɐ n̪ d̪ aː n
கிளப்	k ɪ ɭ ɐ b
கிளப்	k ɪ ɭ ɐ p
கிளப்பு	k ɪ ɭ ɐ pː ʊ
கிளம்பினவேலை	k ɪ ɭ ɐ m b ɪ n ɐ ʋ eː l ɐ ɪ̯
கிளம்பு	k ɪ ɭ ɐ m b ʊ
கிளர்	k ɪ ɭ ɐ ɾ
கிளர்ச்சி	k ɪ ɭ ɐ ɾ t͡ɕː ɪ
கிளர்த்து	k ɪ ɭ ɐ ɾ t̪ː ʊ
கிளறு	k ɪ ɭ ɐ r ʊ
கிளவி	k ɪ ɭ ɐ ʋ ɪ
கிளி	k ɪ ɭ ɪ
கிளிமெண்டி	k ɪ ɭ ɪ m ɛ ɳ ɖ ɪ
கிளை	k ɪ ɭ ɐ ɪ̯
கிளைப்பு	k ɪ ɭ ɐ ɪ̯ pː ʊ
கிள்ளு	k ɪ ɭː ʊ
கிழக்கு	k ɪ ɻ ɐ kː ʊ
கிழக்குக்கணவாய்	k ɪ ɻ ɐ kː ʊ kː ɐ ɳ ɐ ʋ aː j
கிழங்கு	k ɪ ɻ ɐ ŋ ɡ ʊ
கிழமை	k ɪ ɻ ɐ m ɐ ɪ̯
கிழவன்	k ɪ ɻ ɐ ʋ ɐ n
கிழவி	k ɪ ɻ ɐ ʋ ɪ
கிழவு	k ɪ ɻ ɐ ʋ ʊ
கிழி	k ɪ ɻ ɪ
கிழிப்பு	k ɪ ɻ ɪ pː ʊ
கிஸ்மத்	k ɪ s m ɐ t̪
கீரை	k iː ɾ ɐ ɪ̯
கீர்த்தி	k iː ɾ t̪ː ɪ
கீறு	k iː r ʊ
கீலாரி	k iː l aː ɾ ɪ
கீழே	k iː ɻ eː
கீழ்	k iː ɻ
கீழ்காற்று	k iː ɻ ɡ aː rː ʊ
கீழ்ப்பாகம்	k iː ɻ pː aː ɡ ɐ m
கீழ்மை	k iː ɻ m ɐ ɪ̯
குகை	ɡ ʊ h ɐ ɪ̯
குங்கிலியம்	k ʊ ŋ ɡ ɪ l ɪ j ɐ m
குங்குமப்பூ	k ʊ ŋ ɡ ʊ m ɐ pː uː
குங்குமம்	k ʊ ŋ ɡ ʊ m ɐ m
குசராத்	k ʊ t͡ɕ ɐ ɾ aː t̪
குச்சி	k ʊ t͡ɕː ɪ
குச்சிப்புடி	k u t͡ɕː i pː u ɖ i
குஞ்சி	k ʊ ɲ d͡ʑ ɪ
குஞ்சு	k ʊ ɲ d͡ʑ ʊ
குடங்கர்	k ʊ ɖ ɐ ŋ ɡ ɐ ɾ
குடசப்பாலை	k ʊ ɖ ɐ t͡ɕ ɐ pː aː l ɐ ɪ̯
குடம்	k ʊ ɖ ɐ m
குடம்புளி	k ʊ ɖ ɐ m b ʊ ɭ ɪ
குடல்	k ʊ ɖ ɐ l
குடல்வால்	k ʊ ɖ ɐ l ʋ aː l
குடாரி	k ʊ ɖ aː ɾ ɪ
குடி	k ʊ ɖ ɪ
குடிசை	k ʊ ɖ ɪ t͡ɕ ɐ ɪ̯
குடிநீர்	k ʊ ɖ ɪ n̪ iː ɾ
குடிமகன்	k ʊ ɖ ɪ m ɐ ɡ ɐ n
குடியரசு	k ʊ ɖ ɪ j ɐ ɾ ɐ t͡ɕ ʊ
குடியிருப்பு	k ʊ ɖ ɪ j ɪ ɾ ʊ pː ʊ
குடியுரிமை	k ʊ ɖ ɪ j ʊ ɾ ɪ m ɐ ɪ̯
குடில்	k ʊ ɖ ɪ l
குடுமி	k ʊ ɖ ʊ m ɪ
குடும்பம்	k ʊ ɖ ʊ m b ɐ m
குடுவை	k ʊ ɖ ʊ ʋ ɐ ɪ̯
குடை	k ʊ ɖ ɐ ɪ̯
குட்டி	k ʊ ʈː ɪ
குட்டை	k ʊ ʈː ɐ ɪ̯
குணப்படு	k ʊ ɳ ɐ pː ɐ ɖ ʊ
குணம்	k ʊ ɳ ɐ m
குணிப்பு	k ʊ ɳ ɪ pː ʊ
குணிப்பெயர்	k ʊ ɳ ɪ pː ɛ j ɐ ɾ
குண்டம்	k ʊ ɳ ɖ ɐ m
குண்டி	k ʊ ɳ ɖ ɪ
குதி	k ʊ d̪ ɪ
குதி	ɡ ʊ d̪ ɪ
குதிரை	k ʊ d̪ ɪ ɾ ɐ ɪ̯
குதிரை	ɡ ʊ d̪ ɪ ɾ ɐ ɪ̯
குதிரைப்பந்தி	k ʊ d̪ ɪ ɾ ɐ ɪ̯ pː ɐ n̪ d̪ ɪ
குதிரைவாலி	k ʊ d̪ ɪ ɾ ɐ ɪ̯ ʋ aː l ɪ
குத்தகை	k ʊ t̪ː ɐ ɡ ɐ ɪ̯
குத்து	k ʊ t̪ː ʊ
குந்தம்	k ʊ n̪ d̪ ɐ m
குனி	k ʊ n ɪ
குன்றம்	k ʊ n r ɐ m
குன்றின்	k ʊ n r ɪ n
குன்றிமணி	k ʊ n r ɪ m ɐ ɳ ɪ
குன்று	k ʊ n r ʊ
குபுர்	k ʊ b ʊ ɾ
குபேரன்	k ʊ b eː ɾ ɐ n
குப்பம்	k ʊ pː ɐ m
குப்பி	k ʊ pː ɪ
குப்பை	k ʊ pː ɐ ɪ̯
குப்பைமேனி	k ʊ pː ɐ ɪ̯ m eː n ɪ
குமளி	k ʊ m ɐ ɭ ɪ
குமாரத்தி	k ʊ m aː ɾ ɐ t̪ː ɪ
குமாரன்	k ʊ m aː ɾ ɐ n
குமார்	k ʊ m aː ɾ
குமிழி	k ʊ m ɪ ɻ ɪ
கும்பகோணம்	k ʊ m b ɐ ɡ oː ɳ ɐ m
கும்பம்	k ʊ m b ɐ m
கும்பளம்	k ʊ m b ɐ ɭ ɐ m
கும்பி	k ʊ m b ɪ
கும்பிடு	k ʊ m b ɪ ɖ ʊ
கும்மாளம்	ɡ ʊ mː aː ɭ ɐ m
குயவன்	k ʊ j ɐ ʋ ɐ n
குயில்	k ʊ j ɪ l
குரங்கு	k ʊ ɾ ɐ ŋ ɡ ʊ
குரல்	k ʊ ɾ ɐ l
குரல்கள்	k ʊ ɾ ɐ l ɡ ɐ ɭ
குரல்வளை	k ʊ ɾ ɐ l ʋ ɐ ɭ ɐ ɪ̯
குரு	k ʊ ɾ ʊ
குரு	ɡ ʊ ɾ ʊ
குருகுலம்	ɡ u ɾ̪ u k u l̪ a m
குருகுலம்	ɡ ʊ ɾ̪ ʊ k ʊ l̪ ə m
குருசு	k u ɾ u s u
குருடன்	k ʊ ɾ ʊ ɖ ɐ n
குருடு	k ʊ ɾ ʊ ɖ ʊ
குருட்டுக்கொக்கு	k ʊ ɾ ʊ ʈː ʊ kː ɔ kː ʊ
குருட்டுத்தனம்	k ʊ ɾ ʊ ʈː ʊ t̪ː ɐ n ɐ m
குருணாகல்	k ʊ ɾ ʊ ɳ aː ɡ ɐ l
குருதி	k ʊ ɾ ʊ d̪ ɪ
குருத்து	k ʊ ɾ ʊ t̪ː ʊ
குருத்துவம்	k ʊ ɾ ʊ t̪ː ʊ ʋ ɐ m
குருத்தெலும்பு	k ʊ ɾ ʊ t̪ː ɛ l ʊ m b ʊ
குருத்தோலை	k ʊ ɾ ʊ t̪ː oː l ɐ ɪ̯
குருத்தோலைஞாயிறு	k ʊ ɾ ʊ t̪ː oː l ɐ ɪ̯ ɲ aː j ɪ r ʊ
குரும்பை	k ʊ ɾ ʊ m b ɐ ɪ̯
குருவி	k ʊ ɾ ʊ ʋ ɪ
குருவிரசு	k ʊ ɾ ʊ ʋ ɪ ɾ ɐ t͡ɕ ʊ
குறங்கு	k ʊ r ɐ ŋ ɡ ʊ
குறட்டை	k ʊ r ɐ ʈː ɐ ɪ̯
குறி	k ʊ r ɪ
குறிக்கோள்	k ʊ r ɪ kː oː ɭ
குறித்து	k ʊ r ɪ t̪ː ʊ
குறிப்பிடம்	k ʊ r ɪ pː ɪ ɖ ɐ m
குறிப்பு	k ʊ r ɪ pː ʊ
குறியீடு	k ʊ r ɪ j iː ɖ ʊ
குறில்	k ʊ r ɪ l
குறு	k ʊ r ʊ
குறுகிய	k ʊ r ʊ ɡ ɪ j ɐ
குறுகு	k ʊ r ʊ ɡ ʊ
குறுக்கம்	k ʊ r ʊ kː ɐ m
குறுந்தொகை	k ʊ r ʊ n̪ d̪ ɔ ɡ ɐ ɪ̯
குறுமை	k ʊ r ʊ m ɐ ɪ̯
குறை	k ʊ r ɐ ɪ̯
குறைக்கடத்தி	k ʊ r ɐ ɪ̯ kː ɐ ɖ ɐ t̪ː ɪ
குறைநாள்	k ʊ r ɐ ɪ̯ n̪ aː ɭ
குறைபடு	k ʊ r ɐ ɪ̯ b ɐ ɖ ʊ
குறைபாடு	k ʊ r ɐ ɪ̯ b aː ɖ ʊ
குறைவு	k ʊ r ɐ ɪ̯ ʋ ʊ
குற்றங்கள்	k ʊ rː ɐ ŋ ɡ ɐ ɭ
குற்றச்சாட்டு	k ʊ rː ɐ t͡ɕː aː ʈː ʊ
குற்றம்	k ʊ rː ɐ m
குற்றி	k ʊ rː ɪ
குற்றியலிகரம்	k ʊ rː ɪ j ɐ l ɪ ɡ ɐ ɾ ɐ m
குற்றியலுகரம்	k ʊ rː ɪ j ɐ l ʊ ɡ ɐ ɾ ɐ m
குற்று	k ʊ rː ʊ
குற்றெழுத்து	k ʊ rː ɛ ɻ ʊ t̪ː ʊ
குலம்	k ʊ l ɐ m
குலவரி	k ʊ l ɐ ʋ ɐ ɾ ɪ
குலிகம்	k ʊ l ɪ ɡ ɐ m
குலுக்கு	k ʊ l ʊ kː ʊ
குலுங்கு	k ʊ l ʊ ŋ ɡ ʊ
குலை	k ʊ l ɐ ɪ̯
குலோத்துங்க	k ʊ l oː t̪ː ʊ ŋ ɡ ɐ
குலோத்துங்கன்	k ʊ l oː t̪ː ʊ ŋ ɡ ɐ n
குல்ஃபி	ɡ ʊ l f ɪ
குல்லா	k ʊ l l aː
குல்லா	ɡ ʊ l l aː
குளம்	k ʊ ɭ ɐ m
குளம்பி	k ʊ ɭ ɐ m b ɪ
குளறியடி	k ʊ ɭ ɐ r ɪ j ɐ ɖ ɪ
குளவி	k ʊ ɭ ɐ ʋ ɪ
குளி	k ʊ ɭ ɪ
குளிப்பு	k ʊ ɭ ɪ pː ʊ
குளியல்	k ʊ ɭ ɪ j ɐ l
குளியாள்	k ʊ ɭ ɪ j aː ɭ
குளிர்	k ʊ ɭ ɪ ɾ
குளிர்களி	k ʊ ɭ ɪ ɾ ɡ ɐ ɭ ɪ
குளிர்ச்சி	k ʊ ɭ ɪ ɾ t͡ɕː ɪ
குளிர்ப்பு	k ʊ ɭ ɪ ɾ pː ʊ
குளிர்மை	k ʊ ɭ ɪ ɾ m ɐ ɪ̯
குள்ளமான	k ʊ ɭː ɐ m aː n ɐ
குள்ளம்	k ʊ ɭː ɐ m
குழந்தை	k ʊ ɻ ɐ n̪ d̪ ɐ ɪ̯
குழப்பம்	k ʊ ɻ ɐ pː ɐ m
குழப்புதல்	k ʊ ɻ ɐ pː ʊ d̪ ɐ l
குழம்பு	k ʊ ɻ ɐ m b ʊ
குழம்புதல்	k ʊ ɻ ɐ m b ʊ d̪ ɐ l
குழல்	k ʊ ɻ ɐ l
குழவி	k ʊ ɻ ɐ ʋ ɪ
குழாய்	k ʊ ɻ aː j
குழி	k ʊ ɻ ɪ
குழிக்கரண்டி	k ʊ ɻ ɪ kː ɐ ɾ ɐ ɳ ɖ ɪ
குழிங்கை	k ʊ ɻ ɪ ŋ ɡ ɐ ɪ̯
குழிசி	k ʊ ɻ ɪ t͡ɕ ɪ
குழிவு	k ʊ ɻ ɪ ʋ ʊ
குழுவல்	k ʊ ɻ ʊ ʋ ɐ l
குழை	k ʊ ɻ ɐ ɪ̯
குழைச்சு	k ʊ ɻ ɐ ɪ̯ t͡ɕː ʊ
குழைவு	k ʊ ɻ ɐ ɪ̯ ʋ ʊ
குவளை	k ʊ ʋ ɐ ɭ ɐ ɪ̯
குவார்ட்சு	k ʊ ʋ aː ɾ ʈ t͡ɕ ʊ
குவி	k ʊ ʋ ɪ
குவியம்	k ʊ ʋ ɪ j ɐ m
குவியல்	k ʊ ʋ ɪ j ɐ l
கூகை	k uː ɡ ɐ ɪ̯
கூசு	k uː t͡ɕ ʊ
கூட	k uː ɖ ɐ
கூடம்	k uː ɖ ɐ m
கூடாரத்தில்	k uː ɖ aː ɾ ɐ t̪ː ɪ l
கூடாரம்	k uː ɖ aː ɾ ɐ m
கூடு	k uː ɖ ʊ
கூடை	k uː ɖ ɐ ɪ̯
கூடைப்பந்து	k uː ɖ ɐ ɪ̯ pː ɐ n̪ d̪ ʊ
கூட்டம்	k uː ʈː ɐ m
கூட்டரவு	k uː ʈː ɐ ɾ ɐ ʋ ʊ
கூட்டர்	k uː ʈː ɐ ɾ
கூட்டல்	k uː ʈː ɐ l
கூட்டாளி	k uː ʈː aː ɭ ɪ
கூட்டு	k uː ʈː ʊ
கூட்டுறவு	k uː ʈː ʊ r ɐ ʋ ʊ
கூட்டெழுத்து	k uː ʈː ɛ ɻ ʊ t̪ː ʊ
கூத்தன்	k uː t̪ː ɐ n
கூத்தாட	k uː t̪ː aː ɖ ɐ
கூத்தாடு	k uː t̪ː aː ɖ ʊ
கூத்தி	k uː t̪ː ɪ
கூத்து	k uː t̪ː ʊ
கூனைப்பூ	k uː n ɐ ɪ̯ pː uː
கூப்பிடு	k uː pː ɪ ɖ ʊ
கூம்பல்	k uː m b ɐ l
கூரல்	ɡ uː ɾ ɐ l
கூரை	k uː ɾ ɐ ɪ̯
கூரைவீடு	k uː ɾ ɐ ɪ̯ ʋ iː ɖ ʊ
கூர்மம்	k uː ɾ m ɐ m
கூர்மை	k uː ɾ m ɐ ɪ̯
கூறு	k uː r ʊ
கூறை	k uː r ɐ ɪ̯
கூற்று	k uː rː ʊ
கூலம்	k uː l ɐ m
கூலி	k uː l ɪ
கூளி	k uː ɭ ɪ
கூழ்	k uː ɻ
கூழ்முன்னை	k uː ɻ m ʊ nː ɐ ɪ̯
கெஞ்சு	k ɛ ɲ d͡ʑ ʊ
கெடா	k ɛ ɖ aː
கெடு	k ɛ ɖ ʊ
கெட்ட	k ɛ ʈː ɐ
கெட்டம்	k ɛ ʈː ɐ m
கெட்டி	k ɛ ʈː ɪ
கெட்டு	k ɛ ʈː ʊ
கெண்டை	k ɛ ɳ ɖ ɐ ɪ̯
கெய்ரோ	k ɛ j ɾ oː
கெளதம்	k ɛ ɭ ɐ d̪ ɐ m
கெழு	k ɛ ɻ ʊ
கேசரி	k eː t͡ɕ ɐ ɾ ɪ
கேசரியாசனம்	k eː t͡ɕ ɐ ɾ ɪ j aː t͡ɕ ɐ n ɐ m
கேடு	k eː ɖ ʊ
கேதகை	k eː d̪ ɐ ɡ ɐ ɪ̯
கேதுரு	k eː d̪ ʊ ɾ ʊ
கேத்துல்	k eː t̪ː ʊ l
கேந்திரம்	k eː n̪ d̪ ɪ ɾ ɐ m
கேரளம்	k eː ɾ ɐ ɭ ɐ m
கேரளா	k eː ɾ ɐ ɭ aː
கேள்	k eː ɭ
கேள்வி	k eː ɭ ʋ ɪ
கேள்விகள்	k eː ɭ ʋ ɪ ɡ ɐ ɭ
கேள்விக்குறி	k eː ɭ ʋ ɪ kː ʊ r ɪ
கேள்விப்படு	k eː ɭ ʋ ɪ pː ɐ ɖ ʊ
கேழ்வரகு	k eː ɻ ʋ ɐ ɾ ɐ ɡ ʊ
கை	k ɐ ɪ̯
கைக்கடிகாரம்	k ɐ ɪ̯ kː ɐ ɖ ɪ ɡ aː ɾ ɐ m
கைது	k ɐ ɪ̯ d̪ ʊ
கைப்பிடி	k ɐ ɪ̯ pː ɪ ɖ ɪ
கைப்பு	k ɐ ɪ̯ pː ʊ
கைப்பை	k ɐ ɪ̯ pː ɐ ɪ̯
கைம்மூலம்	k ɐ ɪ̯ mː uː l ɐ m
கையறுநிலை	k ɐ ɪ̯ j ɐ r ʊ n̪ ɪ l ɐ ɪ̯
கையூட்டு	k ɐ ɪ̯ j uː ʈː ʊ
கைலி	k ɐ ɪ̯ l ɪ
கைவேலை	k ɐ ɪ̯ ʋ eː l ɐ ɪ̯
கொக்கிஸ்	k ɔ kː ɪ s
கொக்கு	k ɔ kː ʊ
கொக்குமந்தாரை	k ɔ kː ʊ m ɐ n̪ d̪ aː ɾ ɐ ɪ̯
கொங்கு	k ɔ ŋ ɡ ʊ
கொசு	k ɔ t͡ɕ ʊ
கொஞ்சம்	k ɔ ɲ d͡ʑ ɐ m
கொஞ்சு	k ɔ ɲ d͡ʑ ʊ
கொடி	k ɔ ɖ ɪ
கொடிக்கையான்	k ɔ ɖ ɪ kː ɐ ɪ̯ j aː n
கொடிச்சீலை	k ɔ ɖ ɪ t͡ɕː iː l ɐ ɪ̯
கொடிப்பாசி	k ɔ ɖ ɪ pː aː t͡ɕ ɪ
கொடிமுந்திரி	k ɔ ɖ ɪ m ʊ n̪ d̪ ɪ ɾ ɪ
கொடு	k ɔ ɖ ʊ
கொடுந்தமிழ்	k ɔ ɖ ʊ n̪ d̪ ɐ m ɪ ɻ
கொடுந்தலைப்பொருவா	k ɔ ɖ ʊ n̪ d̪ ɐ l ɐ ɪ̯ pː ɔ ɾ ʊ ʋ aː
கொடுப்பு	k ɔ ɖ ʊ pː ʊ
கொடுப்புப்பல்	k ɔ ɖ ʊ pː ʊ pː ɐ l
கொடுமரம்	k ɔ ɖ ʊ m ɐ ɾ ɐ m
கொடுமுடி	k ɔ ɖ ʊ m ʊ ɖ ɪ
கொடுமை	k ɔ ɖ ʊ m ɐ ɪ̯
கொடும்பகல்	k ɔ ɖ ʊ m b ɐ ɡ ɐ l
கொடும்பாடு	k ɔ ɖ ʊ m b aː ɖ ʊ
கொடும்புலி	k ɔ ɖ ʊ m b ʊ l ɪ
கொடும்பை	k ɔ ɖ ʊ m b ɐ ɪ̯
கொடுவாள்	k ɔ ɖ ʊ ʋ aː ɭ
கொடுவேலி	k ɔ ɖ ʊ ʋ eː l ɪ
கொடூரம்	k ɔ ɖ uː ɾ ɐ m
கொடை	k ɔ ɖ ɐ ɪ̯
கொடைமை	k ɔ ɖ ɐ ɪ̯ m ɐ ɪ̯
கொட்டகை	k ɔ ʈː ɐ ɡ ɐ ɪ̯
கொட்டாவி	k ɔ ʈː aː ʋ ɪ
கொட்டு	k ɔ ʈː ʊ
கொட்டை	k ɔ ʈː ɐ ɪ̯
கொட்டையிலந்தை	k ɔ ʈː ɐ ɪ̯ j ɪ l ɐ n̪ d̪ ɐ ɪ̯
கொண்டபாடு	k ɔ ɳ ɖ ɐ b aː ɖ ʊ
கொண்டலாத்தி	k ɔ ɳ ɖ ɐ l aː t̪ː ɪ
கொண்டல்	k ɔ ɳ ɖ ɐ l
கொண்டவன்	k ɔ ɳ ɖ ɐ ʋ ɐ n
கொண்டாடு	k ɔ ɳ ɖ aː ɖ ʊ
கொண்டாட்டம்	k ɔ ɳ ɖ aː ʈː ɐ m
கொண்டாட்டு	k ɔ ɳ ɖ aː ʈː ʊ
கொண்டி	k ɔ ɳ ɖ ɪ
கொண்டியம்	k ɔ ɳ ɖ ɪ j ɐ m
கொண்டு	k ɔ ɳ ɖ ʊ
கொண்டுகூற்று	k ɔ ɳ ɖ ʊ ɡ uː rː ʊ
கொண்டுபோ	k ɔ ɳ ɖ ʊ b oː
கொண்டை	k ɔ ɳ ɖ ɐ ɪ̯
கொத்தமல்லி	k ɔ t̪ː ɐ m ɐ l l ɪ
கொந்தர்	k ɔ n̪ d̪ ɐ ɾ
கொந்தளம்	k ɔ n̪ d̪ ɐ ɭ ɐ m
கொந்தளி	k ɔ n̪ d̪ ɐ ɭ ɪ
கொம்பி	k ɔ m b ɪ
கொம்பு	k ɔ m b ʊ
கொம்மட்டி	k ɔ mː ɐ ʈː ɪ
கொய்	k ɔ j
கொய்யா	k ɔ jː aː
கொய்யா	ɡ ɔ jː aː
கொரோனா	k ɔ ɾ oː n aː
கொறி	k ɔ r ɪ
கொறுக்கை	k ɔ r ʊ kː ɐ ɪ̯
கொற்றம்	k ɔ rː ɐ m
கொற்றவை	k ɔ rː ɐ ʋ ɐ ɪ̯
கொலுசு	k o l ɯ s ɯ
கொலுசு	k ɔ l ʊ t͡ɕ ʊ
கொலுசு	ɡ o l ɯ s ɯ
கொலுசு	ɡ ɔ l ʊ t͡ɕ ʊ
கொலை	k ɔ l ɐ ɪ̯
கொல்	k ɔ l
கொல்லன்	k ɔ l l ɐ n
கொல்லன்பட்டடை	k ɔ l l ɐ n b ɐ ʈː ɐ ɖ ɐ ɪ̯
கொல்லன்பட்டரை	k ɔ l l ɐ n b ɐ ʈː ɐ ɾ ɐ ɪ̯
கொல்லம்	k ɔ l l ɐ m
கொல்லறு	k ɔ l l ɐ r ʊ
கொல்லற்றுவேலை	k ɔ l l ɐ rː ʊ ʋ eː l ɐ ɪ̯
கொளுவி	k ɔ ɭ ʊ ʋ ɪ
கொள்	k ɔ ɭ
கொள்கை	k ɔ ɭ ɡ ɐ ɪ̯
கொள்முதல்	k ɔ ɭ m ʊ d̪ ɐ l
கொள்ள	k ɔ ɭː ɐ
கொள்ளை	k ɔ ɭː ɐ ɪ̯
கொள்வனை	k ɔ ɭ ʋ ɐ n ɐ ɪ̯
கொழகொழ	k o ɻ ɐ k o ɻ ɐ
கொழி	k ɔ ɻ ɪ
கொழுக்கட்டை	k ɔ ɻ ʊ kː ɐ ʈː ɐ ɪ̯
கொழுத்தமுரல்	k ɔ ɻ ʊ t̪ː ɐ m ʊ ɾ ɐ l
கொழுப்பு	k ɔ ɻ ʊ pː ʊ
கொழும்பு	k ɔ ɻ ʊ m b ʊ
கோ	k oː
கோசம்	k oː t͡ɕ ɐ m
கோடகசாலை	k oː ɖ ɐ ɡ ɐ t͡ɕ aː l ɐ ɪ̯
கோடரி	k oː ɖ ɐ ɾ ɪ
கோடர்	k oː ɖ ɐ ɾ
கோடாலி	k oː ɖ aː l ɪ
கோடி	k oː ɖ ɪ
கோடிமுனை	k oː ɖ ɪ m ʊ n ɐ ɪ̯
கோடு	k oː ɖ ʊ
கோடை	k oː ɖ ɐ ɪ̯
கோட்டம்	k oː ʈː ɐ m
கோட்டயம்	k oː ʈː ɐ j ɐ m
கோட்டான்	k oː ʈː aː n
கோட்டை	k oː ʈː ɐ ɪ̯
கோட்டைப்போர்	k oː ʈː ɐ ɪ̯ pː oː ɾ
கோட்பாடு	k oː ʈ p aː ɖ ʊ
கோணங்கி	k oː ɳ ɐ ŋ ɡ ɪ
கோணம்	k oː ɳ ɐ m
கோணவியல்	k oː ɳ ɐ ʋ ɪ j ɐ l
கோணு	k oː ɳ ʊ
கோதாவரி	k oː d̪ aː ʋ ɐ ɾ ɪ
கோதுமை	k oː d̪ ʊ m ɐ ɪ̯
கோந்து	k oː n̪ d̪ ʊ
கோந்து	ɡ oː n̪ d̪ ʊ
கோனான்	k oː n aː n
கோன்	k oː n
கோபம்	k oː b ɐ m
கோபாலன்	k oː b aː l ɐ n
கோபி	k oː b ɪ
கோபுரம்	k oː b ʊ ɾ ɐ m
கோப்பு	k oː pː ʊ
கோப்பை	k oː pː ɐ ɪ̯
கோமான்	k oː m aː n
கோமாளி	k oː m aː ɭ ɪ
கோமி	k oː m ɪ
கோமுகம்	k oː m ʊ ɡ ɐ m
கோமுகாசனம்	k oː m ʊ ɡ aː t͡ɕ ɐ n ɐ m
கோமேதகம்	k oː m eː d̪ ɐ ɡ ɐ m
கோயம்புத்தூர்	k oː j ɐ m b ʊ t̪ː uː ɾ
கோயில்	k oː j ɪ l
கோரிக்கை	k oː ɾ ɪ kː ɐ ɪ̯
கோரை	k oː ɾ ɐ ɪ̯
கோலம்	k oː l ɐ m
கோலாலம்பூர்	k oː l aː l ɐ m b uː ɾ
கோலுமை	k oː l ʊ m ɐ ɪ̯
கோலெழுத்து	k oː l ɛ ɻ ʊ t̪ː ʊ
கோல்	k oː l
கோளாறு	k oː ɭ aː r ʊ
கோள்	k oː ɭ
கோழி	k oː ɻ ɪ
கோழிகள்	k oː ɻ ɪ ɡ ɐ ɭ
கோழிக்கோடு	k oː ɻ ɪ kː oː ɖ ʊ
கோழை	k oː ɻ ɐ ɪ̯
கோவசூரி	k oː ʋ ɐ t͡ɕ uː ɾ ɪ
கோவணம்	k oː ʋ ɐ ɳ ɐ m
கோவல்	k oː ʋ ɐ l
கோவா	ɡ oː ʋ aː
கோவிந்தன்	k oː ʋ ɪ n̪ d̪ ɐ n
கோவில்	k oː ʋ ɪ l
கோவைக்காய்	k oː ʋ ɐ ɪ̯ kː aː j
கௌதாரி	k ɐ ʊ̯ d̪ aː ɾ ɪ
கௌதூகலம்	k ɐ ʊ̯ d̪ uː ɡ ɐ l ɐ m
கௌரவம்	ɡ ɐ ʊ̯ ɾ ɐ ʋ ɐ m
கௌளி	k ɐ ʊ̯ ɭ ɪ
க்	i k
க்	i kː ɯ
க்	k
க்ஷ	k ʂ ɐ
க்ஷணம்	k ʂ ɐ ɳ ɐ m
க்ஷிரஸமுத்ரம்	k ʂ ɪ ɾ ɐ s ɐ m ʊ t̪ ɾ ɐ m
க்ஷீணம்	k ʂ iː ɳ ɐ m
க்ஷேத்திரம்	k ʂ eː t̪ː ɪ ɾ ɐ m
க்ஷேமம்	k ʂ eː m ɐ m
க்ஷ்	k ʂ
ங	ŋ ɐ
ங்	i ŋ ɡ
ங்	i ŋ ɡ ɯ
ங்	ŋ
ச	t͡ɕ ɐ
சகசரி	t͡ɕ ɐ ɡ ɐ t͡ɕ ɐ ɾ ɪ
சகதி	t͡ɕ ɐ ɡ ɐ d̪ ɪ
சகரியா	t͡ɕ ɐ ɡ ɐ ɾ ɪ j aː
சகி	t͡ɕ ɐ ɡ ɪ
சகிப்பு	t͡ɕ ɐ ɡ ɪ pː ʊ
சகோ	t͡ɕ ɐ ɡ oː
சகோதரன்	t͡ɕ ɐ ɡ oː d̪ ɐ ɾ ɐ n
சகோதரி	t͡ɕ ɐ ɡ oː d̪ ɐ ɾ ɪ
சக்கரை	t͡ɕ ɐ kː ɐ ɾ ɐ ɪ̯
சக்கை	t͡ɕ ɐ kː ɐ ɪ̯
சக்தி	t͡ɕ ɐ k t̪ ɪ
சங்கடம்	t͡ɕ ɐ ŋ ɡ ɐ ɖ ɐ m
சங்கத்தமிழ்	t͡ɕ ɐ ŋ ɡ ɐ t̪ː ɐ m ɪ ɻ
சங்கம்	t͡ɕ ɐ ŋ ɡ ɐ m
சங்கரன்	t͡ɕ ɐ ŋ ɡ ɐ ɾ ɐ n
சங்கிரகம்	t͡ɕ ɐ ŋ ɡ ɪ ɾ ɐ ɡ ɐ m
சங்கிரகி	t͡ɕ ɐ ŋ ɡ ɪ ɾ ɐ ɡ ɪ
சங்கீதம்	t͡ɕ ɐ ŋ ɡ iː d̪ ɐ m
சசம்	t͡ɕ ɐ t͡ɕ ɐ m
சச்சம்	t͡ɕ ɐ t͡ɕː ɐ m
சஞ்சலம்	t͡ɕ ɐ ɲ d͡ʑ ɐ l ɐ m
சடங்கு	t͡ɕ ɐ ɖ ɐ ŋ ɡ ʊ
சடத்துவம்	t͡ɕ ɐ ɖ ɐ t̪ː ʊ ʋ ɐ m
சடாலம்	t͡ɕ ɐ ɖ aː l ɐ m
சடுதி	t͡ɕ ɐ ɖ ʊ d̪ ɪ
சடுத்தம்	t͡ɕ ɐ ɖ ʊ t̪ː ɐ m
சடை	t͡ɕ ɐ ɖ ɐ ɪ̯
சடையன்	t͡ɕ ɐ ɖ ɐ ɪ̯ j ɐ n
சட்டசபை	t͡ɕ ɐ ʈː ɐ t͡ɕ ɐ b ɐ ɪ̯
சட்டதிட்டம்	t͡ɕ ɐ ʈː ɐ d̪ ɪ ʈː ɐ m
சட்டமன்றம்	t͡ɕ ɐ ʈː ɐ m ɐ n r ɐ m
சட்டம்	t͡ɕ ɐ ʈː ɐ m
சட்டம்பி	t͡ɕ ɐ ʈː ɐ m b ɪ
சட்டி	t͡ɕ ɐ ʈː ɪ
சட்டை	t͡ɕ ɐ ʈː ɐ ɪ̯
சட்னி	t͡ɕ ɐ ʈ n ɪ
சணல்	t͡ɕ ɐ ɳ ɐ l
சண்டிகர்	t͡ɕ ɐ ɳ ɖ ɪ ɡ ɐ ɾ
சண்டை	t͡ɕ ɐ ɳ ɖ ɐ ɪ̯
சதம்	t͡ɕ ɐ d̪ ɐ m
சதா	t͡ɕ ɐ d̪ aː
சதாசிவன்	t͡ɕ ɐ d̪ aː t͡ɕ ɪ ʋ ɐ n
சதுரங்கம்	t͡ɕ ɐ d̪ ʊ ɾ ɐ ŋ ɡ ɐ m
சதுரம்	t͡ɕ ɐ d̪ ʊ ɾ ɐ m
சதுர்முகன்	t͡ɕ ɐ d̪ ʊ ɾ m ʊ ɡ ɐ n
சதுர்யுகம்	t͡ɕ ɐ d̪ ʊ ɾ j ʊ ɡ ɐ m
சதுர்வருணம்	t͡ɕ ɐ d̪ ʊ ɾ ʋ ɐ ɾ ʊ ɳ ɐ m
சதை	t͡ɕ ɐ d̪ ɐ ɪ̯
சத்தம்	t͡ɕ ɐ t̪ː ɐ m
சத்தாகம்	t͡ɕ ɐ t̪ː aː ɡ ɐ m
சத்தி	t͡ɕ ɐ t̪ː ɪ
சத்தியம்	t͡ɕ ɐ t̪ː ɪ j ɐ m
சத்திரம்	t͡ɕ ɐ t̪ː ɪ ɾ ɐ m
சத்தீசுகர்	t͡ɕ ɐ t̪ː iː t͡ɕ ʊ ɡ ɐ ɾ
சத்து	t͡ɕ ɐ t̪ː ʊ
சத்துரு	t͡ɕ ɐ t̪ː ʊ ɾ ʊ
சந்தனம்	t͡ɕ ɐ n̪ d̪ ɐ n ɐ m
சந்தர்ப்பம்	t͡ɕ ɐ n̪ d̪ ɐ ɾ pː ɐ m
சந்தா	t͡ɕ ɐ n̪ d̪ aː
சந்தாதாரர்	t͡ɕ ɐ n̪ d̪ aː d̪ aː ɾ ɐ ɾ
சந்திப்பு	t͡ɕ ɐ n̪ d̪ ɪ pː ʊ
சந்திரசேகரன்	t͡ɕ ɐ n̪ d̪ ɪ ɾ ɐ t͡ɕ eː ɡ ɐ ɾ ɐ n
சந்திரன்	t͡ɕ ɐ n̪ d̪ ɪ ɾ ɐ n
சந்திரப்பிரபை	t͡ɕ ɐ n̪ d̪ ɪ ɾ ɐ pː ɪ ɾ ɐ b ɐ ɪ̯
சந்திராதபம்	t͡ɕ ɐ n̪ d̪ ɪ ɾ aː d̪ ɐ b ɐ m
சந்து	t͡ɕ ɐ n̪ d̪ ʊ
சந்தை	t͡ɕ ɐ n̪ d̪ ɐ ɪ̯
சந்தோஷம்	t͡ɕ ɐ n̪ d̪ oː ʂ ɐ m
சனவரி	t͡ɕ ɐ n ɐ ʋ ɐ ɾ ɪ
சனி	t͡ɕ ɐ n ɪ
சனிக்கிழமை	t͡ɕ ɐ n ɪ kː ɪ ɻ ɐ m ɐ ɪ̯
சன்மார்க்கம்	t͡ɕ ɐ n m aː ɾ kː ɐ m
சபதம்	t͡ɕ ɐ b ɐ d̪ ɐ m
சபா	t͡ɕ ɐ b aː
சபாத்தியட்சன்	t͡ɕ ɐ b aː t̪ː ɪ j ɐ ʈ t͡ɕ ɐ n
சபாமூப்பன்	t͡ɕ ɐ b aː m uː pː ɐ n
சபி	t͡ɕ ɐ b ɪ
சபை	t͡ɕ ɐ b ɐ ɪ̯
சப்பங்கி	t͡ɕ ɐ pː ɐ ŋ ɡ ɪ
சப்பாத்தி	t͡ɕ ɐ pː aː t̪ː ɪ
சப்பாத்து	t͡ɕ ɐ pː aː t̪ː ʊ
சப்போட்டா	t͡ɕ ɐ pː oː ʈː aː
சப்ரகமுவ	t͡ɕ ɐ p ɾ ɐ ɡ ɐ m ʊ ʋ ɐ
சமசுகிருதம்	t͡ɕ ɐ m ɐ t͡ɕ ʊ ɡ ɪ ɾ ʊ d̪ ɐ m
சமம்	t͡ɕ ɐ m ɐ m
சமயம்	t͡ɕ ɐ m ɐ j ɐ m
சமர்ப்பணம்	t͡ɕ ɐ m ɐ ɾ pː ɐ ɳ ɐ m
சமர்ப்பி	t͡ɕ ɐ m ɐ ɾ pː ɪ
சமவெளி	t͡ɕ ɐ m ɐ ʋ ɛ ɭ ɪ
சமஸ்கிருதம்	t͡ɕ ɐ m ɐ s k ɪ ɾ ʊ d̪ ɐ m
சமாதானம்	t͡ɕ ɐ m aː d̪ aː n ɐ m
சமீபம்	t͡ɕ ɐ m iː b ɐ m
சமுதாயச்சீர்திருத்தம்	t͡ɕ ɐ m ʊ d̪ aː j ɐ t͡ɕː iː ɾ d̪ ɪ ɾ ʊ t̪ː ɐ m
சமுதாயம்	t͡ɕ ɐ m ʊ d̪ aː j ɐ m
சமுத்திரம்	t͡ɕ ɐ m ʊ t̪ː ɪ ɾ ɐ m
சமூகம்	t͡ɕ ɐ m uː ɡ ɐ m
சமை	t͡ɕ ɐ m ɐ ɪ̯
சமைவு	t͡ɕ ɐ m ɐ ɪ̯ ʋ ʊ
சமோசா	t͡ɕ ɐ m oː t͡ɕ aː
சம்சாரம்	t͡ɕ ɐ m t͡ɕ aː ɾ ɐ m
சம்பகம்	t͡ɕ ɐ m b ɐ ɡ ɐ m
சம்பங்கி	t͡ɕ ɐ m b ɐ ŋ ɡ ɪ
சம்பளம்	t͡ɕ ɐ m b ɐ ɭ ɐ m
சம்பவம்	t͡ɕ ɐ m b ɐ ʋ ɐ m
சம்பவி	t͡ɕ ɐ m b ɐ ʋ ɪ
சம்பா	t͡ɕ ɐ m b aː
சம்பாதி	t͡ɕ ɐ m b aː d̪ ɪ
சம்பிரமம்	t͡ɕ ɐ m b ɪ ɾ ɐ m ɐ m
சம்புநாவல்	t͡ɕ ɐ m b ʊ n̪ aː ʋ ɐ l
சம்மட்டி	t͡ɕ ɐ mː ɐ ʈː ɪ
சயிக்கம்	t͡ɕ ɐ j ɪ kː ɐ m
சயிந்தவம்	t͡ɕ ɐ j ɪ n̪ d̪ ɐ ʋ ɐ m
சரக்கு	t͡ɕ ɐ ɾ ɐ kː ʊ
சரக்கொன்றை	t͡ɕ ɐ ɾ ɐ kː ɔ n r ɐ ɪ̯
சரணம்	t͡ɕ ɐ ɾ ɐ ɳ ɐ m
சரணியன்	t͡ɕ ɐ ɾ ɐ ɳ ɪ j ɐ n
சரண்	t͡ɕ ɐ ɾ ɐ ɳ
சரண்புகு	t͡ɕ ɐ ɾ ɐ ɳ b ʊ ɡ ʊ
சரபத்து	t͡ɕ ɐ ɾ ɐ b ɐ t̪ː ʊ
சரவாக்	t͡ɕ ɐ ɾ ɐ ʋ aː k
சரி	t͡ɕ ɐ ɾ ɪ
சரித்திரகாரன்	t͡ɕ ɐ ɾ ɪ t̪ː ɪ ɾ ɐ ɡ aː ɾ ɐ n
சரித்திரம்	t͡ɕ ɐ ɾ ɪ t̪ː ɪ ɾ ɐ m
சரிவு	t͡ɕ ɐ ɾ ɪ ʋ ʊ
சருமம்	t͡ɕ ɐ ɾ ʊ m ɐ m
சருவம்	t͡ɕ ɐ ɾ ʊ ʋ ɐ m
சர்க்கரை	t͡ɕ ɐ ɾ kː ɐ ɾ ɐ ɪ̯
சர்ச்சை	t͡ɕ ɐ ɾ t͡ɕː ɐ ɪ̯
சர்பராஜ்	t͡ɕ ɐ ɾ b ɐ ɾ aː d͡ʑ
சர்ப்பம்	t͡ɕ ɐ ɾ pː ɐ m
சர்வத்திர	t͡ɕ ɐ ɾ ʋ ɐ t̪ː ɪ ɾ ɐ
சற்பிரசாதம்	t͡ɕ ɐ r p ɪ ɾ ɐ t͡ɕ aː d̪ ɐ m
சலகம்	t͡ɕ ɐ l ɐ ɡ ɐ m
சலங்கு	t͡ɕ ɐ l ɐ ŋ ɡ ʊ
சலதோசம்	t͡ɕ ɐ l ɐ d̪ oː t͡ɕ ɐ m
சலவைக்காரர்	t͡ɕ ɐ l ɐ ʋ ɐ ɪ̯ kː aː ɾ ɐ ɾ
சல்லடை	t͡ɕ ɐ l l ɐ ɖ ɐ ɪ̯
சல்லரி	t͡ɕ ɐ l l ɐ ɾ ɪ
சல்லி	t͡ɕ ɐ l l ɪ
சளி	t͡ɕ ɐ ɭ ɪ
சவம்	t͡ɕ ɐ ʋ ɐ m
சவால்	t͡ɕ ɐ ʋ aː l
சவுக்கு	t͡ɕ ɐ ʋ ʊ kː ʊ
சவுத்து	t͡ɕ ɐ ʋ ʊ t̪ː ʊ
சவை	t͡ɕ ɐ ʋ ɐ ɪ̯
சவ்வரிசி	t͡ɕ ɐ ʋː ɐ ɾ ɪ t͡ɕ ɪ
சா	t͡ɕ aː
சாக்கு	t͡ɕ aː kː ʊ
சாசனம்	t͡ɕ aː t͡ɕ ɐ n ɐ m
சாசுவதம்	t͡ɕ aː t͡ɕ ʊ ʋ ɐ d̪ ɐ m
சாடு	t͡ɕ aː ɖ ʊ
சாட்சி	t͡ɕ aː ʈ t͡ɕ ɪ
சாட்டியம்	t͡ɕ aː ʈː ɪ j ɐ m
சாட்டை	t͡ɕ aː ʈː ɐ ɪ̯
சாணம்	t͡ɕ aː ɳ ɐ m
சாணி	t͡ɕ aː ɳ ɪ
சாணைக்கல்	t͡ɕ aː ɳ ɐ ɪ̯ kː ɐ l
சாண்	t͡ɕ aː ɳ
சாதனம்	t͡ɕ aː d̪ ɐ n ɐ m
சாதனை	t͡ɕ aː d̪ ɐ n ɐ ɪ̯
சாதம்	t͡ɕ aː d̪ ɐ m
சாதி	t͡ɕ aː d̪ ɪ
சாதிக்காய்	t͡ɕ aː d̪ ɪ kː aː j
சாத்தான்	t͡ɕ aː t̪ː aː n
சாத்து	t͡ɕ aː t̪ː ʊ
சாந்து	t͡ɕ aː n̪ d̪ ʊ
சானம்	t͡ɕ aː n ɐ m
சானா	t͡ɕ aː n aː
சானாஅ	t͡ɕ aː n aː ɐ
சான்று	t͡ɕ aː n r ʊ
சாபம்	t͡ɕ aː b ɐ m
சாப்பாடு	t͡ɕ aː pː aː ɖ ʊ
சாப்பாட்டுக்கடை	t͡ɕ aː pː aː ʈː ʊ kː ɐ ɖ ɐ ɪ̯
சாப்பிடு	t͡ɕ aː pː ɪ ɖ ʊ
சாப்பிட்டீங்களா	t͡ɕ aː pː ɪ ʈː iː ŋ ɡ ɐ ɭ aː
சாமந்தி	t͡ɕ aː m ɐ n̪ d̪ ɪ
சாமி	t͡ɕ aː m ɪ
சாமுவேல்	t͡ɕ aː m ʊ ʋ eː l
சாம்பல்	t͡ɕ aː m b ɐ l
சாம்பார்	t͡ɕ aː m b aː ɾ
சாம்ராச்சியம்	t͡ɕ aː m ɾ aː t͡ɕː ɪ j ɐ m
சாம்ராஜ்யம்	t͡ɕ aː m ɾ aː d͡ʑ j ɐ m
சாயங்காலம்	t͡ɕ aː j ɐ ŋ ɡ aː l ɐ m
சாய்	t͡ɕ aː j
சாய்கோடு	t͡ɕ aː j ɡ oː ɖ ʊ
சாய்ப்பிடம்	t͡ɕ aː j pː ɪ ɖ ɐ m
சாரத்துவம்	t͡ɕ aː ɾ ɐ t̪ː ʊ ʋ ɐ m
சாரன்	t͡ɕ aː ɾ ɐ n
சாரம்	t͡ɕ aː ɾ a m
சாரம்	t͡ɕ aː ɾ ɐ m
சாரல்	t͡ɕ aː ɾ ɐ l
சாராயம்	t͡ɕ aː ɾ aː j ɐ m
சார்	t͡ɕ aː ɾ
சார்க்கண்டு	t͡ɕ aː ɾ kː ɐ ɳ ɖ ʊ
சார்த்து	t͡ɕ aː ɾ t̪ː ʊ
சார்பெழுத்து	t͡ɕ aː ɾ b ɛ ɻ ʊ t̪ː ʊ
சார்வு	t͡ɕ aː ɾ ʋ ʊ
சாறு	t͡ɕ aː r ʊ
சாலி	t͡ɕ aː l ɪ
சாலியன்	t͡ɕ aː l ɪ j ɐ n
சாலை	t͡ɕ aː l ɐ ɪ̯
சால்	t͡ɕ aː l
சாளம்	t͡ɕ aː ɭ ɐ m
சாளரம்	t͡ɕ aː ɭ ɐ ɾ ɐ m
சாளை	t͡ɕ aː ɭ ɐ ɪ̯
சாவல்	t͡ɕ aː ʋ ɐ l
சாவாமை	t͡ɕ aː ʋ aː m ɐ ɪ̯
சாவி	t͡ɕ aː ʋ ɪ
சாவிகள்	t͡ɕ aː ʋ ɪ ɡ ɐ ɭ
சாவு	t͡ɕ aː ʋ ʊ
சாஸனம்	t͡ɕ aː s ɐ n ɐ m
சாஸ்திரம்	t͡ɕ aː s t̪ ɪ ɾ ɐ m
சிகப்பு	t͡ɕ ɪ ɡ ɐ pː ʊ
சிகரட்	t͡ɕ ɪ ɡ ɐ ɾ ɐ ʈ
சிகரம்	t͡ɕ ɪ ɡ ɐ ɾ ɐ m
சிகாகோ	t͡ɕ ɪ ɡ aː ɡ oː
சிகிச்சை	t͡ɕ ɪ ɡ ɪ t͡ɕː ɐ ɪ̯
சிகை	t͡ɕ ɪ ɡ ɐ ɪ̯
சிகைக்காய்	t͡ɕ ɪ ɡ ɐ ɪ̯ kː aː j
சிக்கல்	t͡ɕ ɪ kː ɐ l
சிக்கிம்	t͡ɕ ɪ kː ɪ m
சிக்கு	t͡ɕ ɪ kː ʊ
சிங்கப்பூர்	t͡ɕ ɪ ŋ ɡ ɐ pː uː ɾ
சிங்கம்	t͡ɕ ɪ ŋ ɡ ɐ m
சிங்களம்	t͡ɕ ɪ ŋ ɡ ɐ ɭ ɐ m
சிங்காசனம்	t͡ɕ ɪ ŋ ɡ aː t͡ɕ ɐ n ɐ m
சிங்கி	t͡ɕ ɪ ŋ ɡ ɪ
சிங்கு	t͡ɕ ɪ ŋ ɡ ʊ
சிசு	t͡ɕ ɪ t͡ɕ ʊ
சிதடு	t͡ɕ ɪ d̪ ɐ ɖ ʊ
சிதமை	t͡ɕ ɪ d̪ ɐ m ɐ ɪ̯
சிதர்	t͡ɕ ɪ d̪ ɐ ɾ
சிதறியம்	t͡ɕ ɪ d̪ ɐ r ɪ j ɐ m
சிதல்	t͡ɕ ɪ d̪ ɐ l
சிதாரி	t͡ɕ ɪ d̪ aː ɾ ɪ
சிதை	t͡ɕ ɪ d̪ ɐ ɪ̯
சிதைவு	t͡ɕ ɪ d̪ ɐ ɪ̯ ʋ ʊ
சித்தம்	t͡ɕ ɪ t̪ː ɐ m
சித்தர்	t͡ɕ ɪ t̪ː ɐ ɾ
சித்தார்	t͡ɕ ɪ t̪ː aː ɾ
சித்தி	t͡ɕ ɪ t̪ː ɪ
சித்திரபானு	t͡ɕ ɪ t̪ː ɪ ɾ ɐ b aː n ʊ
சித்திரை	t͡ɕ ɪ t̪ː ɪ ɾ ɐ ɪ̯
சிநேகிதன்	s n̪ eː h ɪ d̪ ɐ n
சிநேகிதன்	t͡ɕ ɪ n̪ eː ɡ ɪ d̪ ɐ n
சிந்தம்	t͡ɕ ɪ n̪ d̪ ɐ m
சிந்தி	t͡ɕ ɪ n̪ d̪ ɪ
சிந்து	t͡ɕ ɪ n̪ d̪ ʊ
சிந்தை	t͡ɕ ɪ n̪ d̪ ɐ ɪ̯
சினகரம்	t͡ɕ ɪ n ɐ ɡ ɐ ɾ ɐ m
சினகர்	t͡ɕ ɪ n ɐ ɡ ɐ ɾ
சினம்	t͡ɕ ɪ n ɐ m
சினாடிகா	t͡ɕ ɪ n aː ɖ ɪ ɡ aː
சினிமா	t͡ɕ ɪ n ɪ m aː
சினேகம்	t͡ɕ ɪ n eː ɡ ɐ m
சினை	t͡ɕ ɪ n ɐ ɪ̯
சினைப்பை	t͡ɕ ɪ n ɐ ɪ̯ pː ɐ ɪ̯
சின்டி	t͡ɕ ɪ n ɖ ɪ
சின்ன	t͡ɕ ɪ nː ɐ
சின்னக்கரடி	t͡ɕ ɪ nː ɐ kː ɐ ɾ ɐ ɖ ɪ
சிப்பாய்	t͡ɕ ɪ pː aː j
சிமிட்டி	t͡ɕ ɪ m ɪ ʈː ɪ
சிமையம்	t͡ɕ ɪ m ɐ ɪ̯ j ɐ m
சிம்சோன்	t͡ɕ ɪ m t͡ɕ oː n
சிம்மம்	t͡ɕ ɪ mː ɐ m
சியோல்	t͡ɕ ɪ j oː l
சிரபுஞ்சி	t͡ɕ i ɾ ɐ p u ɲ d͡ʑ i
சிராத்தம்	t͡ɕ ɪ ɾ aː t̪ː ɐ m
சிரி	t͡ɕ ɪ ɾ ɪ
சிரிப்பு	t͡ɕ ɪ ɾ ɪ pː ʊ
சிருட்டி	t͡ɕ ɪ ɾ ʊ ʈː ɪ
சிருஷ்டி	t͡ɕ ɪ ɾ ʊ ʂ ʈ ɪ
சிரேட்டி	t͡ɕ ɪ ɾ eː ʈː ɪ
சிற	t͡ɕ ɪ r ɐ
சிறகு	t͡ɕ ɪ r ɐ ɡ ʊ
சிறந்த	t͡ɕ ɪ r ɐ n̪ d̪ ɐ
சிறப்பு	t͡ɕ ɪ r ɐ pː ʊ
சிறப்புரிமை	t͡ɕ ɪ r ɐ pː ʊ ɾ ɪ m ɐ ɪ̯
சிறிய	t͡ɕ ɪ r ɪ j ɐ
சிறீதரன்	t͡ɕ ɪ r iː d̪ ɐ ɾ ɐ n
சிறு	t͡ɕ ɪ r ʊ
சிறுகதை	t͡ɕ ɪ r ʊ ɡ ɐ d̪ ɐ ɪ̯
சிறுகுறிஞ்சா	t͡ɕ ɪ r ʊ ɡ ʊ r ɪ ɲ d͡ʑ aː
சிறுசெண்பகம்	t͡ɕ ɪ r ʊ t͡ɕ ɛ ɳ b ɐ ɡ ɐ m
சிறுசெய்	t͡ɕ ɪ r ʊ t͡ɕ ɛ j
சிறுதடி	t͡ɕ ɪ r ʊ d̪ ɐ ɖ ɪ
சிறுத்தை	t͡ɕ ɪ r ʊ t̪ː ɐ ɪ̯
சிறுநீரகம்	t͡ɕ ɪ r ʊ n̪ iː ɾ ɐ ɡ ɐ m
சிறுநீர்	t͡ɕ ɪ r ʊ n̪ iː ɾ
சிறுமை	t͡ɕ ɪ r ʊ m ɐ ɪ̯
சிறுவன்	t͡ɕ ɪ r ʊ ʋ ɐ n
சிறுவாள்	t͡ɕ ɪ r ʊ ʋ aː ɭ
சிற்பசாஸ்திரி	t͡ɕ ɪ r p ɐ t͡ɕ aː s t̪ ɪ ɾ ɪ
சிற்பம்	t͡ɕ ɪ r p ɐ m
சிற்பர்	t͡ɕ ɪ r p ɐ ɾ
சிற்பியல்	t͡ɕ ɪ r p ɪ j ɐ l
சிற்றரத்தை	t͡ɕ ɪ rː ɐ ɾ ɐ t̪ː ɐ ɪ̯
சிற்றுண்டி	t͡ɕ ɪ rː ʊ ɳ ɖ ɪ
சிற்றூர்	t͡ɕ ɪ rː uː ɾ
சில	t͡ɕ ɪ l ɐ
சிலந்தி	t͡ɕ ɪ l ɐ n̪ d̪ ɪ
சிலப்பதிகாரம்	t͡ɕ ɪ l ɐ pː ɐ d̪ ɪ ɡ aː ɾ ɐ m
சிலர்	t͡ɕ ɪ l ɐ ɾ
சிலாக்கியம்	t͡ɕ ɪ l aː kː ɪ j ɐ m
சிலாங்கூர்	t͡ɕ ɪ l aː ŋ ɡ uː ɾ
சிலாசத்து	t͡ɕ ɪ l aː t͡ɕ ɐ t̪ː ʊ
சிலாபம்	t͡ɕ ɪ l aː b ɐ m
சிலுவை	t͡ɕ ɪ l ʊ ʋ ɐ ɪ̯
சிவ	t͡ɕ ɪ ʋ ɐ
சிவகங்கை	t͡ɕ ɪ ʋ ɐ ɡ ɐ ŋ ɡ ɐ ɪ̯
சிவந்தி	t͡ɕ ɪ ʋ ɐ n̪ d̪ ɪ
சிவன்	t͡ɕ ɪ ʋ ɐ n
சிவப்பு	t͡ɕ ɪ ʋ ɐ pː ʊ
சிவப்புக்கல்	t͡ɕ ɪ ʋ ɐ pː ʊ kː ɐ l
சிவப்புமரம்	t͡ɕ ɪ ʋ ɐ pː ʊ m ɐ ɾ ɐ m
சிவரிக்கீரை	t͡ɕ ɪ ʋ ɐ ɾ ɪ kː iː ɾ ɐ ɪ̯
சிவளிகைக்கச்சு	t͡ɕ ɪ ʋ ɐ ɭ ɪ ɡ ɐ ɪ̯ kː ɐ t͡ɕː ʊ
சிவிகை	t͡ɕ ɪ ʋ ɪ ɡ ɐ ɪ̯
சிவிங்கி	t͡ɕ ɪ ʋ ɪ ŋ ɡ ɪ
சிஷ்டம்	t͡ɕ ɪ ʂ ʈ ɐ m
சிஷ்யன்	t͡ɕ ɪ ʂ j ɐ n
சீக்கிரம்	t͡ɕ iː kː ɪ ɾ ɐ m
சீசா	t͡ɕ iː t͡ɕ aː
சீடை	t͡ɕ iː ɖ ɐ ɪ̯
சீட்டு	t͡ɕ iː ʈː ʊ
சீண்டு	t͡ɕ iː ɳ ɖ ʊ
சீதனம்	t͡ɕ iː d̪ ɐ n ɐ m
சீதை	t͡ɕ iː d̪ ɐ ɪ̯
சீந்து	t͡ɕ iː n̪ d̪ ʊ
சீனா	t͡ɕ iː n aː
சீனிக்கிழங்கு	t͡ɕ iː n ɪ kː ɪ ɻ ɐ ŋ ɡ ʊ
சீனிவாசன்	t͡ɕ iː n ɪ ʋ aː t͡ɕ ɐ n
சீபாதம்	t͡ɕ iː b aː d̪ ɐ m
சீமை	t͡ɕ iː m ɐ ɪ̯
சீமைக்கொய்யா	t͡ɕ iː m ɐ ɪ̯ kː ɔ jː aː
சீமைச்சீரகம்	t͡ɕ iː m ɐ ɪ̯ t͡ɕː iː ɾ ɐ ɡ ɐ m
சீமையழவனம்	t͡ɕ iː m ɐ ɪ̯ j ɐ ɻ ɐ ʋ ɐ n ɐ m
சீயக்காய்	t͡ɕ iː j ɐ kː aː j
சீயநெய்	t͡ɕ iː j ɐ n̪ ɛ j
சீயம்	t͡ɕ iː j ɐ m
சீரகம்	t͡ɕ iː ɾ ɐ ɡ ɐ m
சீரற்ற	t͡ɕ iː ɾ ɐ rː ɐ
சீருடை	t͡ɕ iː ɾ ʊ ɖ ɐ ɪ̯
சீர்	t͡ɕ iː ɾ
சீர்ப்படு	t͡ɕ iː ɾ pː ɐ ɖ ʊ
சீர்மை	t͡ɕ iː ɾ m ɐ ɪ̯
சீலை	t͡ɕ iː l ɐ ɪ̯
சீலைகள்	t͡ɕ iː l ɐ ɪ̯ ɡ ɐ ɭ
சீழ்	t͡ɕ iː ɻ
சீவன்	t͡ɕ iː ʋ ɐ n
சீவி	t͡ɕ iː ʋ ɪ
சுகந்தவர்க்கம்	t͡ɕ ʊ ɡ ɐ n̪ d̪ ɐ ʋ ɐ ɾ kː ɐ m
சுகம்	t͡ɕ ʊ ɡ ɐ m
சுகவழி	t͡ɕ ʊ ɡ ɐ ʋ ɐ ɻ ɪ
சுகாசனம்	t͡ɕ ʊ ɡ aː t͡ɕ ɐ n ɐ m
சுகுத்திரா	s o q o t̪ː i ɾ aː
சுகுத்திரா	t͡ɕ ʊ ɡ ʊ t̪ː ɪ ɾ aː
சுக்கிரன்	t͡ɕ ʊ kː ɪ ɾ ɐ n
சுக்கு	t͡ɕ ʊ kː ʊ
சுக்கை	t͡ɕ ʊ kː ɐ ɪ̯
சுடர்	t͡ɕ ʊ ɖ ɐ ɾ
சுடு	t͡ɕ ʊ ɖ ʊ
சுடுகாடு	t͡ɕ ʊ ɖ ʊ ɡ aː ɖ ʊ
சுட்டாமுட்டி	t͡ɕ ʊ ʈː aː m ʊ ʈː ɪ
சுட்டிக்காட்டு	t͡ɕ ʊ ʈː ɪ kː aː ʈː ʊ
சுட்டுவிரல்	t͡ɕ ʊ ʈː ʊ ʋ ɪ ɾ ɐ l
சுட்டெழுத்து	t͡ɕ ʊ ʈː ɛ ɻ ʊ t̪ː ʊ
சுண்டல்	t͡ɕ ʊ ɳ ɖ ɐ l
சுண்டு	t͡ɕ ʊ ɳ ɖ ʊ
சுண்டெலி	t͡ɕ ʊ ɳ ɖ ɛ l ɪ
சுண்ணம்	t͡ɕ ʊ ɳː ɐ m
சுண்ணாம்பு	t͡ɕ ʊ ɳː aː m b ʊ
சுண்ணாம்புக்கல்	t͡ɕ ʊ ɳː aː m b ʊ kː ɐ l
சுண்ணாம்புக்காளவாய்	t͡ɕ ʊ ɳː aː m b ʊ kː aː ɭ ɐ ʋ aː j
சுதந்தரம்	t͡ɕ ʊ d̪ ɐ n̪ d̪ ɐ ɾ ɐ m
சுதந்திரம்	t͡ɕ ʊ d̪ ɐ n̪ d̪ ɪ ɾ ɐ m
சுதன்	t͡ɕ ʊ d̪ ɐ n
சுத்தம்	t͡ɕ ʊ t̪ː ɐ m
சுத்தியல்	t͡ɕ ʊ t̪ː ɪ j ɐ l
சுந்தரம்	t͡ɕ ʊ n̪ d̪ ɐ ɾ ɐ m
சுனாமி	t͡ɕ ʊ n aː m ɪ
சுனை	t͡ɕ ʊ n ɐ ɪ̯
சுன்னத்து	t͡ɕ ʊ nː ɐ t̪ː ʊ
சுபம்	t͡ɕ ʊ b ɐ m
சுமார்	t͡ɕ ʊ m aː ɾ
சுமை	t͡ɕ ʊ m ɐ ɪ̯
சுரணை	t͡ɕ ʊ ɾ ɐ ɳ ɐ ɪ̯
சுரண்டு	t͡ɕ ʊ ɾ ɐ ɳ ɖ ʊ
சுரமண்டலம்	t͡ɕ ʊ ɾ ɐ m ɐ ɳ ɖ ɐ l ɐ m
சுரம்	t͡ɕ ʊ ɾ ɐ m
சுருக்கம்	t͡ɕ ʊ ɾ ʊ kː ɐ m
சுருக்கு	t͡ɕ ʊ ɾ ʊ kː ʊ
சுருட்டு	t͡ɕ ʊ ɾ ʊ ʈː ʊ
சுருதி	t͡ɕ ʊ ɾ ʊ d̪ ɪ
சுருதிகூட்டு	t͡ɕ ʊ ɾ ʊ d̪ ɪ ɡ uː ʈː ʊ
சுரும்பு	t͡ɕ ʊ ɾ ʊ m b ʊ
சுருளி	t͡ɕ ʊ ɾ ʊ ɭ ɪ
சுருள்	t͡ɕ ʊ ɾ ʊ ɭ
சுரை	t͡ɕ ʊ ɾ ɐ ɪ̯
சுரைக்காய்	t͡ɕ ʊ ɾ ɐ ɪ̯ kː aː j
சுறவம்	t͡ɕ ʊ r ɐ ʋ ɐ m
சுறா	t͡ɕ ʊ r aː
சுறாமீன்	t͡ɕ ʊ r aː m iː n
சுற்றம்	t͡ɕ ʊ rː ɐ m
சுற்றி	t͡ɕ ʊ rː ɪ
சுற்று	t͡ɕ ʊ rː ʊ
சுற்றுச்சூழல்	t͡ɕ ʊ rː ʊ t͡ɕː uː ɻ ɐ l
சுலபம்	t͡ɕ ʊ l ɐ b ɐ m
சுல்தானகம்	t͡ɕ ʊ l d̪ aː n ɐ ɡ ɐ m
சுளுக்கு	t͡ɕ ʊ ɭ ʊ kː ʊ
சுழியம்	t͡ɕ ʊ ɻ ɪ j ɐ m
சுவடி	t͡ɕ ʊ ʋ ɐ ɖ ɪ
சுவடு	t͡ɕ ʊ ʋ ɐ ɖ ʊ
சுவத்திகம்	t͡ɕ ʊ ʋ ɐ t̪ː ɪ ɡ ɐ m
சுவத்திகாசனம்	t͡ɕ ʊ ʋ ɐ t̪ː ɪ ɡ aː t͡ɕ ɐ n ɐ m
சுவர்	t͡ɕ ʊ ʋ ɐ ɾ
சுவர்க்கம்	t͡ɕ ʊ ʋ ɐ ɾ kː ɐ m
சுவாசம்	t͡ɕ ʊ ʋ aː t͡ɕ ɐ m
சுவாசியா	t͡ɕ ʊ ʋ aː t͡ɕ ɪ j aː
சுவானம்	t͡ɕ ʊ ʋ aː n ɐ m
சுவாமி	t͡ɕ ʊ ʋ aː m ɪ
சுவாலை	t͡ɕ ʊ ʋ aː l ɐ ɪ̯
சுவிசேஷம்	t͡ɕ ʊ ʋ ɪ t͡ɕ eː ʂ ɐ m
சுவேதம்	t͡ɕ ʊ ʋ eː t̪ː ɐ m
சுவை	t͡ɕ ʊ ʋ ɐ ɪ̯
சுவையான	t͡ɕ ʊ ʋ ɐ ɪ̯ j aː n ɐ
சூடு	t͡ɕ uː ɖ ʊ
சூட்	t͡ɕ uː ʈ
சூட்டுக்கள்	t͡ɕ uː ʈː ʊ kː ɐ ɭ
சூத்திரம்	t͡ɕ uː t̪ː ɪ ɾ ɐ m
சூனியம்	t͡ɕ uː n ɪ j ɐ m
சூன்	t͡ɕ uː n
சூரியகாந்தி	t͡ɕ uː ɾ ɪ j ɐ ɡ aː n̪ d̪ ɪ
சூரியன்	t͡ɕ uː ɾ ɪ j ɐ n
சூறாவளி	t͡ɕ uː r aː ʋ ɐ ɭ ɪ
சூறை	t͡ɕ uː r ɐ ɪ̯
சூலை	t͡ɕ uː l ɐ ɪ̯
சூளுறு	t͡ɕ uː ɭ ʊ r ʊ
சூழலியல்	t͡ɕ uː ɻ ɐ l ɪ j ɐ l
சூழல்	t͡ɕ uː ɻ ɐ l
சூழ்	t͡ɕ uː ɻ
செகம்	t͡ɕ ɛ ɡ ɐ m
செக்கு	t͡ɕ ɛ kː ʊ
செங்	t͡ɕ ɛ ŋ
செங்கந்தகம்	t͡ɕ ɛ ŋ ɡ ɐ n̪ d̪ ɐ ɡ ɐ m
செங்கல்	t͡ɕ ɛ ŋ ɡ ɐ l
செங்கல்பட்டு	t͡ɕ ɛ ŋ ɡ ɐ l b ɐ ʈː ʊ
செங்கல்மால்	t͡ɕ ɛ ŋ ɡ ɐ l m aː l
செங்களம்	t͡ɕ ɛ ŋ ɡ ɐ ɭ ɐ m
செங்கழுநீர்	t͡ɕ ɛ ŋ ɡ ɐ ɻ ʊ n̪ iː ɾ
செங்காடை	t͡ɕ ɛ ŋ ɡ aː ɖ ɐ ɪ̯
செங்கிழங்கு	t͡ɕ ɛ ŋ ɡ ɪ ɻ ɐ ŋ ɡ ʊ
செங்கோல்	t͡ɕ ɛ ŋ ɡ oː l
செச்சினியா	t͡ɕ ɛ t͡ɕː ɪ n ɪ j aː
செச்சை	t͡ɕ ɛ t͡ɕː ɐ ɪ̯
செஞ்சந்தனம்	t͡ɕ ɛ ɲ d͡ʑ ɐ n̪ d̪ ɐ n ɐ m
செடி	t͡ɕ ɛ ɖ ɪ
செடிகொடி	t͡ɕ ɛ ɖ ɪ ɡ ɔ ɖ ɪ
செட்டிநாகம்	t͡ɕ ɛ ʈː ɪ n̪ aː ɡ ɐ m
செட்டு	t͡ɕ ɛ ʈː ʊ
செட்டை	t͡ɕ ɛ ʈː ɐ ɪ̯
செட்டைகள்	t͡ɕ ɛ ʈː ɐ ɪ̯ ɡ ɐ ɭ
செத்தவீடு	t͡ɕ ɛ t̪ː ɐ ʋ iː ɖ ʊ
செத்தை	t͡ɕ ɛ t̪ː ɐ ɪ̯
செந்	t͡ɕ ɛ n̪
செந்தமிழ்	t͡ɕ ɛ n̪ d̪ ɐ m ɪ ɻ
செந்தாமரை	t͡ɕ ɛ n̪ d̪ aː m ɐ ɾ ɐ ɪ̯
செந்துருக்கம்	t͡ɕ ɛ n̪ d̪ ʊ ɾ ʊ kː ɐ m
செந்நீர்	t͡ɕ ɛ n̪ː iː ɾ
சென்னை	t͡ɕ ɛ nː ɐ ɪ̯
செபக்குடம்	t͡ɕ ɛ b ɐ kː ʊ ɖ ɐ m
செபம்	t͡ɕ ɛ b ɐ m
செப்டம்பர்	t͡ɕ ɛ p ʈ ɐ m b ɐ ɾ
செப்டெம்பர்	t͡ɕ ɛ p ʈ ɛ m b ɐ ɾ
செப்பம்	t͡ɕ ɛ pː ɐ m
செப்பு	t͡ɕ ɛ pː ʊ
செம்	t͡ɕ ɛ m
செம்பு	t͡ɕ ɛ m b ʊ
செம்புற்று	t͡ɕ ɛ m b ʊ rː ʊ
செம்ம	t͡ɕ ɛ mː ɐ
செம்மறி	t͡ɕ ɛ mː ɐ r ɪ
செம்மீன்	t͡ɕ ɛ mː iː n
செம்முள்ளி	t͡ɕ ɛ mː ʊ ɭː ɪ
செம்மை	t͡ɕ ɛ mː ɐ ɪ̯
செம்மொழி	t͡ɕ ɛ mː ɔ ɻ ɪ
செயசூறை	t͡ɕ ɛ j ɐ t͡ɕ uː r ɐ ɪ̯
செயப்படுபொருள்குன்றாதவினை	t͡ɕ ɛ j ɐ pː ɐ ɖ ʊ b ɔ ɾ ʊ ɭ ɡ ʊ n r aː d̪ ɐ ʋ ɪ n ɐ ɪ̯
செயப்படுபொருள்குன்றியவினை	t͡ɕ ɛ j ɐ pː ɐ ɖ ʊ b ɔ ɾ ʊ ɭ ɡ ʊ n r ɪ j ɐ ʋ ɪ n ɐ ɪ̯
செயப்பாட்டுவினை	t͡ɕ ɛ j ɐ pː aː ʈː ʊ ʋ ɪ n ɐ ɪ̯
செயம்	t͡ɕ ɛ j ɐ m
செயற்கை	t͡ɕ ɛ j ɐ r k ɐ ɪ̯
செயற்றிட்டம்	t͡ɕ ɛ j ɐ rː ɪ ʈː ɐ m
செயலி	t͡ɕ ɛ j ɐ l ɪ
செயலிழ	t͡ɕ ɛ j ɐ l ɪ ɻ ɐ
செயி	t͡ɕ ɛ j ɪ
செய்	t͡ɕ ɛ j
செய்தல்	t͡ɕ ɛ j d̪ ɐ l
செய்தி	t͡ɕ ɛ j d̪ ɪ
செய்தித்தாள்	t͡ɕ ɛ j d̪ ɪ t̪ː aː ɭ
செய்துகோள்	t͡ɕ ɛ j d̪ ʊ ɡ oː ɭ
செய்யுள்	t͡ɕ ɛ jː ʊ ɭ
செய்யோன்	t͡ɕ ɛ jː oː n
செய்வது	t͡ɕ ɛ j ʋ ɐ d̪ ʊ
செரி	t͡ɕ ɛ ɾ ɪ
செருக்கு	t͡ɕ ɛ ɾ ʊ kː ʊ
செருப்பு	t͡ɕ ɛ ɾ ʊ pː ʊ
செருமன்	t͡ɕ ɛ ɾ ʊ m ɐ n
செருமு	t͡ɕ ɛ ɾ ʊ m ʊ
செறி	t͡ɕ ɛ r ɪ
செறு	t͡ɕ ɛ r ʊ
செலவு	t͡ɕ ɛ l ɐ ʋ ʊ
செலுத்து	t͡ɕ ɛ l ʊ t̪ː ʊ
செலுப்பட்டி	t͡ɕ ɛ l ʊ pː ɐ ʈː ɪ
செல்	t͡ɕ ɛ l
செல்லம்	t͡ɕ ɛ l l ɐ m
செல்வநூல்	t͡ɕ ɛ l ʋ ɐ n̪ uː l
செல்வந்தன்	t͡ɕ ɛ l ʋ ɐ n̪ d̪ ɐ n
செல்வன்	t͡ɕ ɛ l ʋ ɐ n
செல்வம்	t͡ɕ ɛ l ʋ ɐ m
செல்வாக்கு	t͡ɕ ɛ l ʋ aː kː ʊ
செல்வி	t͡ɕ ɛ l ʋ ɪ
செள்ளு	t͡ɕ ɛ ɭː ʊ
செழி	t͡ɕ ɛ ɻ ɪ
செழித்தகல்	t͡ɕ ɛ ɻ ɪ t̪ː ɐ ɡ ɐ l
செழிப்பு	t͡ɕ ɛ ɻ ɪ pː ʊ
செழியன்	t͡ɕ ɛ ɻ ɪ j ɐ n
செவி	t͡ɕ ɛ ʋ ɪ
செவிகொடு	t͡ɕ ɛ ʋ ɪ ɡ ɔ ɖ ʊ
செவிடன்	t͡ɕ ɛ ʋ ɪ ɖ ɐ n
செவிடு	t͡ɕ ɛ ʋ ɪ ɖ ʊ
செவியன்	t͡ɕ ɛ ʋ ɪ j ɐ n
செவிலித்தாய்	t͡ɕ ɛ ʋ ɪ l ɪ t̪ː aː j
செவ்வந்தி	t͡ɕ ɛ ʋː ɐ n̪ d̪ ɪ
செவ்வனம்	t͡ɕ ɛ ʋː ɐ n ɐ m
செவ்வல்லி	t͡ɕ ɛ ʋː ɐ l l ɪ
செவ்வள்ளி	t͡ɕ ɛ ʋː ɐ ɭː ɪ
செவ்வாம்பல்	t͡ɕ ɛ ʋː aː m b ɐ l
செவ்வாய்	t͡ɕ ɛ ʋː aː j
செவ்வாய்க்கிழமை	t͡ɕ ɛ ʋː aː j kː ɪ ɻ ɐ m ɐ ɪ̯
செவ்வி	t͡ɕ ɛ ʋː ɪ
செவ்விரும்பு	t͡ɕ ɛ ʋː ɪ ɾ ʊ m b ʊ
சேகரி	t͡ɕ eː ɡ ɐ ɾ ɪ
சேதம்	t͡ɕ eː d̪ ɐ m
சேதி	t͡ɕ eː d̪ ɪ
சேத்து	t͡ɕ eː t̪ː ʊ
சேனை	t͡ɕ eː n ɐ ɪ̯
சேப்பங்கிழங்கு	t͡ɕ eː pː ɐ ŋ ɡ ɪ ɻ ɐ ŋ ɡ ʊ
சேமி	t͡ɕ eː m ɪ
சேமியா	t͡ɕ eː m ɪ j aː
சேம்பு	t͡ɕ eː m b ʊ
சேய்	t͡ɕ eː j
சேய்மை	t͡ɕ eː j m ɐ ɪ̯
சேரர்	t͡ɕ eː ɾ ɐ ɾ
சேரி	t͡ɕ eː ɾ ɪ
சேர்	t͡ɕ eː ɾ
சேர்க்கை	t͡ɕ eː ɾ kː ɐ ɪ̯
சேர்த்தி	t͡ɕ eː ɾ t̪ː ɪ
சேர்த்து	t͡ɕ eː ɾ t̪ː ʊ
சேர்ந்தலை	t͡ɕ eː ɾ n̪ d̪ ɐ l ɐ ɪ̯
சேர்ந்தார்	t͡ɕ eː ɾ n̪ d̪ aː ɾ
சேர்ப்பு	t͡ɕ eː ɾ pː ʊ
சேறு	t͡ɕ eː r ʊ
சேற்றுக்கால்	t͡ɕ eː rː ʊ kː aː l
சேலம்	t͡ɕ eː l ɐ m
சேலை	t͡ɕ eː l ɐ ɪ̯
சேவல்	t͡ɕ eː ʋ ɐ l
சேவை	t͡ɕ eː ʋ ɐ ɪ̯
சைகதம்	t͡ɕ ɐ ɪ̯ ɡ ɐ d̪ ɐ m
சைனன்	t͡ɕ ɐ ɪ̯ n ɐ n
சைனம்	t͡ɕ ɐ ɪ̯ n ɐ m
சைவம்	t͡ɕ ɐ ɪ̯ ʋ ɐ m
சொக்கத்தங்கம்	t͡ɕ ɔ kː ɐ t̪ː ɐ ŋ ɡ ɐ m
சொடுக்கி	t͡ɕ ɔ ɖ ʊ kː ɪ
சொட்டு	t͡ɕ ɔ ʈː ʊ
சொத்தால்	t͡ɕ ɔ t̪ː aː l
சொத்தின்	t͡ɕ ɔ t̪ː ɪ n
சொத்திலிருந்து	t͡ɕ ɔ t̪ː ɪ l ɪ ɾ ʊ n̪ d̪ ʊ
சொத்தில்	t͡ɕ ɔ t̪ː ɪ l
சொத்து	t͡ɕ ɔ t̪ː ʊ
சொத்துக்களால்	t͡ɕ ɔ t̪ː ʊ kː ɐ ɭ aː l
சொத்துக்களின்	t͡ɕ ɔ t̪ː ʊ kː ɐ ɭ ɪ n
சொத்துக்களிலிருந்து	t͡ɕ ɔ t̪ː ʊ kː ɐ ɭ ɪ l ɪ ɾ ʊ n̪ d̪ ʊ
சொத்துக்களில்	t͡ɕ ɔ t̪ː ʊ kː ɐ ɭ ɪ l
சொத்துக்களுக்காக	t͡ɕ ɔ t̪ː ʊ kː ɐ ɭ ʊ kː aː ɡ ɐ
சொத்துக்களுக்கு	t͡ɕ ɔ t̪ː ʊ kː ɐ ɭ ʊ kː ʊ
சொத்துக்களுடைய	t͡ɕ ɔ t̪ː ʊ kː ɐ ɭ ʊ ɖ ɐ ɪ̯ j ɐ
சொத்துக்களே	t͡ɕ ɔ t̪ː ʊ kː ɐ ɭ eː
சொத்துக்களை	t͡ɕ ɔ t̪ː ʊ kː ɐ ɭ ɐ ɪ̯
சொத்துக்களோடு	t͡ɕ ɔ t̪ː ʊ kː ɐ ɭ oː ɖ ʊ
சொத்துக்கள்	t͡ɕ ɔ t̪ː ʊ kː ɐ ɭ
சொத்துக்காக	t͡ɕ ɔ t̪ː ʊ kː aː ɡ ɐ
சொத்துக்கு	t͡ɕ ɔ t̪ː ʊ kː ʊ
சொத்துடைய	t͡ɕ ɔ t̪ː ʊ ɖ ɐ ɪ̯ j ɐ
சொத்தே	t͡ɕ ɔ t̪ː eː
சொத்தை	t͡ɕ ɔ t̪ː ɐ ɪ̯
சொத்தோடு	t͡ɕ ɔ t̪ː oː ɖ ʊ
சொந்த	t͡ɕ ɔ n̪ d̪ ɐ
சொந்தம்	t͡ɕ ɔ n̪ d̪ ɐ m
சொப்பனம்	t͡ɕ ɔ pː ɐ n ɐ m
சொரி	t͡ɕ ɔ ɾ ɪ
சொரிகொன்றை	t͡ɕ ɔ ɾ ɪ ɡ ɔ n r ɐ ɪ̯
சொருணை	t͡ɕ ɔ ɾ ʊ ɳ ɐ ɪ̯
சொர்க்கம்	t͡ɕ ɔ ɾ kː ɐ m
சொர்ணம்	t͡ɕ ɔ ɾ ɳ ɐ m
சொறி	t͡ɕ ɔ r ɪ
சொற்பிறப்பியல்	t͡ɕ ɔ r p ɪ r ɐ pː ɪ j ɐ l
சொற்பு	t͡ɕ ɔ r p ʊ
சொற்புத்தி	t͡ɕ ɔ r p ʊ t̪ː ɪ
சொற்பொழிவு	t͡ɕ ɔ r p ɔ ɻ ɪ ʋ ʊ
சொற்றொடர்	t͡ɕ ɔ rː ɔ ɖ ɐ ɾ
சொல்	t͡ɕ ɔ l
சொல்லாட்சி	t͡ɕ ɔ l l aː ʈ t͡ɕ ɪ
சொல்லிக்கொடு	t͡ɕ ɔ l l ɪ kː ɔ ɖ ʊ
சொல்லியல்	t͡ɕ ɔ l l ɪ j ɐ l
சொல்லெச்சம்	t͡ɕ ɔ l l ɛ t͡ɕː ɐ m
சொல்வளம்	t͡ɕ ɔ l ʋ ɐ ɭ ɐ m
சோகம்	t͡ɕ oː ɡ ɐ m
சோகிக்கீரை	t͡ɕ oː ɡ ɪ kː iː ɾ ɐ ɪ̯
சோக்கரா	t͡ɕ oː kː ɐ ɾ aː
சோதனை	t͡ɕ oː d̪ ɐ n ɐ ɪ̯
சோதி	t͡ɕ oː d̪ ɪ
சோதிடம்	t͡ɕ oː d̪ ɪ ɖ ɐ m
சோபானம்	t͡ɕ oː b aː n ɐ m
சோம்பு	t͡ɕ oː m b ʊ
சோர்	t͡ɕ oː ɾ
சோறு	t͡ɕ oː r ʊ
சோலை	t͡ɕ oː l ɐ ɪ̯
சோளப்பொரி	t͡ɕ oː ɭ ɐ pː ɔ ɾ ɪ
சோளம்	t͡ɕ oː ɭ ɐ m
சோழன்	t͡ɕ oː ɻ ɐ n
சோழர்	t͡ɕ oː ɻ ɐ ɾ
சோவி	t͡ɕ oː ʋ ɪ
சௌக்கியமா	t͡ɕ ɐ ʊ̯ kː ɪ j ɐ m aː
சௌக்கியம்	t͡ɕ ɐ ʊ̯ kː ɪ j ɐ m
சௌசௌ	t͡ɕ ɐ ʊ̯ t͡ɕ ɐ ʊ̯
சௌத்து	t͡ɕ ɐ ʊ̯ t̪ː ʊ
சௌந்தரியம்	t͡ɕ ɐ ʊ̯ n̪ d̪ ɐ ɾ ɪ j ɐ m
ச்	i t͡ɕ
ச்	i t͡ɕː ɯ
ச்	t͡ɕ
ஜ	d͡ʑ ɐ
ஜகத்	d͡ʑ ɐ ɡ ɐ t̪
ஜகம்	d͡ʑ ɐ ɡ ɐ m
ஜங்கிள்	d͡ʑ ɐ ŋ ɡ ɪ ɭ
ஜட்டி	d͡ʑ ɐ ʈː ɪ
ஜட்டிகள்	d͡ʑ ɐ ʈː ɪ ɡ ɐ ɭ
ஜண்டா	d͡ʑ ɐ ɳ ɖ aː
ஜந்து	d͡ʑ ɐ n̪ d̪ ʊ
ஜனகம்	d͡ʑ ɐ n ɐ ɡ ɐ m
ஜனவரி	d͡ʑ ɐ n ɐ ʋ ɐ ɾ ɪ
ஜனாபா	d͡ʑ ɐ n aː b aː
ஜன்னல்	d͡ʑ ɐ nː ɐ l
ஜப்பான்	d͡ʑ ɐ pː aː n
ஜமாத்து	d͡ʑ ɐ m aː t̪ː ʊ
ஜலதி	d͡ʑ ɐ l ɐ d̪ ɪ
ஜலதோஷம்	d͡ʑ ɐ l ɐ d̪ oː ʂ ɐ m
ஜலம்	d͡ʑ ɐ l ɐ m
ஜலுப்பு	d͡ʑ ɐ l ʊ pː ʊ
ஜவ்வரிசி	d͡ʑ ɐ ʋː ɐ ɾ ɪ t͡ɕ ɪ
ஜாஃப்னா	d͡ʑ aː f n aː
ஜாஜ்வல்யம்	d͡ʑ aː d͡ʑ ʋ ɐ l j ɐ m
ஜாதகம்	d͡ʑ aː d̪ ɐ ɡ ɐ m
ஜாதி	d͡ʑ aː d̪ ɪ
ஜாநு	d͡ʑ aː n̪ ʊ
ஜிகுஜிகு	d͡ʑ ɪ ɡ ʊ d͡ʑ ɪ ɡ ʊ
ஜிந்தகி	d͡ʑ ɪ n̪ d̪ ɐ ɡ ɪ
ஜிராக்ஸ்	d͡ʑ ɪ ɾ aː k s
ஜிராயதி	d͡ʑ ɪ ɾ aː j ɐ d̪ ɪ
ஜிஹாத்	d͡ʑ ɪ h aː t̪
ஜீதம்	d͡ʑ iː d̪ ɐ m
ஜீரகம்	d͡ʑ iː ɾ ɐ ɡ ɐ m
ஜீரணி	d͡ʑ iː ɾ ɐ ɳ ɪ
ஜீவசரிதை	d͡ʑ iː ʋ ɐ t͡ɕ ɐ ɾ ɪ d̪ ɐ ɪ̯
ஜீவன்	d͡ʑ iː ʋ ɐ n
ஜீவன்கள்	d͡ʑ iː ʋ ɐ n ɡ ɐ ɭ
ஜீவவிருட்சம்	d͡ʑ iː ʋ ɐ ʋ ɪ ɾ ʊ ʈ t͡ɕ ɐ m
ஜீவிதம்	d͡ʑ iː ʋ ɪ d̪ ɐ m
ஜுரம்	d͡ʑ ʊ ɾ ɐ m
ஜுவாலை	d͡ʑ ʊ ʋ aː l ɐ ɪ̯
ஜூன்	d͡ʑ uː n
ஜூலை	d͡ʑ uː l ɐ ɪ̯
ஜென்மம்	d͡ʑ ɛ n m ɐ m
ஜெபம்	d͡ʑ ɛ b ɐ m
ஜெபி	d͡ʑ ɛ b ɪ
ஜெயம்	d͡ʑ ɛ j ɐ m
ஜெயி	d͡ʑ ɛ j ɪ
ஜெராக்ஸ்	d͡ʑ ɛ ɾ aː k s
ஜெருசலேம்	d͡ʑ ɛ ɾ ʊ t͡ɕ ɐ l eː m
ஜெர்மன்	d͡ʑ ɛ ɾ m ɐ n
ஜொள்ளு	d͡ʑ ɔ ɭː ʊ
ஜோகூர்	d͡ʑ oː ɡ uː ɾ
ஜோடி	d͡ʑ oː ɖ ɪ
ஜோதிடம்	d͡ʑ oː d̪ ɪ ɖ ɐ m
ஜ்	d͡ʑ
ஜ்வரம்	d͡ʑ ʋ ɐ ɾ ɐ m
ஜ்வாலை	d͡ʑ ʋ aː l ɐ ɪ̯
ஞ	ɲ ɐ
ஞமன்	ɲ ɐ m ɐ n
ஞமலி	ɲ ɐ m ɐ l ɪ
ஞாங்க	ɲ aː ŋ ɡ ɐ
ஞாஞ்சில்	ɲ aː ɲ d͡ʑ ɪ l
ஞாண்	ɲ aː ɳ
ஞானம்	ɲ aː n ɐ m
ஞானஸ்நானம்	ɲ aː n ɐ s n̪ aː n ɐ m
ஞாபகம்	ɲ aː b ɐ ɡ ɐ m
ஞாபகம்	ɲ aː ʋ ɐ m
ஞாயிறு	ɲ aː j ɪ r ʊ
ஞாயிற்றுக்கிழமை	ɲ aː j ɪ rː ʊ kː ɪ ɻ ɐ m ɐ ɪ̯
ஞாலம்	ɲ aː l ɐ m
ஞிமிறு	ɲ ɪ m ɪ r ʊ
ஞெமலி	ɲ ɛ m ɐ l ɪ
ஞ்	i ɲ d͡ʑ
ஞ்	i ɲ d͡ʑ ɯ
ஞ்	ɲ
ட	ʈ ɐ
டங்கம்	ʈ ɐ ŋ ɡ ɐ m
டப்பா	ɖ ɐ b b aː
டப்பா	ɖ ɐ pː aː
டப்பா	ʈ ɐ pː aː
டயமண்ட்	ʈ ɐ j ɐ m ɐ ɳ ɖ
டர்	ɖ ɐ ɾ
டிசம்பர்	ɖ ɪ t͡ɕ ɐ m b ɐ ɾ
டிராகன்	ʈ ɪ ɾ aː ɡ ɐ n
டீ	ʈ iː
டுபாக்கூர்	ɖ ʊ b aː kː uː ɾ
டெல்லி	ʈ ɛ l l ɪ
டேஸ்டு	ɖ eː s ʈ ʊ
டேஸ்டு	ʈ eː s ʈ ʊ
டைனோசர்	ɖ ɐ ɪ̯ n oː t͡ɕ ɐ ɾ
டைமண்டு	ʈ ɐ ɪ̯ m ɐ ɳ ɖ ʊ
டைமண்டுக்கள்	ʈ ɐ ɪ̯ m ɐ ɳ ɖ ʊ kː ɐ ɭ
டைமண்ட்	ʈ ɐ ɪ̯ m ɐ ɳ ɖ
ட்	i ʈ
ட்	i ʈː ɯ
ட்	ʈ
ண	ɳ ɐ
ண்	i ɳ
ண்	i ɳː ɯ
ண்	ɳ
த	t̪ ɐ
தகடி	t̪ ɐ ɡ ɐ ɖ ɪ
தகடு	t̪ ɐ ɡ ɐ ɖ ʊ
தகதக	t̪ a ɡ a t̪ a ɡ a
தகதக	t̪ ɐ ɡ ɐ t̪ ɐ ɡ ɐ
தகப்பன்	t̪ ɐ h ɐ pː ɐ n
தகப்பன்	t̪ ɐ ɡ ɐ pː ɐ n
தகரம்	t̪ ɐ ɡ ɐ ɾ ɐ m
தகரை	t̪ ɐ ɡ ɐ ɾ ɐ ɪ̯
தகவல்	t̪ ɐ ɡ ɐ ʋ ɐ l
தகு	t̪ ɐ ɡ ʊ
தகுதி	t̪ ɐ ɡ ʊ d̪ ɪ
தக்கணநாடு	t̪ ɐ kː ɐ ɳ ɐ n̪ aː ɖ ʊ
தக்கணை	t̪ ɐ kː ɐ ɳ ɐ ɪ̯
தக்காளி	t̪ ɐ kː aː ɭ ɪ
தங்கமீன்	t̪ ɐ ŋ ɡ ɐ m iː n
தங்கம்	t̪ ɐ ŋ ɡ ɐ m
தங்கு	t̪ ɐ ŋ ɡ ʊ
தங்குதல்	t̪ ɐ ŋ ɡ ʊ d̪ ɐ l
தங்கை	t̪ ɐ ŋ ɡ ɐ ɪ̯
தசை	t̪ ɐ t͡ɕ ɐ ɪ̯
தஞ்சம்	t̪ ɐ ɲ d͡ʑ ɐ m
தஞ்சாவூர்	t̪ ɐ ɲ d͡ʑ aː ʋ uː ɾ
தடங்காட்டி	t̪ ɐ ɖ ɐ ŋ ɡ aː ʈː ɪ
தடம்	t̪ ɐ ɖ ɐ m
தடவு	t̪ ɐ ɖ ɐ ʋ ʊ
தடவை	d̪ ɐ ɖ ɐ ʋ ɐ ɪ̯
தடவை	t̪ ɐ ɖ ɐ ʋ ɐ ɪ̯
தடி	t̪ ɐ ɖ ɪ
தடித்த	t̪ ɐ ɖ ɪ t̪ː ɐ
தடு	t̪ ɐ ɖ ʊ
தடுத்துவை	t̪ ɐ ɖ ʊ t̪ː ʊ ʋ ɐ ɪ̯
தடுப்பு	t̪ ɐ ɖ ʊ pː ʊ
தடுப்பூசி	t̪ ɐ ɖ ʊ pː uː t͡ɕ ɪ
தடுப்பூசிகள்	t̪ ɐ ɖ ʊ pː uː t͡ɕ ɪ ɡ ɐ ɭ
தடுமாற்றம்	t̪ ɐ ɖ ʊ m aː rː ɐ m
தட்டான்	t̪ ɐ ʈː aː n
தட்டு	t̪ ɐ ʈː ʊ
தட்டை	t̪ ɐ ʈː ɐ ɪ̯
தணல்	t̪ ɐ ɳ ɐ l
தண்	t̪ ɐ ɳ
தண்டனம்	d̪ ɐ ɳ ɖ ɐ n ɐ m
தண்டனை	t̪ ɐ ɳ ɖ ɐ n ɐ ɪ̯
தண்டம்	d̪ ɐ ɳ ɖ ɐ m
தண்டி	d̪ ɐ ɳ ɖ ɪ
தண்ணி	t̪ ɐ ɳː ɪ
தண்ணீர்	t̪ ɐ ɳː iː ɾ
தண்ணீர்விட்டான்	t̪ ɐ ɳː iː ɾ ʋ ɪ ʈː aː n
தத்துவம்	t̪ ɐ t̪ː ʊ ʋ ɐ m
தத்தை	t̪ ɐ t̪ː ɐ ɪ̯
தத்ரம்	d̪ ɐ d̪ ɾ ɐ m
தந்தம்	d̪ ɐ n̪ d̪ ɐ m
தந்திரவாயன்	t̪ ɐ n̪ d̪ ɪ ɾ ɐ ʋ aː j ɐ n
தந்தை	t̪ ɐ n̪ d̪ ɐ ɪ̯
தனஞ்சயன்	d̪ ɐ n ɐ ɲ d͡ʑ ɐ j ɐ n
தனாக்	t̪ ɐ n aː k
தனி	t̪ ɐ n ɪ
தனிமை	t̪ ɐ n ɪ m ɐ ɪ̯
தனியா	t̪ ɐ n ɪ j aː
தனுசு	t̪ ɐ n ʊ t͡ɕ ʊ
தனுஷ்கோடி	d̪ ɐ n ʊ ʂ k oː ɖ ɪ
தன்	t̪ ɐ n
தன்னுணர்வு	t̪ ɐ nː ʊ ɳ ɐ ɾ ʋ ʊ
தன்பாலீர்ப்பு	t̪ ɐ n b aː l iː ɾ pː ʊ
தன்மை	t̪ ɐ n m ɐ ɪ̯
தபால்	t̪ ɐ b aː l
தப்பி	t̪ ɐ pː ɪ
தப்பு	t̪ ɐ pː ʊ
தமக்கை	t̪ ɐ m ɐ kː ɐ ɪ̯
தமரத்தை	t̪ ɐ m ɐ ɾ ɐ t̪ː ɐ ɪ̯
தமிழகம்	t̪ ɐ m ɪ ɻ ɐ ɡ ɐ m
தமிழச்சி	t̪ ɐ m ɪ ɻ ɐ t͡ɕː ɪ
தமிழன்	t̪ ɐ m ɪ ɻ ɐ n
தமிழால்	t̪ ɐ m ɪ ɻ aː l
தமிழிடம்	t̪ ɐ m ɪ ɻ ɪ ɖ ɐ m
தமிழின்	t̪ ɐ m ɪ ɻ ɪ n
தமிழிலக்கணம்	t̪ ɐ m ɪ ɻ ɪ l ɐ kː ɐ ɳ ɐ m
தமிழிலிருந்து	t̪ ɐ m ɪ ɻ ɪ l ɪ ɾ ʊ n̪ d̪ ʊ
தமிழில்	t̪ ɐ m ɪ ɻ ɪ l
தமிழுக்காக	t̪ ɐ m ɪ ɻ ʊ kː aː ɡ ɐ
தமிழுக்கு	t̪ ɐ m ɪ ɻ ʊ kː ʊ
தமிழுடன்	t̪ ɐ m ɪ ɻ ʊ ɖ ɐ n
தமிழுடைய	t̪ ɐ m ɪ ɻ ʊ ɖ ɐ ɪ̯ j ɐ
தமிழே	t̪ ɐ m ɪ ɻ eː
தமிழை	t̪ ɐ m ɪ ɻ ɐ ɪ̯
தமிழோடு	t̪ ɐ m ɪ ɻ oː ɖ ʊ
தமிழ்	t̪ ɐ m ɪ ɻ
தமிழ்செல்வன்	t̪ ɐ m ɪ ɻ t͡ɕ ɛ l ʋ ɐ n
தமிழ்செல்வி	t̪ ɐ m ɪ ɻ t͡ɕ ɛ l ʋ ɪ
தமிழ்நாடு	t̪ ɐ m ɪ ɻ n̪ aː ɖ ʊ
தம்	t̪ ɐ m
தம்பதி	t̪ ɐ m b ɐ d̪ ɪ
தம்பம்	t̪ ɐ m b ɐ m
தம்பி	t̪ ɐ m b ɪ
தம்புரா	t̪ ɐ m b ʊ ɾ aː
தயவு	d̪ ɐ j ɐ ʋ ʊ
தயார்	t̪ ɐ j aː ɾ
தயிர்	t̪ ɐ j ɪ ɾ
தயிலம்	t̪ ɐ j ɪ l ɐ m
தயை	d̪ ɐ j ɐ ɪ̯
தரங்கம்	t̪ ɐ ɾ ɐ ŋ ɡ ɐ m
தரணி	t̪ ɐ ɾ ɐ ɳ ɪ
தரப்பு	t̪ ɐ ɾ ɐ pː ʊ
தரம்	t̪ ɐ ɾ ɐ m
தரவு	t̪ ɐ ɾ ɐ ʋ ʊ
தரவுகள்	t̪ ɐ ɾ ɐ ʋ ʊ ɡ ɐ ɭ
தராசு	t̪ ɐ ɾ aː t͡ɕ ʊ
தரிசனம்	t̪ ɐ ɾ ɪ t͡ɕ ɐ n ɐ m
தரிசனை	t̪ ɐ ɾ ɪ t͡ɕ ɐ n ɐ ɪ̯
தரித்திரம்	d̪ ɐ ɾ ɪ t̪ː ɪ ɾ ɐ m
தரிப்பு	t̪ ɐ ɾ ɪ pː ʊ
தரியலர்	t̪ ɐ ɾ ɪ j ɐ l ɐ ɾ
தரியாபத்து	t̪ ɐ ɾ ɪ j aː b ɐ t̪ː ʊ
தருக்கு	t̪ ɐ ɾ ʊ kː ʊ
தருமன்	t̪ ɐ ɾ ʊ m ɐ n
தருமம்	t̪ ɐ ɾ ʊ m ɐ m
தருமராசா	t̪ ɐ ɾ ʊ m ɐ ɾ aː t͡ɕ aː
தருவாய்	t̪ ɐ ɾ ʊ ʋ aː j
தரூடம்	t̪ ɐ ɾ uː ɖ ɐ m
தரை	t̪ ɐ ɾ ɐ ɪ̯
தரையாமை	t̪ ɐ ɾ ɐ ɪ̯ j aː m ɐ ɪ̯
தரோகா	t̪ ɐ ɾ oː ɡ aː
தரோபஸ்து	t̪ ɐ ɾ oː b ɐ s t̪ ʊ
தர்கா	t̪ ɐ ɾ ɡ aː
தர்ச்சனி	t̪ ɐ ɾ t͡ɕː ɐ n ɪ
தர்ஜமா	t̪ ɐ ɾ d͡ʑ ɐ m aː
தர்ஜா	t̪ ɐ ɾ d͡ʑ aː
தர்பார்	t̪ ɐ ɾ b aː ɾ
தர்பூசணி	d̪ ɐ ɾ b uː t͡ɕ ɐ ɳ ɪ
தர்ப்பீத்து	t̪ ɐ ɾ pː iː t̪ː ʊ
தர்மபுரி	t̪ ɐ ɾ m ɐ b ʊ ɾ ɪ
தர்மா	t̪ ɐ ɾ m aː
தர்முஸ்தாஜர்	t̪ ɐ ɾ m ʊ s t̪ aː d͡ʑ ɐ ɾ
தறி	t̪ ɐ r ɪ
தற்கொலை	t̪ ɐ r k ɔ l ɐ ɪ̯
தற்சனி	t̪ ɐ r t͡ɕ ɐ n ɪ
தற்பால்சேர்க்கை	t̪ ɐ r p aː l t͡ɕ eː ɾ kː ɐ ɪ̯
தற்புகழ்ச்சி	t̪ ɐ r p ʊ ɡ ɐ ɻ t͡ɕː ɪ
தற்போதம்	t̪ ɐ r p oː d̪ ɐ m
தலகாணி	t̪ ɐ l ɐ ɡ aː ɳ ɪ
தலம்	t̪ ɐ l ɐ m
தலாக்	t̪ ɐ l aː k
தலை	t̪ ɐ l ɐ ɪ̯
தலைமறை	t̪ ɐ l ɐ ɪ̯ m ɐ r ɐ ɪ̯
தலைமாடு	t̪ ɐ l ɐ ɪ̯ m aː ɖ ʊ
தலைமாறு	t̪ ɐ l ɐ ɪ̯ m aː r ʊ
தலைமுறை	t̪ ɐ l ɐ ɪ̯ m ʊ r ɐ ɪ̯
தலைமை	t̪ ɐ l ɐ ɪ̯ m ɐ ɪ̯
தலையணை	t̪ ɐ l ɐ ɪ̯ j ɐ ɳ ɐ ɪ̯
தலையல்	t̪ ɐ l ɐ ɪ̯ j ɐ l
தலைவன்	t̪ ɐ l ɐ ɪ̯ ʋ ɐ n
தலைவர்	t̪ ɐ l ɐ ɪ̯ ʋ ɐ ɾ
தல்லம்	t̪ ɐ l l ɐ m
தளப்பு	t̪ ɐ ɭ ɐ pː ʊ
தளம்	t̪ ɐ ɭ ɐ m
தளம்பு	t̪ ɐ ɭ ɐ m b ʊ
தளர்	t̪ ɐ ɭ ɐ ɾ
தளர்ச்சி	t̪ ɐ ɭ ɐ ɾ t͡ɕː ɪ
தளர்வு	t̪ ɐ ɭ ɐ ɾ ʋ ʊ
தளை	t̪ ɐ ɭ ɐ ɪ̯
தள்ளு	t̪ ɐ ɭː ʊ
தள்ளை	t̪ ɐ ɭː ɐ ɪ̯
தழுதணை	t̪ ɐ ɻ ʊ d̪ ɐ ɳ ɐ ɪ̯
தழும்பு	t̪ ɐ ɻ ʊ m b ʊ
தவனம்	t̪ ɐ ʋ ɐ n ɐ m
தவம்	t̪ ɐ ʋ ɐ m
தவறணை	t̪ ɐ ʋ ɐ r ɐ ɳ ɐ ɪ̯
தவறு	t̪ ɐ ʋ ɐ r ʊ
தவளம்	t̪ ɐ ʋ ɐ ɭ ɐ m
தவளை	t̪ ɐ ʋ ɐ ɭ ɐ ɪ̯
தவாரிக்	t̪ ɐ ʋ aː ɾ ɪ k
தவி	t̪ ɐ ʋ ɪ
தவிர	t̪ ɐ ʋ ɪ ɾ ɐ
தவிர்ச்சி	t̪ ɐ ʋ ɪ ɾ t͡ɕː ɪ
தவில்	t̪ ɐ ʋ ɪ l
தவிள்	t̪ ɐ ʋ ɪ ɭ
தஸ்தவேசு	t̪ ɐ s t̪ ɐ ʋ eː t͡ɕ ʊ
தஸ்தாவேஜு	t̪ ɐ s t̪ aː ʋ eː d͡ʑ ʊ
தஸ்தாவேஜ்	t̪ ɐ s t̪ aː ʋ eː d͡ʑ
தா	t̪ aː
தாகம்	d̪ aː ɡ ɐ m
தாகம்	t̪ aː ɡ ɐ m
தாகெஸ்தான்	t̪ aː ɡ ɛ s t̪ aː n
தாக்கம்	t̪ aː kː ɐ m
தாங்கி	t̪ aː ŋ ɡ ɪ
தாங்கு	t̪ aː ŋ ɡ ʊ
தாச்சா	t̪ aː t͡ɕː aː
தாடி	t̪ aː ɖ ɪ
தாட்கோல்	t̪ aː ʈ k oː l
தாண்டவம்	t̪ aː ɳ ɖ ɐ ʋ ɐ m
தாண்டி	t̪ aː ɳ ɖ ɪ
தாண்டு	t̪ aː ɳ ɖ ʊ
தாதை	t̪ aː d̪ ɐ ɪ̯
தாத்தா	t̪ aː t̪ː aː
தாத்திரம்	t̪ aː t̪ː ɪ ɾ ɐ m
தானம்	t̪ aː n ɐ m
தானி	t̪ aː n ɪ
தானியம்	t̪ aː n ɪ j ɐ m
தானியேல்	t̪ aː n ɪ j eː l
தான்	t̪ aː n
தாபரம்	t̪ aː b ɐ ɾ ɐ m
தாமரை	t̪ aː m ɐ ɾ ɐ ɪ̯
தாமிரபரணி	t̪ aː m ɪ ɾ ɐ b ɐ ɾ ɐ ɳ ɪ
தாமிரபருணி	t̪ aː m ɪ ɾ ɐ b ɐ ɾ ʊ ɳ ɪ
தாமிரம்	t̪ aː m ɪ ɾ ɐ m
தாம்	t̪ aː m
தாயகம்	t̪ aː j ɐ ɡ ɐ m
தாய்	t̪ aː j
தாய்மாமன்	t̪ aː j m aː m ɐ n
தாய்மொழி	t̪ aː j m ɔ ɻ ɪ
தாய்லாந்து	t̪ aː j l aː n̪ d̪ ʊ
தாரா	t̪ aː ɾ aː
தாராக்கள்	t̪ aː ɾ aː kː ɐ ɭ
தாரித்திரம்	t̪ aː ɾ ɪ t̪ː ɪ ɾ ɐ m
தாரை	t̪ aː ɾ ɐ ɪ̯
தார்	t̪ aː ɾ
தாற்பரியம்	t̪ aː r p ɐ ɾ ɪ j ɐ m
தாலாட்டு	t̪ aː l aː ʈː ʊ
தாலி	t̪ aː l ɪ
தாலிகள்	t̪ aː l ɪ ɡ ɐ ɭ
தாலித்துக்கம்	t̪ aː l ɪ t̪ː ʊ kː ɐ m
தாளம்	t̪ aː ɭ ɐ m
தாளி	t̪ aː ɭ ɪ
தாளிக்கம்	t̪ aː ɭ ɪ kː ɐ m
தாளிசம்	t̪ aː ɭ ɪ t͡ɕ ɐ m
தாளித்தல்	t̪ aː ɭ ɪ t̪ː ɐ l
தாளிப்பனை	t̪ aː ɭ ɪ pː ɐ n ɐ ɪ̯
தாள்	t̪ aː ɭ
தாழை	t̪ aː ɻ ɐ ɪ̯
தாழ்	t̪ aː ɻ
தாழ்மை	t̪ aː ɻ m ɐ ɪ̯
தாழ்வாரம்	t̪ aː ɻ ʋ aː ɾ ɐ m
தாவடி	t̪ aː ʋ ɐ ɖ ɪ
தாவரம்	t̪ aː ʋ ɐ ɾ ɐ m
தாவரவியல்	t̪ aː ʋ ɐ ɾ ɐ ʋ ɪ j ɐ l
தாவீது	t̪ aː ʋ iː d̪ ʊ
தாவு	t̪ aː ʋ ʊ
தாஸ்மானியா	t̪ aː s m aː n ɪ j aː
திகில்	d̪ ɪ h ɪ l
திகில்	d̪ ɪ ɡ ɪ l
திகில்	t̪ ɪ ɡ ɪ l
திக்கு	d̪ ɪ kː ʊ
திக்கு	t̪ ɪ kː ʊ
திங்கட்கிழமை	t̪ ɪ ŋ ɡ ɐ ʈ k ɪ ɻ ɐ m ɐ ɪ̯
திங்கள்	t̪ ɪ ŋ ɡ ɐ ɭ
திசெம்பர்	d̪ ɪ t͡ɕ ɐ m b ɐ ɾ
திசை	d̪ ɪ t͡ɕ ɐ ɪ̯
திசை	t̪ ɪ t͡ɕ ɐ ɪ̯
திசைமானி	d̪ ɪ t͡ɕ ɐ ɪ̯ m aː n ɪ
திசைவி	t̪ ɪ t͡ɕ ɐ ɪ̯ ʋ ɪ
திடீர்	d̪ ɪ ɖ iː ɾ
திடீர்	t̪ ɪ ɖ iː ɾ
திட்டம்	t̪ ɪ ʈː ɐ m
திட்டாந்தம்	t̪ ɪ ʈː aː n̪ d̪ ɐ m
திட்டாந்தரம்	t̪ ɪ ʈː aː n̪ d̪ ɐ ɾ ɐ m
திட்டி	t̪ ɪ ʈː ɪ
திட்டு	t̪ ɪ ʈː ʊ
திணை	t̪ ɪ ɳ ɐ ɪ̯
திண்டாடு	t̪ ɪ ɳ ɖ aː ɖ ʊ
திண்டிவனம்	t̪ ɪ ɳ ɖ ɪ ʋ ɐ n ɐ m
திண்டுக்கல்	t̪ ɪ ɳ ɖ ʊ kː ɐ l
திதி	t̪ ɪ d̪ ɪ
திநாரம்	t̪ ɪ n̪ aː ɾ ɐ m
திந்திரிவனம்	t̪ ɪ n̪ d̪ ɪ ɾ ɪ ʋ ɐ n ɐ m
தினந்தோறும்	t̪ ɪ n ɐ n̪ d̪ oː r ʊ m
தினம்	t̪ ɪ n ɐ m
தின்	t̪ ɪ n
தின்னு	t̪ ɪ nː ʊ
திப்பலி	t̪ ɪ pː ɐ l ɪ
திமிங்கிலம்	t̪ ɪ m ɪ ŋ ɡ ɪ l ɐ m
திமிர்	t̪ ɪ m ɪ ɾ
தியானம்	t̪ ɪ j aː n ɐ m
தியானி	t̪ ɪ j aː n ɪ
திரணை	t̪ ɪ ɾ ɐ ɳ ɐ ɪ̯
திரள்	t̪ ɪ ɾ ɐ ɭ
திரவம்	t̪ ɪ ɾ ɐ ʋ ɐ m
திரவிடம்	t̪ ɪ ɾ ɐ ʋ ɪ ɖ ɐ m
திராங்கானு	t̪ ɪ ɾ aː ŋ ɡ aː n ʊ
திராட்சை	d̪ ɪ ɾ aː ʈ t͡ɕ ɐ ɪ̯
திராணி	t̪ ɪ ɾ aː ɳ ɪ
திராவகம்	t̪ ɪ ɾ aː ʋ ɐ ɡ ɐ m
திராவிட	t̪ ɪ ɾ aː ʋ ɪ ɖ ɐ
திராவிடம்	t̪ ɪ ɾ aː ʋ ɪ ɖ ɐ m
திரி	t̪ ɪ ɾ ɪ
திரிதடையம்	t̪ ɪ ɾ ɪ d̪ ɐ ɖ ɐ ɪ̯ j ɐ m
திரித்துவம்	t̪ ɪ ɾ ɪ t̪ː ʊ ʋ ɐ m
திரிபுண்டரம்	t̪ ɪ ɾ ɪ b ʊ ɳ ɖ ɐ ɾ ɐ m
திரிபுரா	t̪ i ɾ̪ i p u ɾ̪ aː
திரிய	t̪ ɪ ɾ ɪ j ɐ
திரியும்	t̪ ɪ ɾ ɪ j ʊ m
திரு	t̪ ɪ ɾ ʊ
திருகாணி	t̪ ɪ ɾ ʊ ɡ aː ɳ ɪ
திருகுமணை	t̪ ɪ ɾ ʊ ɡ ʊ m ɐ ɳ ɐ ɪ̯
திருகோணமலை	t̪ ɪ ɾ ʊ ɡ oː ɳ ɐ m ɐ l ɐ ɪ̯
திருக்கார்த்திகை	t̪ ɪ ɾ ʊ kː aː ɾ t̪ː ɪ ɡ ɐ ɪ̯
திருக்கை	t̪ ɪ ɾ ʊ kː ɐ ɪ̯
திருச்சபை	t̪ ɪ ɾ ʊ t͡ɕː ɐ b ɐ ɪ̯
திருச்சிராப்பள்ளி	t̪ ɪ ɾ ʊ t͡ɕː ɪ ɾ aː pː ɐ ɭː ɪ
திருச்சூர்	t̪ ɪ ɾ ʊ t͡ɕː uː ɾ
திருடன்	t̪ ɪ ɾ ʊ ɖ ɐ n
திருடு	t̪ ɪ ɾ ʊ ɖ ʊ
திருட்டு	t̪ ɪ ɾ ʊ ʈː ʊ
திருத்தம்	t̪ ɪ ɾ ʊ t̪ː ɐ m
திருத்து	t̪ ɪ ɾ ʊ t̪ː ʊ
திருநங்கை	t̪ ɪ ɾ ʊ n̪ ɐ ŋ ɡ ɐ ɪ̯
திருநம்பி	t̪ ɪ ɾ ʊ n̪ ɐ m b ɪ
திருநாமச்செடி	t̪ ɪ ɾ ʊ n̪ aː m ɐ t͡ɕː ɛ ɖ ɪ
திருநீற்றுப்பச்சை	t̪ ɪ ɾ ʊ n̪ iː rː ʊ pː ɐ t͡ɕː ɐ ɪ̯
திருநெல்வேலி	t̪ ɪ ɾ ʊ n̪ ɛ l ʋ eː l ɪ
திருந்து	t̪ ɪ ɾ ʊ n̪ d̪ ʊ
திருனர்	t̪ ɪ ɾ ʊ n ɐ ɾ
திருப்தி	t̪ ɪ ɾ ʊ p t̪ ɪ
திருப்பதி	t̪ ɪ ɾ ʊ pː ɐ d̪ ɪ
திருப்பத்தூர்	t̪ ɪ ɾ ʊ pː ɐ t̪ː uː ɾ
திருப்பலி	t̪ ɪ ɾ ʊ pː ɐ l ɪ
திருப்பு	t̪ ɪ ɾ ʊ pː ʊ
திருப்புகை	t̪ ɪ ɾ ʊ pː ʊ ɡ ɐ ɪ̯
திருப்புதல்	t̪ ɪ ɾ ʊ pː ʊ d̪ ɐ l
திருப்பூர்	t̪ ɪ ɾ ʊ pː uː ɾ
திருமகள்	t̪ ɪ ɾ ʊ m ɐ ɡ ɐ ɭ
திருமணம்	t̪ ɪ ɾ ʊ m ɐ ɳ ɐ m
திருமண்	t̪ ɪ ɾ ʊ m ɐ ɳ
திருமலை	t̪ ɪ ɾ ʊ m ɐ l ɐ ɪ̯
திருமால்	t̪ ɪ ɾ ʊ m aː l
திருமுகம்	t̪ ɪ ɾ ʊ m ʊ ɡ ɐ m
திருமுழுக்கு	t̪ ɪ ɾ ʊ m ʊ ɻ ʊ kː ʊ
திரும்ப	t̪ ɪ ɾ ʊ m b ɐ
திரும்பவும்	t̪ ɪ ɾ ʊ m b ɐ ʋ ʊ m
திரும்பு	t̪ ɪ ɾ ʊ m b ʊ
திருவண்ணாமலை	t̪ ɪ ɾ ʊ ʋ ɐ ɳː aː m ɐ l ɐ ɪ̯
திருவனந்தபுரம்	t̪ ɪ ɾ ʊ ʋ ɐ n ɐ n̪ d̪ ɐ b ʊ ɾ ɐ m
திருவருட்சாதனம்	t̪ ɪ ɾ ʊ ʋ ɐ ɾ ʊ ʈ t͡ɕ aː d̪ ɐ n ɐ m
திருவல்லிக்கேணி	t̪ ɪ ɾ ʊ ʋ ɐ l l ɪ kː eː ɳ ɪ
திருவள்ளூர்	t̪ ɪ ɾ ʊ ʋ ɐ ɭː uː ɾ
திருவாரூர்	t̪ ɪ ɾ ʊ ʋ aː ɾ uː ɾ
திருவிருந்து	t̪ ɪ ɾ ʊ ʋ ɪ ɾ ʊ n̪ d̪ ʊ
திருவிழா	t̪ ɪ ɾ ʊ ʋ ɪ ɻ aː
திரைப்படம்	t̪ ɪ ɾ ɐ ɪ̯ pː ɐ ɖ ɐ m
திற	t̪ ɪ r ɐ
திறன்பேசி	t̪ ɪ r ɐ n b eː t͡ɕ ɪ
திறமை	t̪ ɪ r ɐ m ɐ ɪ̯
திறவுகோல்	t̪ ɪ r ɐ ʋ ʊ ɡ oː l
தில்லம்	t̪ ɪ l l ɐ m
தில்லி	d̪ ɪ l l ɪ
திவ்விய	t̪ ɪ ʋː ɪ j ɐ
திவ்வியஸ்நானம்	t̪ ɪ ʋː ɪ j ɐ s n̪ aː n ɐ m
தீ	t̪ iː
தீக்கடல்	t̪ iː kː ɐ ɖ ɐ l
தீந்தமிழ்	t̪ iː n̪ d̪ ɐ m ɪ ɻ
தீனம்	t̪ iː n ɐ m
தீனி	t̪ iː n ɪ
தீனிப்பை	t̪ iː n ɪ pː ɐ ɪ̯
தீபம்	d̪ iː b ɐ m
தீபம்	d̪ iː p ɐ m
தீபஸ்தம்பம்	t̪ iː b ɐ s t̪ ɐ m b ɐ m
தீபாராதனை	t̪ iː b aː ɾ aː d̪ ɐ n ɐ ɪ̯
தீபிகை	t̪ iː b ɪ ɡ ɐ ɪ̯
தீமுறி	t̪ iː m ʊ r ɪ
தீமை	t̪ iː m ɐ ɪ̯
தீமொழி	t̪ iː m ɔ ɻ ɪ
தீய	t̪ iː j ɐ
தீர்	t̪ iː ɾ
தீர்க்கதரிசனங்கள்	t̪ iː ɾ kː ɐ d̪ ɐ ɾ ɪ t͡ɕ ɐ n ɐ ŋ ɡ ɐ ɭ
தீர்க்கதரிசனம்	t̪ iː ɾ kː ɐ d̪ ɐ ɾ ɪ t͡ɕ ɐ n ɐ m
தீர்க்கதரிசி	t̪ iː ɾ kː ɐ d̪ ɐ ɾ ɪ t͡ɕ ɪ
தீர்த்தம்	t̪ iː ɾ t̪ː ɐ m
தீர்ப்பு	t̪ iː ɾ pː ʊ
தீவினை	t̪ iː ʋ ɪ n ɐ ɪ̯
தீவிய	t̪ iː ʋ ɪ j ɐ
தீவிரகந்தம்	t̪ iː ʋ ɪ ɾ ɐ ɡ ɐ n̪ d̪ ɐ m
தீவிரகாசரோகம்	t̪ iː ʋ ɪ ɾ ɐ ɡ aː t͡ɕ ɐ ɾ oː ɡ ɐ m
தீவிரம்	t̪ iː ʋ ɪ ɾ ɐ m
தீவு	t̪ iː ʋ ʊ
துகான்	t̪ ʊ ɡ aː n
துக்கக்காரன்	t̪ ʊ kː ɐ kː aː ɾ ɐ n
துக்கம்	d̪ ʊ kː ɐ m
துக்கி	t̪ ʊ kː ɪ
துஞ்சு	t̪ ʊ ɲ d͡ʑ ʊ
துடவை	t̪ ʊ ɖ ɐ ʋ ɐ ɪ̯
துடுபு	t̪ ʊ ɖ ʊ b ʊ
துடுப்புக்காலி	t̪ ʊ ɖ ʊ pː ʊ kː aː l ɪ
துடை	t̪ ʊ ɖ ɐ ɪ̯
துடைப்பம்	t̪ ʊ ɖ ɐ ɪ̯ pː ɐ m
துட்டு	d̪ ʊ ɖ ɖ ʊ
துணி	t̪ ʊ ɳ ɪ
துணிவு	t̪ ʊ ɳ ɪ ʋ ʊ
துணை	t̪ ʊ ɳ ɐ ɪ̯
துணைக்கருவி	t̪ ʊ ɳ ɐ ɪ̯ kː ɐ ɾ ʊ ʋ ɪ
துணைமை	t̪ ʊ ɳ ɐ ɪ̯ m ɐ ɪ̯
துண்டி	t̪ ʊ ɳ ɖ ɪ
துண்டு	t̪ ʊ ɳ ɖ ʊ
துதி	t̪ ʊ d̪ ɪ
துத்தநாகம்	t̪ ʊ t̪ː ɐ n̪ aː ɡ ɐ m
துத்தம்	t̪ ʊ t̪ː ɐ m
துந்தம்	t̪ ʊ n̪ d̪ ɐ m
துந்தி	t̪ ʊ n̪ d̪ ɪ
துன்பம்	t̪ ʊ n b ɐ m
துன்புறுத்து	t̪ ʊ n b ʊ r ʊ t̪ː ʊ
துன்மதி	t̪ ʊ n m ɐ d̪ ɪ
துப்பம்	t̪ ʊ pː ɐ m
துப்பல்	t̪ ʊ pː ɐ l
துப்பாக்கி	t̪ ʊ pː aː kː ɪ
துப்பு	t̪ ʊ pː ʊ
தும்பி	t̪ ʊ m b ɪ
தும்பிக்கை	t̪ ʊ m b ɪ kː ɐ ɪ̯
தும்மல்	t̪ ʊ mː ɐ l
தும்மு	t̪ ʊ mː ʊ
துயில்	t̪ ʊ j ɪ l
துய்	t̪ ʊ j
துரியான்	t̪ ʊ ɾ ɪ j aː n
துருகம்	d̪ ʊ ɾ ʊ ɡ ɐ m
துருகம்	t̪ ʊ ɾ ʊ ɡ ɐ m
துருக்மெனிஸ்தான்	t̪ ʊ ɾ ʊ k m ɛ n ɪ s t̪ aː n
துருவவொளி	d̪ ʊ ɾ ʊ ʋ ɐ ʋ ɔ ɭ ɪ
துரோகம்	d̪ ɾ oː h ɐ m
துரோகம்	d̪ ʊ ɾ oː ɡ ɐ m
துரோகம்	t̪ ʊ ɾ oː ɡ ɐ m
துர்க்கை	t̪ ʊ ɾ kː ɐ ɪ̯
துர்நாற்றம்	t̪ ʊ ɾ n̪ aː rː ɐ m
துறப்பு	t̪ ʊ r ɐ pː ʊ
துறவறம்	t̪ ʊ r ɐ ʋ ɐ r ɐ m
துறவி	t̪ ʊ r ɐ ʋ ɪ
துறை	t̪ ʊ r ɐ ɪ̯
துறைமுகம்	t̪ ʊ r ɐ ɪ̯ m ʊ ɡ ɐ m
துலாம்	t̪ ʊ l aː m
துலுக்கச்செவ்வந்தி	t̪ ʊ l ʊ kː ɐ t͡ɕː ɛ ʋː ɐ n̪ d̪ ɪ
துளசி	t̪ ʊ ɭ ɐ t͡ɕ ɪ
துளி	t̪ ʊ ɭ ɪ
துளுவம்	t̪ ʊ ɭ ʊ ʋ ɐ m
துளை	t̪ ʊ ɭ ɐ ɪ̯
துவக்கு	t̪ ʊ ʋ ɐ kː ʊ
துவக்கூசி	t̪ ʊ ʋ ɐ kː uː t͡ɕ ɪ
துவரை	t̪ ʊ ʋ ɐ ɾ ɐ ɪ̯
துவாரம்	t̪ ʊ ʋ aː ɾ ɐ m
துவையல்	t̪ ʊ ʋ ɐ ɪ̯ j ɐ l
தூக்கம்	t̪ uː kː ɐ m
தூக்கு	t̪ uː kː ʊ
தூங்கு	t̪ uː ŋ ɡ ʊ
தூசரம்	t̪ uː t͡ɕ ɐ ɾ ɐ m
தூசி	d̪ uː t͡ɕ ɪ
தூசி	t̪ uː t͡ɕ ɪ
தூசு	t̪ uː t͡ɕ ʊ
தூண்	t̪ uː ɳ
தூண்டில்	t̪ uː ɳ ɖ ɪ l
தூதன்	d̪ uː d̪ ɐ n
தூதன்	t̪ uː d̪ ɐ n
தூத்துக்குடி	t̪ uː t̪ː ʊ kː ʊ ɖ ɪ
தூபி	t̪ uː b ɪ
தூமகேது	d̪ uː m a k eː d̪ u
தூமகேது	d̪ uː m ɐ k eː d̪ ɯ
தூய்	t̪ uː j
தூரம்	d̪ uː ɾ ɐ m
தூரம்	t̪ uː ɾ ɐ m
தூர்	t̪ uː ɾ
தூர்வாரு	t̪ uː ɾ ʋ aː ɾ ʊ
தூவல்	t̪ uː ʋ ɐ l
தூவி	t̪ uː ʋ ɪ
தூவு	t̪ uː ʋ ʊ
தூஷணம்	d̪ uː ʂ ɐ ɳ ɐ m
தெகுரான்	t̪ ɛ ɡ ʊ ɾ aː n
தெங்கு	t̪ ɛ ŋ ɡ ʊ
தெனாவட்டு	t̪ ɛ n aː ʋ ɐ ʈː ʊ
தென்	t̪ ɛ n
தென்காசி	t̪ ɛ n ɡ aː t͡ɕ ɪ
தென்கிழக்காசியா	t̪ ɛ n ɡ ɪ ɻ ɐ kː aː t͡ɕ ɪ j aː
தென்னாடு	t̪ ɛ nː aː ɖ ʊ
தென்மேற்கு	t̪ ɛ n m eː r k ʊ
தென்மொழி	t̪ ɛ n m ɔ ɻ ɪ
தென்றல்	t̪ ɛ n r ɐ l
தெப்பம்	t̪ ɛ pː ɐ m
தெய்வங்கள்	d̪ ɛ j ʋ ɐ ŋ ɡ ɐ ɭ
தெய்வம்	d̪ ɛ j ʋ ɐ m
தெரி	t̪ ɛ ɾ ɪ
தெரிந்துணர்ச்சி	t̪ ɛ ɾ ɪ n̪ d̪ ʊ ɳ ɐ ɾ t͡ɕː ɪ
தெரிபடு	t̪ ɛ ɾ ɪ b ɐ ɖ ʊ
தெரிப்பு	t̪ ɛ ɾ ɪ pː ʊ
தெரியல்	t̪ ɛ ɾ ɪ j ɐ l
தெரியவுணர்	t̪ ɛ ɾ ɪ j ɐ ʋ ʊ ɳ ɐ ɾ
தெரிவி	t̪ ɛ ɾ ɪ ʋ ɪ
தெரிவு	t̪ ɛ ɾ ɪ ʋ ʊ
தெரு	t̪ ɛ ɾ ʊ
தெருள்	t̪ ɛ ɾ ʊ ɭ
தெற்கு	t̪ ɛ r k ʊ
தெலங்காணா	t̪ ɛ l ɐ ŋ ɡ aː ɳ aː
தெலுங்கம்	t̪ ɛ l ʊ ŋ ɡ ɐ m
தெலுங்கு	t̪ ɛ l ʊ ŋ ɡ ʊ
தெளி	t̪ ɛ ɭ ɪ
தெளிவி	t̪ ɛ ɭ ɪ ʋ ɪ
தெளிவு	t̪ ɛ ɭ ɪ ʋ ʊ
தெள்ளு	t̪ ɛ ɭː ʊ
தெஹரான்	t̪ ɛ h ɐ ɾ aː n
தேகங்கள்	d̪ ɛ ɡ ɐ ŋ ɡ ɐ ɭ
தேகம்	d̪ eː h ɐ m
தேகம்	d̪ eː ɡ ɐ m
தேக்கர்	t̪ eː kː ɐ ɾ
தேக்கு	t̪ eː kː ʊ
தேங்காய்	t̪ eː ŋ ɡ aː j
தேசகன்	t̪ eː t͡ɕ ɐ ɡ ɐ n
தேசபாஷை	d̪ eː t͡ɕ ɐ b aː ʂ ɐ ɪ̯
தேசம்	d̪ eː t͡ɕ ɐ m
தேசாசாரம்	t̪ eː t͡ɕ aː t͡ɕ aː ɾ ɐ m
தேசாதிபதி	t̪ eː t͡ɕ aː d̪ ɪ b ɐ d̪ ɪ
தேசிய	t̪ eː t͡ɕ ɪ j ɐ
தேசீயவியக்கம்	t̪ eː t͡ɕ iː j ɐ ʋ ɪ j ɐ kː ɐ m
தேடு	t̪ eː ɖ ʊ
தேதி	t̪ eː d̪ ɪ
தேநீர்	t̪ eː n̪ iː ɾ
தேனடை	t̪ eː n ɐ ɖ ɐ ɪ̯
தேனி	t̪ eː n ɪ
தேனிறால்	t̪ eː n ɪ r aː l
தேனிலவு	t̪ eː n ɪ l ɐ ʋ ʊ
தேனீ	t̪ eː n iː
தேன்	t̪ eː n
தேன்கூடு	t̪ eː n ɡ uː ɖ ʊ
தேன்மொழி	t̪ eː n m ɔ ɻ ɪ
தேம்பாவணி	t̪ eː m b aː ʋ ɐ ɳ ɪ
தேய்	t̪ eː j
தேய்பிறை	t̪ eː j b ɪ r ɐ ɪ̯
தேய்வாங்கு	t̪ eː j ʋ aː ŋ ɡ ʊ
தேர்	t̪ eː ɾ
தேர்ச்சி	t̪ eː ɾ t͡ɕː ɪ
தேர்தல்	t̪ eː ɾ d̪ ɐ l
தேர்வு	t̪ eː ɾ ʋ ʊ
தேர்வுக்கூடம்	t̪ eː ɾ ʋ ʊ kː uː ɖ ɐ m
தேற்றம்	t̪ eː rː ɐ m
தேற்றா	t̪ eː rː aː
தேற்று	t̪ eː rː ʊ
தேள்	t̪ eː ɭ
தேவடியாள்	t̪ eː ʋ ɐ ɖ ɪ j aː ɭ
தேவதூதன்	t̪ eː ʋ ɐ d̪ uː d̪ ɐ n
தேவதூஷணம்	t̪ eː ʋ ɐ d̪ uː ʂ ɐ ɳ ɐ m
தேவதை	t̪ eː ʋ ɐ d̪ ɐ ɪ̯
தேவதைகள்	t̪ eː ʋ ɐ d̪ ɐ ɪ̯ ɡ ɐ ɭ
தேவன்	d̪ eː ʋ ɐ n
தேவன்	t̪ eː ʋ ɐ n
தேவவசீகரம்	t̪ eː ʋ ɐ ʋ ɐ t͡ɕ iː ɡ ɐ ɾ ɐ m
தேவஸ்தானம்	t̪ eː ʋ ɐ s t̪ aː n ɐ m
தேவாங்கர்	t̪ eː ʋ aː ŋ ɡ ɐ ɾ
தேவாங்கு	d̪ eː ʋ aː ŋ ɡ ʊ
தேவாங்கு	t̪ eː ʋ aː ŋ ɡ ʊ
தேவாலயம்	d̪ eː ʋ aː l ɐ j ɐ m
தேவாலயம்	t̪ eː ʋ aː l ɐ j ɐ m
தேவி	d̪ eː ʋ ɪ
தேவை	t̪ eː ʋ ɐ ɪ̯
தேவையான	t̪ eː ʋ ɐ ɪ̯ j aː n ɐ
தை	t̪ ɐ ɪ̯
தைரியம்	d̪ ɐ ɪ̯ ɾ ɪ j ɐ m
தைரியம்	t̪ ɐ ɪ̯ ɾ ɪ j ɐ m
தைலமிறக்கு	t̪ ɐ ɪ̯ l ɐ m ɪ r ɐ kː ʊ
தைலம்	t̪ ɐ ɪ̯ l ɐ m
தொகு	t̪ ɔ ɡ ʊ
தொகுதி	t̪ ɔ ɡ ʊ d̪ ɪ
தொகுதியெண்	t̪ ɔ ɡ ʊ d̪ ɪ j ɛ ɳ
தொகுப்பு	t̪ ɔ ɡ ʊ pː ʊ
தொகை	t̪ ɔ ɡ ɐ ɪ̯
தொங்கு	t̪ ɔ ŋ ɡ ʊ
தொடங்கல்	t̪ ɔ ɖ ɐ ŋ ɡ ɐ l
தொடங்கி	t̪ ɔ ɖ ɐ ŋ ɡ ɪ
தொடங்கு	t̪ ɔ ɖ ɐ ŋ ɡ ʊ
தொடரி	t̪ ɔ ɖ ɐ ɾ ɪ
தொடருந்து	t̪ ɔ ɖ ɐ ɾ ʊ n̪ d̪ ʊ
தொடர்	t̪ ɔ ɖ ɐ ɾ
தொடர்ச்சி	t̪ ɔ ɖ ɐ ɾ t͡ɕː ɪ
தொடர்ந்தேற்றி	t̪ ɔ ɖ ɐ ɾ n̪ d̪ eː rː ɪ
தொடர்பற	t̪ ɔ ɖ ɐ ɾ b ɐ r ɐ
தொடர்பு	t̪ ɔ ɖ ɐ ɾ b ʊ
தொடர்வண்டி	t̪ ɔ ɖ ɐ ɾ ʋ ɐ ɳ ɖ ɪ
தொடு	t̪ ɔ ɖ ʊ
தொடுகிலும்	t̪ ɔ ɖ ʊ ɡ ɪ l ʊ m
தொடுத்து	t̪ ɔ ɖ ʊ t̪ː ʊ
தொடுப்பு	t̪ ɔ ɖ ʊ pː ʊ
தொடை	t̪ ɔ ɖ ɐ ɪ̯
தொட்டி	t̪ ɔ ʈː ɪ
தொட்டு	t̪ ɔ ʈː ʊ
தொட்டுத்தொட்டு	t̪ ɔ ʈː ʊ t̪ː ɔ ʈː ʊ
தொண்டன்	t̪ ɔ ɳ ɖ ɐ n
தொண்டு	t̪ ɔ ɳ ɖ ʊ
தொண்டை	t̪ ɔ ɳ ɖ ɐ ɪ̯
தொண்ணூறு	t̪ ɔ ɳː uː r ʊ
தொந்தி	t̪ ɔ n̪ d̪ ɪ
தொனி	t̪ ɔ n ɪ
தொன்னை	t̪ ɔ nː ɐ ɪ̯
தொன்மங்கள்	t̪ ɔ n m ɐ ŋ ɡ ɐ ɭ
தொன்மம்	t̪ ɔ n m ɐ m
தொன்மவியல்	t̪ ɔ n m ɐ ʋ ɪ j ɐ l
தொன்மா	t̪ ɔ n m aː
தொன்மை	t̪ ɔ n m ɐ ɪ̯
தொன்று	t̪ ɔ n r ʊ
தொப்பி	t̪ ɔ pː ɪ
தொப்பை	t̪ ɔ pː ɐ ɪ̯
தொறவல்	t̪ ɔ r ɐ ʋ ɐ l
தொறுவு	t̪ ɔ r ʊ ʋ ʊ
தொற்று	t̪ ɔ rː ʊ
தொற்றுநோய்	t̪ ɔ rː ʊ n̪ oː j
தொலை	t̪ ɔ l ɐ ɪ̯
தொலைக்காட்சி	t̪ ɔ l ɐ ɪ̯ kː aː ʈ t͡ɕ ɪ
தொலைபேசி	t̪ ɔ l ɐ ɪ̯ b eː t͡ɕ ɪ
தொலையியக்கி	t̪ ɔ l ɐ ɪ̯ j ɪ j ɐ kː ɪ
தொலைவு	t̪ ɔ l ɐ ɪ̯ ʋ ʊ
தொல்	t̪ ɔ l
தொல்காப்பியம்	t̪ ɔ l ɡ aː pː ɪ j ɐ m
தொல்லியல்	t̪ ɔ l l ɪ j ɐ l
தொளை	t̪ ɔ ɭ ɐ ɪ̯
தொள்ளாயிரம்	t̪ ɔ ɭː aː j ɪ ɾ ɐ m
தொழினுட்பம்	t̪ ɔ ɻ ɪ n ʊ ʈ p ɐ m
தொழிற்சாலை	t̪ ɔ ɻ ɪ r t͡ɕ aː l ɐ ɪ̯
தொழிலாளி	t̪ ɔ ɻ ɪ l aː ɭ ɪ
தொழில்	t̪ ɔ ɻ ɪ l
தொழு	t̪ ɔ ɻ ʊ
தொழும்பு	t̪ ɔ ɻ ʊ m b ʊ
தொழுவன்	t̪ ɔ ɻ ʊ ʋ ɐ n
தொழுவம்	t̪ ɔ ɻ ʊ ʋ ɐ m
தொழுவர்	t̪ ɔ ɻ ʊ ʋ ɐ ɾ
தொழுவு	t̪ ɔ ɻ ʊ ʋ ʊ
தொழுவை	t̪ ɔ ɻ ʊ ʋ ɐ ɪ̯
தோகம்	t̪ oː ɡ ɐ m
தோகை	t̪ oː ɡ ɐ ɪ̯
தோசம்	t̪ oː t͡ɕ ɐ m
தோசிக்கொக்கு	t̪ oː t͡ɕ ɪ kː ɔ kː ʊ
தோசை	d̪ oː t͡ɕ ɐ ɪ̯
தோடு	t̪ oː ɖ ʊ
தோட்டம்	t̪ oː ʈː ɐ m
தோட்டிமை	t̪ oː ʈː ɪ m ɐ ɪ̯
தோணி	t̪ oː ɳ ɪ
தோணிதள்ளு	t̪ oː ɳ ɪ d̪ ɐ ɭː ʊ
தோணித்துறை	t̪ oː ɳ ɪ t̪ː ʊ r ɐ ɪ̯
தோண்டான்	t̪ oː ɳ ɖ aː n
தோண்டு	t̪ oː ɳ ɖ ʊ
தோத்திரம்	t̪ oː t̪ː ɪ ɾ ɐ m
தோன்று	t̪ oː n r ʊ
தோப்பி	t̪ oː pː ɪ
தோற்றம்	t̪ oː rː ɐ m
தோலியல்	t̪ oː l ɪ j ɐ l
தோல்	t̪ oː l
தோல்வி	t̪ oː l ʋ ɪ
தோள்	t̪ oː ɭ
தோழன்	t̪ oː ɻ ɐ n
தோழி	t̪ oː ɻ ɪ
தௌலத்	d̪ ɐ ʊ̯ l ɐ t̪
த்	i t̪
த்	i t̪ː ɯ
த்	t̪
ந	n̪ ɐ
நகம்	n̪ ɐ h ɐ m
நகம்	n̪ ɐ ɡ ɐ m
நகரப்பதி	n̪ ɐ ɡ ɐ ɾ ɐ pː ɐ d̪ ɪ
நகரமாந்தர்	n̪ ɐ ɡ ɐ ɾ ɐ m aː n̪ d̪ ɐ ɾ
நகரம்	n̪ ɐ ɡ ɐ ɾ ɐ m
நகர்	n̪ ɐ ɡ ɐ ɾ
நகர்த்து	n̪ ɐ ɡ ɐ ɾ t̪ː ʊ
நகை	n̪ ɐ ɡ ɐ ɪ̯
நகைச்சுவை	n̪ ɐ h ɐ ɪ̯ t͡ɕː ʊ ʋ ɐ ɪ̯
நகைச்சுவை	n̪ ɐ ɡ ɐ ɪ̯ t͡ɕː ʊ ʋ ɐ ɪ̯
நகோமி	n̪ ɐ ɡ oː m ɪ
நக்க	n̪ ɐ kː ɐ
நக்கம்	n̪ ɐ kː ɐ m
நக்கவரம்	n̪ ɐ kː ɐ ʋ ɐ ɾ ɐ m
நக்கு	n̪ ɐ kː ʊ
நங்கூரம்	n̪ ɐ ŋ ɡ uː ɾ ɐ m
நங்கை	n̪ ɐ ŋ ɡ ɐ ɪ̯
நசுக்கு	n̪ ɐ t͡ɕ ʊ kː ʊ
நசுங்கு	n̪ ɐ t͡ɕ ʊ ŋ ɡ ʊ
நச்சுயிரி	n̪ ɐ t͡ɕː ʊ j ɪ ɾ ɪ
நஞ்சு	n̪ ɐ ɲ d͡ʑ ʊ
நஞ்சுக்கொடி	n̪ ɐ ɲ d͡ʑ ʊ kː ɔ ɖ ɪ
நட	n̪ ɐ ɖ ɐ
நடக்கை	n̪ ɐ ɖ ɐ kː ɐ ɪ̯
நடத்து	n̪ ɐ ɖ ɐ t̪ː ʊ
நடத்தை	n̪ ɐ ɖ ɐ t̪ː ɐ ɪ̯
நடனம்	n̪ ɐ ɖ ɐ n ɐ m
நடப்பன	n̪ ɐ ɖ ɐ pː ɐ n ɐ
நடப்பிப்பு	n̪ ɐ ɖ ɐ pː ɪ pː ʊ
நடமாடு	n̪ ɐ ɖ ɐ m aː ɖ ʊ
நடராஜர்	n̪ ɐ ɖ ɐ ɾ aː d͡ʑ ɐ ɾ
நடலம்	n̪ ɐ ɖ ɐ l ɐ m
நடவடிக்கை	n̪ ɐ ɖ ɐ ʋ ɐ ɖ ɪ kː ɐ ɪ̯
நடவு	n̪ ɐ ɖ ɐ ʋ ʊ
நடி	n̪ ɐ ɖ ɪ
நடிகர்	n̪ ɐ ɖ ɪ ɡ ɐ ɾ
நடு	n̪ ɐ ɖ ʊ
நடுங்கு	n̪ ɐ ɖ ʊ ŋ ɡ ʊ
நடுவடிக்கை	n̪ ɐ ɖ ʊ ʋ ɐ ɖ ɪ kː ɐ ɪ̯
நடுவு	n̪ ɐ ɖ ʊ ʋ ʊ
நடுவுநிலை	n̪ ɐ ɖ ʊ ʋ ʊ n̪ ɪ l ɐ ɪ̯
நடுவுநிலைமை	n̪ ɐ ɖ ʊ ʋ ʊ n̪ ɪ l ɐ ɪ̯ m ɐ ɪ̯
நடை	n̪ ɐ ɖ ɐ ɪ̯
நடைகிணறு	n̪ ɐ ɖ ɐ ɪ̯ ɡ ɪ ɳ ɐ r ʊ
நடைபடி	n̪ ɐ ɖ ɐ ɪ̯ b ɐ ɖ ɪ
நடைப்பொன்	n̪ ɐ ɖ ɐ ɪ̯ pː ɔ n
நடைமேடை	n̪ ɐ ɖ ɐ ɪ̯ m eː ɖ ɐ ɪ̯
நடைமேடைகள்	n̪ ɐ ɖ ɐ ɪ̯ m eː ɖ ɐ ɪ̯ ɡ ɐ ɭ
நட்சத்திரமண்டலம்	n̪ ɐ ʈ t͡ɕ ɐ t̪ː ɪ ɾ ɐ m ɐ ɳ ɖ ɐ l ɐ m
நட்சத்திரம்	n̪ ɐ ʈ t͡ɕ ɐ t̪ː ɪ ɾ ɐ m
நட்டம்	n̪ ɐ ʈː ɐ m
நட்பு	n̪ ɐ ʈ p ʊ
நண்பகல்	n̪ ɐ ɳ b ɐ ɡ ɐ l
நண்பன்	n̪ ɐ ɳ b ɐ n
நதி	n̪ ɐ d̪ ɪ
நதிகேள்வன்	n̪ ɐ d̪ ɪ ɡ eː ɭ ʋ ɐ n
நத்தம்	n̪ ɐ t̪ː ɐ m
நத்தார்	n̪ ɐ t̪ː aː ɾ
நத்தை	n̪ ɐ t̪ː ɐ ɪ̯
நந்தி	n̪ ɐ n̪ d̪ ɪ
நனிசைவம்	n̪ ɐ n ɪ t͡ɕ ɐ ɪ̯ ʋ ɐ m
நன்கடத்தி	n̪ ɐ n k ɐ ɖ ɐ t̪ː i
நன்கு	n̪ ɐ n ɡ ʊ
நன்கொடை	n̪ ɐ n ɡ ɔ ɖ ɐ ɪ̯
நன்னாரி	n̪ ɐ nː aː ɾ ɪ
நன்னிறம்	n̪ ɐ nː ɪ r ɐ m
நன்னூல்	n̪ ɐ nː uː l
நன்பு	n̪ ɐ n b ʊ
நன்மை	n̪ ɐ n m ɐ ɪ̯
நன்றாக	n̪ ɐ n r aː ɡ ɐ
நன்றி	n̪ ɐ n r ɪ
நபம்	n̪ ɐ b ɐ m
நமன்	n̪ ɐ m ɐ n
நம்பி	n̪ ɐ m b ɪ
நம்பிக்கை	n̪ ɐ m b ɪ kː ɐ ɪ̯
நம்பு	n̪ ɐ m b ʊ
நரகம்	n̪ ɐ ɾ ɐ ɡ ɐ m
நரந்தம்	n̪ ɐ ɾ ɐ n̪ d̪ ɐ m
நரம்பியல்	n̪ ɐ ɾ ɐ m b ɪ j ɐ l
நரம்பு	n̪ ɐ ɾ ɐ m b ʊ
நரி	n̪ ɐ ɾ ɪ
நருமதை	n̪ ɐ ɾ ʊ m ɐ d̪ ɐ ɪ̯
நறுக்கு	n̪ ɐ r ʊ kː ʊ
நறுமணம்	n̪ ɐ r ʊ m ɐ ɳ ɐ m
நறுவல்லி	n̪ ɐ r ʊ ʋ ɐ l l ɪ
நறை	n̪ ɐ r ɐ ɪ̯
நற்கருணை	n̪ ɐ r k ɐ ɾ ʊ ɳ ɐ ɪ̯
நற்செய்தி	n̪ ɐ r t͡ɕ ɛ j d̪ ɪ
நற்றிணை	n̪ ɐ rː ɪ ɳ ɐ ɪ̯
நலம்	n̪ ɐ l ɐ m
நல்	n̪ ɐ l
நல்கு	n̪ ɐ l ɡ ʊ
நல்ல	n̪ ɐ l l ɐ
நல்லது	n̪ ɐ l l ɐ d̪ ʊ
நல்லவர்	n̪ ɐ l l ɐ ʋ ɐ ɾ
நல்லா	n̪ ɐ l l aː
நல்லூழ்	n̪ ɐ l l uː ɻ
நல்லொழுக்கம்	n̪ ɐ l l ɔ ɻ ʊ kː ɐ m
நல்வாக்கு	n̪ ɐ l ʋ aː kː ʊ
நளி	n̪ ɐ ɭ ɪ
நளினம்	n̪ ɐ ɭ ɪ n ɐ m
நள்ளி	n̪ ɐ ɭː ɪ
நள்ளிரவு	n̪ ɐ ɭː ɪ ɾ ɐ ʋ ʊ
நவம்பர்	n̪ ɐ ʋ ɐ m b ɐ ɾ
நவில்	n̪ ɐ ʋ ɪ l
நவீனம்	n̪ ɐ ʋ iː n ɐ m
நஷ்டம்	n̪ ɐ ʂ ʈ ɐ m
நா	n̪ aː
நாகசுரம்	n̪ aː ɡ ɐ t͡ɕ ʊ ɾ ɐ m
நாகப்பட்டினம்	n̪ aː ɡ ɐ pː ɐ ʈː ɪ n ɐ m
நாகம்	n̪ aː ɡ ɐ m
நாகரிகம்	n̪ aː ɡ ɐ ɾ ɪ ɡ ɐ m
நாகாலாந்து	n̪ aː ɡ aː l aː n̪ d̪ ʊ
நாக்கு	n̪ aː kː ʊ
நாங்கள்	n̪ aː ŋ ɡ ɐ ɭ
நாசம்	n̪ aː t͡ɕ ɐ m
நாசி	n̪ aː t͡ɕ ɪ
நாச்சியார்	n̪ aː t͡ɕː ɪ j aː ɾ
நாடகம்	n̪ aː ɖ ɐ ɡ ɐ m
நாடன்	n̪ aː ɖ ɐ n
நாடவர்	n̪ aː ɖ ɐ ʋ ɐ ɾ
நாடா	n̪ aː ɖ aː
நாடாளுமன்றம்	n̪ aː ɖ aː ɭ ʊ m ɐ n r ɐ m
நாடி	n̪ aː ɖ ɪ
நாடு	n̪ aː ɖ ʊ
நாடுகள்	n̪ aː ɖ ʊ ɡ ɐ ɭ
நாடோடி	n̪ aː ɖ oː ɖ ɪ
நாட்டம்	n̪ aː ʈː ɐ m
நாட்டாண்மை	n̪ aː ʈː aː ɳ m ɐ ɪ̯
நாட்டான்	n̪ aː ʈː aː n
நாட்டாமை	n̪ aː ʈː aː m ɐ ɪ̯
நாட்டார்	n̪ aː ʈː aː ɾ
நாட்டுமஞ்சட்சீனக்கிழங்கு	n̪ aː ʈː ʊ m ɐ ɲ d͡ʑ ɐ ʈ t͡ɕ iː n ɐ kː ɪ ɻ ɐ ŋ ɡ ʊ
நாணயம்	n̪ aː ɳ ɐ j ɐ m
நாணல்	n̪ aː ɳ ɐ l
நாண்	n̪ aː ɳ
நாதசுவரம்	n̪ aː d̪ ɐ t͡ɕ ʊ ʋ ɐ ɾ ɐ m
நாதஸ்வரம்	n̪ aː d̪ ɐ s ʋ ɐ ɾ ɐ m
நாத்திகம்	n̪ aː t̪ː ɪ ɡ ɐ m
நானூறு	n̪ aː n uː r ʊ
நான்	n̪ aː n
நான்கு	n̪ aː n ɡ ʊ
நான்முகன்	n̪ aː n m ʊ ɡ ɐ n
நாமக்கல்	n̪ aː m ɐ kː ɐ l
நாமம்	n̪ aː m ɐ m
நாம்	n̪ aː m
நாயகன்	n̪ aː j ɐ ɡ ɐ n
நாயகம்	n̪ aː j ɐ ɡ ɐ m
நாயனார்	n̪ aː j ɐ n aː ɾ
நாயுருவி	n̪ aː j ʊ ɾ ʊ ʋ ɪ
நாய்	n̪ aː j
நாய்க்குட்டி	n̪ aː j kː ʊ ʈː ɪ
நாராயணன்	n̪ aː ɾ aː j ɐ ɳ ɐ n
நாரை	n̪ aː ɾ ɐ ɪ̯
நார்	n̪ aː ɾ
நாறு	n̪ aː r ʊ
நாறுகட்டி	n̪ aː r ʊ ɡ ɐ ʈː ɪ
நாறுகரந்தை	n̪ aː r ʊ ɡ ɐ ɾ ɐ n̪ d̪ ɐ ɪ̯
நாறுநறுவிலி	n̪ aː r ʊ n̪ ɐ r ʊ ʋ ɪ l ɪ
நாற்காலி	n̪ aː r k aː l ɪ
நாற்பது	n̪ aː r p ɐ d̪ ʊ
நாற்றம்	n̪ aː rː ɐ m
நாற்று	n̪ aː rː ʊ
நாற்றுநடவு	n̪ aː rː ʊ n̪ ɐ ɖ ɐ ʋ ʊ
நாற்றுப்பாத்தி	n̪ aː rː ʊ pː aː t̪ː ɪ
நாலு	n̪ aː l ʊ
நால்	n̪ aː l
நால்கு	n̪ aː l ɡ ʊ
நாளுக்கு	n̪ aː ɭ ʊ kː ʊ
நாளுக்குநாள்	n̪ aː ɭ ʊ kː ʊ n̪ aː ɭ
நாளும்	n̪ aː ɭ ʊ m
நாளெல்லை	n̪ aː ɭ ɛ l l ɐ ɪ̯
நாளை	n̪ aː ɭ ɐ ɪ̯
நாள்	n̪ aː ɭ
நாள்மீன்	n̪ aː ɭ m iː n
நாழிகை	n̪ aː ɻ ɪ ɡ ɐ ɪ̯
நாவாய்	n̪ aː ʋ aː j
நாவு	n̪ aː ʋ ʊ
நிகண்டு	n̪ ɪ ɡ ɐ ɳ ɖ ʊ
நிகர்ப்பு	n̪ ɪ ɡ ɐ ɾ pː ʊ
நிகர்ப்புதம்	n̪ ɪ ɡ ɐ ɾ pː ʊ d̪ ɐ m
நிகழ்	n̪ ɪ ɡ ɐ ɻ
நிகழ்ச்சி	n̪ ɪ ɡ ɐ ɻ t͡ɕː ɪ
நிகழ்த்து	n̪ ɪ ɡ ɐ ɻ t̪ː ʊ
நிகழ்வு	n̪ ɪ ɡ ɐ ɻ ʋ ʊ
நிசப்தம்	n̪ ɪ t͡ɕ ɐ p t̪ ɐ m
நிசம்	n̪ ɪ t͡ɕ ɐ m
நிச்சயம்	n̪ ɪ t͡ɕː ɐ j ɐ m
நிச்சயி	n̪ ɪ t͡ɕː ɐ j ɪ
நிஜம்	n̪ ɪ d͡ʑ ɐ m
நிடூதனன்	n̪ ɪ ɖ uː d̪ ɐ n ɐ n
நிதானம்	n̪ ɪ d̪ aː n ɐ m
நிதியமைச்சர்	n̪ ɪ d̪ ɪ j ɐ m ɐ ɪ̯ t͡ɕː ɐ ɾ
நித்தியம்	n̪ ɪ t̪ː ɪ j ɐ m
நித்திரை	n̪ ɪ t̪ː ɪ ɾ ɐ ɪ̯
நித்திலம்	n̪ ɪ t̪ː ɪ l ɐ m
நிந்தனை	n̪ ɪ n̪ d̪ ɐ n ɐ ɪ̯
நினை	n̪ ɪ n ɐ ɪ̯
நினைப்பு	n̪ ɪ n ɐ ɪ̯ pː ʊ
நினைவகம்	n̪ ɪ n ɐ ɪ̯ ʋ ɐ ɡ ɐ m
நினைவு	n̪ ɪ n ɐ ɪ̯ ʋ ʊ
நின்	n̪ ɪ n
நின்று	n̪ ɪ n r ʊ
நிபந்தனை	n̪ ɪ b ɐ n̪ d̪ ɐ n ɐ ɪ̯
நிபானம்	n̪ ɪ b aː n ɐ m
நிபுணர்	n̪ ɪ b ʊ ɳ ɐ ɾ
நிமிடம்	n̪ ɪ m ɪ ɖ ɐ m
நிமிர்	n̪ ɪ m ɪ ɾ
நிமிஷம்	n̪ ɪ m ɪ ʂ ɐ m
நிம்மதி	n̪ ɪ mː ɐ d̪ ɪ
நியாசம்	n̪ ɪ j aː t͡ɕ ɐ m
நியாயம்	n̪ ɪ j aː j ɐ m
நியுதம்	n̪ ɪ j ʊ d̪ ɐ m
நிரந்தர	n̪ ɪ ɾ ɐ n̪ d̪ ɐ ɾ ɐ
நிரப்பு	n̪ ɪ ɾ ɐ pː ʊ
நிரம்ப	n̪ ɪ ɾ ɐ m b ɐ
நிரம்பு	n̪ ɪ ɾ ɐ m b ʊ
நிரல்	n̪ ɪ ɾ ɐ l
நிருபம்	n̪ ɪ ɾ ʊ b ɐ m
நிரூபணம்	n̪ ɪ ɾ uː b ɐ ɳ ɐ m
நிரூபி	n̪ ɪ ɾ uː b ɪ
நிரை	n̪ ɪ ɾ ɐ ɪ̯
நிரோதம்	n̪ ɪ ɾ oː d̪ ɐ m
நிர்ணயம்	n̪ ɪ ɾ ɳ ɐ j ɐ m
நிர்வாகம்	n̪ ɪ ɾ ʋ aː ɡ ɐ m
நிர்வாகி	n̪ ɪ ɾ ʋ aː ɡ ɪ
நிறமாலையியல்	n̪ ɪ r ɐ m aː l ɐ ɪ̯ j ɪ j ɐ l
நிறம்	n̪ ɪ r ɐ m
நிறுத்தக்குறி	n̪ ɪ r ʊ t̪ː ɐ kː ʊ r ɪ
நிறுத்து	n̪ ɪ r ʊ t̪ː ʊ
நிறுப்பான்	n̪ ɪ r ʊ pː aː n
நிறுவனம்	n̪ ɪ r ʊ ʋ ɐ n ɐ m
நிறுவு	n̪ ɪ r ʊ ʋ ʊ
நிறை	n̪ ɪ r ɐ ɪ̯
நிறைய	n̪ ɪ r ɐ ɪ̯ j ɐ
நிறைவு	n̪ ɪ r ɐ ɪ̯ ʋ ʊ
நிறைவேறு	n̪ ɪ r ɐ ɪ̯ ʋ eː r ʊ
நிலக்கடலை	n̪ ɪ l ɐ kː ɐ ɖ ɐ l ɐ ɪ̯
நிலங்கு	n̪ ɪ l ɐ ŋ ɡ ʊ
நிலநடுக்கம்	n̪ ɪ l ɐ n̪ ɐ ɖ ʊ kː ɐ m
நிலநடுக்கவியல்	n̪ ɪ l ɐ n̪ ɐ ɖ ʊ kː ɐ ʋ ɪ j ɐ l
நிலநடுக்கோடு	n̪ ɪ l ɐ n̪ ɐ ɖ ʊ kː oː ɖ ʊ
நிலப்படவரைவியல்	n̪ ɪ l ɐ pː ɐ ɖ ɐ ʋ ɐ ɾ ɐ ɪ̯ ʋ ɪ j ɐ l
நிலப்பனை	n̪ ɪ l ɐ pː ɐ n ɐ ɪ̯
நிலம்	n̪ ɪ l ɐ m
நிலவரி	n̪ ɪ l ɐ ʋ ɐ ɾ ɪ
நிலவியல்	n̪ ɪ l ɐ ʋ ɪ j ɐ l
நிலவு	n̪ ɪ l ɐ ʋ ʊ
நிலவேம்பு	n̪ ɪ l ɐ ʋ eː m b ʊ
நிலவொளி	n̪ ɪ l ɐ ʋ ɔ ɭ ɪ
நிலா	n̪ ɪ l aː
நிலாவெளிச்சம்	n̪ ɪ l aː ʋ ɛ ɭ ɪ t͡ɕː ɐ m
நிலை	n̪ ɪ l ɐ ɪ̯
நிலைகுலை	n̪ ɪ l ɐ ɪ̯ ɡ ʊ l ɐ ɪ̯
நிலைபெறு	n̪ ɪ l ɐ ɪ̯ b ɛ r ʊ
நிலைப்பு	n̪ ɪ l ɐ ɪ̯ pː ʊ
நிலைமை	n̪ ɪ l ɐ ɪ̯ m ɐ ɪ̯
நிலையம்	n̪ ɪ l ɐ ɪ̯ j ɐ m
நில்	n̪ ɪ l
நிழல்	n̪ ɪ ɻ ɐ l
நிவசதி	n̪ ɪ ʋ ɐ t͡ɕ ɐ d̪ ɪ
நிவப்பு	n̪ ɪ ʋ ɐ pː ʊ
நிவாசம்	n̪ ɪ ʋ aː t͡ɕ ɐ m
நிஷானி	n̪ ɪ ʂ aː n ɪ
நிஷ்டை	n̪ ɪ ʂ ʈ ɐ ɪ̯
நீ	n̪ iː
நீக்கம்	n̪ iː kː ɐ m
நீக்கல்	n̪ iː kː ɐ l
நீக்கு	n̪ iː kː ʊ
நீங்க	n̪ iː ŋ ɡ ɐ
நீங்கள்	n̪ iː ŋ ɡ ɐ ɭ
நீங்கு	n̪ iː ŋ ɡ ʊ
நீடி	n̪ iː ɖ ɪ
நீடு	n̪ iː ɖ ʊ
நீட்டாணம்	n̪ iː ʈː aː ɳ ɐ m
நீட்டி	n̪ iː ʈː ɪ
நீட்டிநட	n̪ iː ʈː ɪ n̪ ɐ ɖ ɐ
நீட்டு	n̪ iː ʈː ʊ
நீட்பம்	n̪ iː ʈ p ɐ m
நீண்டாயம்	n̪ iː ɳ ɖ aː j ɐ m
நீண்மை	n̪ iː ɳ m ɐ ɪ̯
நீதி	n̪ iː d̪ ɪ
நீதிபதி	n̪ iː d̪ ɪ b ɐ d̪ ɪ
நீதிமன்றம்	n̪ iː d̪ ɪ m ɐ n r ɐ m
நீதிமான்	n̪ iː d̪ ɪ m aː n
நீதிமொழிகள்	n̪ iː d̪ ɪ m ɔ ɻ ɪ ɡ ɐ ɭ
நீத்தம்	n̪ iː t̪ː ɐ m
நீத்து	n̪ iː t̪ː ʊ
நீந்து	n̪ iː n̪ d̪ ʊ
நீனு	n̪ iː n ʊ
நீரகம்	n̪ iː ɾ ɐ ɡ ɐ m
நீராடு	n̪ iː ɾ aː ɖ ʊ
நீராவி	n̪ iː ɾ aː ʋ ɪ
நீரியம்	n̪ iː ɾ ɪ j ɐ m
நீரிழிவு	n̪ iː ɾ ɪ ɻ ɪ ʋ ʊ
நீரொழுக்கு	n̪ iː ɾ ɔ ɻ ʊ kː ʊ
நீர்	n̪ iː ɾ
நீர்கொழும்பு	n̪ iː ɾ ɡ ɔ ɻ ʊ m b ʊ
நீர்க்காகம்	n̪ iː ɾ kː aː ɡ ɐ m
நீர்க்காக்கை	n̪ iː ɾ kː aː kː ɐ ɪ̯
நீர்க்கால்	n̪ iː ɾ kː aː l
நீர்நாய்	n̪ iː ɾ n̪ aː j
நீர்ப்புன்கு	n̪ iː ɾ pː ʊ n ɡ ʊ
நீர்மங்கை	n̪ iː ɾ m ɐ ŋ ɡ ɐ ɪ̯
நீர்மருது	n̪ iː ɾ m ɐ ɾ ʊ d̪ ʊ
நீர்வளம்	n̪ iː ɾ ʋ ɐ ɭ ɐ m
நீர்வாழை	n̪ iː ɾ ʋ aː ɻ ɐ ɪ̯
நீர்வீழ்ச்சி	n̪ iː ɾ ʋ iː ɻ t͡ɕː ɪ
நீலகண்டன்	n̪ iː l ɐ ɡ ɐ ɳ ɖ ɐ n
நீலகிரி	n̪ iː l ɐ ɡ ɪ ɾ ɪ
நீலக்கல்	n̪ iː l ɐ kː ɐ l
நீலம்	n̪ iː l ɐ m
நீலிரும்பு	n̪ iː l ɪ ɾ ʊ m b ʊ
நீளமான	n̪ iː ɭ ɐ m aː n ɐ
நீளம்	n̪ iː ɭ ɐ m
நீளிப்பு	n̪ iː ɭ ɪ pː ʊ
நீள்	n̪ iː ɭ
நுகம்	n̪ ʊ ɡ ɐ m
நுகர்	n̪ ʊ ɡ ɐ ɾ
நுகர்ச்சி	n̪ ʊ ɡ ɐ ɾ t͡ɕː ɪ
நுகைவு	n̪ ʊ ɡ ɐ ɪ̯ ʋ ʊ
நுங்கு	n̪ ʊ ŋ ɡ ʊ
நுடக்கு	n̪ ʊ ɖ ɐ kː ʊ
நுட்பம்	n̪ ʊ ʈ p ɐ m
நுண்ணோக்கி	n̪ ʊ ɳː oː kː ɪ
நுதல்	n̪ ʊ d̪ ɐ l
நுன்	n̪ ʊ n
நுரையீரல்	n̪ ʊ ɾ ɐ ɪ̯ j iː ɾ ɐ l
நுளம்பு	n̪ ʊ ɭ ɐ m b ʊ
நுழை	n̪ ʊ ɻ ɐ ɪ̯
நுழைவாசல்	n̪ ʊ ɻ ɐ ɪ̯ ʋ aː t͡ɕ ɐ l
நுழைவு	n̪ ʊ ɻ ɐ ɪ̯ ʋ ʊ
நுழைவுத்தேர்வு	n̪ ʊ ɻ ɐ ɪ̯ ʋ ʊ t̪ː eː ɾ ʋ ʊ
நூ	n̪ uː
நூதனசாலை	n̪ uː d̪ ɐ n ɐ t͡ɕ aː l ɐ ɪ̯
நூறாயிசு	n̪ uː r aː j ɪ t͡ɕ ʊ
நூறாயிரம்	n̪ uː r aː j ɪ ɾ ɐ m
நூறு	n̪ uː r ʊ
நூறுகோடி	n̪ uː r ʊ ɡ oː ɖ ɪ
நூலகம்	n̪ uː l ɐ ɡ ɐ m
நூலறிவு	n̪ uː l ɐ r ɪ ʋ ʊ
நூலாம்படை	n̪ uː l aː m b ɐ ɖ ɐ ɪ̯
நூல்	n̪ uː l
நெகிழி	n̪ ɛ ɡ ɪ ɻ ɪ
நெகிழிக்குப்பை	n̪ ɛ ɡ ɪ ɻ ɪ kː ʊ pː ɐ ɪ̯
நெகிழ்ச்சி	n̪ ɛ ɡ ɪ ɻ t͡ɕː ɪ
நெகேமியா	n̪ ɛ ɡ eː m ɪ j aː
நெசவாளர்	n̪ ɛ t͡ɕ ɐ ʋ aː ɭ ɐ ɾ
நெசவு	n̪ ɛ t͡ɕ ɐ ʋ ʊ
நெஞ்சம்	n̪ ɛ ɲ d͡ʑ ɐ m
நெஞ்சு	n̪ ɛ ɲ d͡ʑ ʊ
நெடில்	n̪ ɛ ɖ ɪ l
நெடுக	n̪ ɛ ɖ ʊ ɡ ɐ
நெடுகலும்	n̪ ɛ ɖ ʊ ɡ ɐ l ʊ m
நெடுநல்வாடை	n̪ ɛ ɖ ʊ n̪ ɐ l ʋ aː ɖ ɐ ɪ̯
நெடுநாரை	n̪ ɛ ɖ ʊ n̪ aː ɾ ɐ ɪ̯
நெட்டெழுத்து	n̪ ɛ ʈː ɛ ɻ ʊ t̪ː ʊ
நெட்டைநாரத்தை	n̪ ɛ ʈː ɐ ɪ̯ n̪ aː ɾ ɐ t̪ː ɐ ɪ̯
நென்மா	n̪ ɛ n m aː
நெம்புகோல்	n̪ ɛ m b ʊ ɡ oː l
நெய்	n̪ ɛ j
நெய்த்தோர்	n̪ ɛ j t̪ː oː ɾ
நெய்த்தோலி	n̪ ɛ j t̪ː oː l ɪ
நெய்ப்பு	n̪ ɛ j pː ʊ
நெய்யாடல்	n̪ ɛ jː aː ɖ ɐ l
நெருக்கு	n̪ ɛ ɾ ʊ kː ʊ
நெருங்கு	n̪ ɛ ɾ ʊ ŋ ɡ ʊ
நெருப்பு	n̪ ɛ ɾ ʊ pː ʊ
நெறி	n̪ ɛ r ɪ
நெறிமுறை	n̪ ɛ r ɪ m ʊ r ɐ ɪ̯
நெறிமுறைமை	n̪ ɛ r ɪ m ʊ r ɐ ɪ̯ m ɐ ɪ̯
நெறிமை	n̪ ɛ r ɪ m ɐ ɪ̯
நெற்றி	n̪ ɛ rː ɪ
நெல்லி	n̪ ɛ l l ɪ
நெளை	n̪ ɛ ɭ ɐ ɪ̯
நேசி	n̪ eː t͡ɕ ɪ
நேத்து	n̪ eː t̪ː ʊ
நேரப்பட	n̪ eː ɾ ɐ pː ɐ ɖ ɐ
நேரம்	n̪ eː ɾ ɐ m
நேர்ச்சி	n̪ eː ɾ t͡ɕː ɪ
நேர்த்தி	n̪ eː ɾ t̪ː ɪ
நேர்பாடு	n̪ eː ɾ b aː ɖ ʊ
நேர்முகத்தேர்வு	n̪ eː ɾ m ʊ ɡ ɐ t̪ː eː ɾ ʋ ʊ
நேர்மை	n̪ eː ɾ m ɐ ɪ̯
நேர்விடை	n̪ eː ɾ ʋ ɪ ɖ ɐ ɪ̯
நேர்வு	n̪ eː ɾ ʋ ʊ
நேற்று	n̪ eː rː ʊ
நேற்று	n̪ eː ʈː ʊ
நேற்றுமுந்தாநாள்	n̪ eː rː ʊ m ʊ n̪ d̪ aː n̪ aː ɭ
நேற்றையதினம்	n̪ eː rː ɐ ɪ̯ j ɐ d̪ ɪ n ɐ m
நைட்ரஜன்	n̪ ɐ ɪ̯ ʈ ɾ ɐ d͡ʑ ɐ n
நைனா	n̪ ɐ ɪ̯ n aː
நொடி	n̪ ɔ ɖ ɪ
நொடிப்பு	n̪ ɔ ɖ ɪ pː ʊ
நொண்டி	n̪ ɔ ɳ ɖ ɪ
நொர்ஸ்க்	n̪ ɔ ɾ s k
நொறுக்கு	n̪ ɔ r ʊ kː ʊ
நொறுங்கு	n̪ ɔ r ʊ ŋ ɡ ʊ
நோக்காடு	n̪ oː kː aː ɖ ʊ
நோக்கு	n̪ oː kː ʊ
நோண்டு	n̪ oː ɳ ɖ ʊ
நோன்பு	n̪ oː n b ʊ
நோய்	n̪ oː j
நௌ	n̪ ɐ ʊ̯
நௌகா	n̪ ɐ ʊ̯ ɡ aː
ந்	i n̪ d̪
ந்	i n̪ d̪ ɯ
ந்	n̪
ன	n ɐ
ன்	n
ப	p ɐ
பஃறி	p ɐ ɦ r i
பகடி	p ɐ ɡ ɐ ɖ ɪ
பகடையாட்டம்	p ɐ ɡ ɐ ɖ ɐ ɪ̯ j aː ʈː ɐ m
பகதத்தன்	p ɐ ɡ ɐ d̪ ɐ t̪ː ɐ n
பகன்	p ɐ ɡ ɐ n
பகரம்	p ɐ ɡ ɐ ɾ ɐ m
பகர்	p ɐ ɡ ɐ ɾ
பகர்ச்சி	p ɐ ɡ ɐ ɾ t͡ɕː ɪ
பகர்த்து	p ɐ ɡ ɐ ɾ t̪ː ʊ
பகல்	p ɐ ɡ ɐ l
பகவான்	b ɐ ɡ ɐ ʋ aː n
பகாங்	p ɐ ɡ aː ŋ
பகினி	p ɐ ɡ ɪ n ɪ
பகு	p ɐ ɡ ʊ
பகுதி	p ɐ ɡ ʊ d̪ ɪ
பகுத்தறிவு	p ɐ ɡ ʊ t̪ː ɐ r ɪ ʋ ʊ
பகுத்தல்	p ɐ ɡ ʊ t̪ː ɐ l
பகுப்பாய்வு	p ɐ ɡ ʊ pː aː j ʋ ʊ
பகை	p ɐ ɡ ɐ ɪ̯
பகைவன்	p ɐ ɡ ɐ ɪ̯ ʋ ɐ n
பக்கம்	p ɐ kː ɐ m
பக்கா	p ɐ kː aː
பக்குவம்	p ɐ kː ʊ ʋ ɐ m
பக்குவாசயம்	p ɐ kː ʊ ʋ aː t͡ɕ ɐ j ɐ m
பக்தி	b ɐ k t̪ ɪ
பக்ரித்	b ɐ k ɾ ɪ t̪
பக்ஷி	p ɐ k ʂ ɪ
பங்கம்	p ɐ ŋ ɡ ɐ m
பங்களா	b ɐ ŋ ɡ ɐ ɭ aː
பங்களி	p ɐ ŋ ɡ ɐ ɭ ɪ
பங்களிப்பு	p ɐ ŋ ɡ ɐ ɭ ɪ pː ʊ
பங்குனி	p ɐ ŋ ɡ ʊ n ɪ
பங்குரம்	p ɐ ŋ ɡ ʊ ɾ ɐ m
பசலிப்பழம்	p ɐ t͡ɕ ɐ l ɪ pː ɐ ɻ ɐ m
பசளி	p ɐ t͡ɕ ɐ ɭ ɪ
பசி	p ɐ t͡ɕ ɪ
பசியம்	p ɐ t͡ɕ ɪ j ɐ m
பசியாறை	p ɐ t͡ɕ ɪ j aː r ɐ ɪ̯
பசு	p ɐ t͡ɕ ʊ
பசுங்கோலா	p ɐ t͡ɕ ʊ ŋ ɡ oː l aː
பசுப்பு	p ɐ t͡ɕ ʊ pː ʊ
பசுமுன்னை	p ɐ t͡ɕ ʊ m ʊ nː ɐ ɪ̯
பசுமை	p ɐ t͡ɕ ʊ m ɐ ɪ̯
பசை	p ɐ t͡ɕ ɐ ɪ̯
பச்சிலை	p ɐ t͡ɕː ɪ l ɐ ɪ̯
பச்சுளி	p ɐ t͡ɕː ʊ ɭ ɪ
பச்சை	p ɐ t͡ɕː ɐ ɪ̯
பச்சைக்கல்	p ɐ t͡ɕː ɐ ɪ̯ kː ɐ l
பச்சோந்தி	p ɐ t͡ɕː oː n̪ d̪ ɪ
பச்சோந்திகள்	p ɐ t͡ɕː oː n̪ d̪ ɪ ɡ ɐ ɭ
பஞ்சம்	p ɐ ɲ d͡ʑ ɐ m
பஞ்சரம்	p ɐ ɲ d͡ʑ ɐ ɾ ɐ m
பஞ்சாப்	p ɐ ɲ d͡ʑ aː p
பஞ்சாயத்து	p ɐ ɲ d͡ʑ aː j ɐ t̪ː ʊ
பஞ்சு	p ɐ ɲ d͡ʑ ʊ
பஞ்சை	p ɐ ɲ d͡ʑ ɐ ɪ̯
படகு	p ɐ ɖ ɐ ɡ ʊ
படங்கள்	p ɐ ɖ ɐ ŋ ɡ ɐ ɭ
படப்பு	p ɐ ɖ ɐ pː ʊ
படப்பை	p ɐ ɖ ɐ pː ɐ ɪ̯
படமி	p ɐ ɖ ɐ m ɪ
படமிகள்	p ɐ ɖ ɐ m ɪ ɡ ɐ ɭ
படம்	p ɐ ɖ ɐ m
படல்	p ɐ ɖ ɐ l
படி	p ɐ ɖ ɪ
படிக்காரம்	p ɐ ɖ ɪ kː aː ɾ ɐ m
படிப்பறிவு	p ɐ ɖ ɪ pː ɐ r ɪ ʋ ʊ
படிப்பு	p ɐ ɖ ɪ pː ʊ
படிமம்	p ɐ ɖ ɪ m ɐ m
படிவம்	p ɐ ɖ ɪ ʋ ɐ m
படு	p ɐ ɖ ʊ
படுகுழி	p a ɖ u k u ɻ i
படுகை	p ɐ ɖ ʊ ɡ ɐ ɪ̯
படுக்கை	p ɐ ɖ ʊ kː ɐ ɪ̯
படுக்கைகள்	p ɐ ɖ ʊ kː ɐ ɪ̯ ɡ ɐ ɭ
படுத்தலோசை	p ɐ ɖ ʊ t̪ː ɐ l oː t͡ɕ ɐ ɪ̯
படுத்து	p ɐ ɖ ʊ t̪ː ʊ
படை	p ɐ ɖ ɐ ɪ̯
படைப்பு	p ɐ ɖ ɐ ɪ̯ pː ʊ
படையாளன்	p ɐ ɖ ɐ ɪ̯ j aː ɭ ɐ n
பட்சி	p ɐ ʈ t͡ɕ ɪ
பட்டணம்	p ɐ ʈː ɐ ɳ ɐ m
பட்டபோது	p a ʈː a p oː d̪ u
பட்டபோது	p ɐ ʈː ɐ p oː d̪ ɯ
பட்டாசு	p ɐ ʈː aː t͡ɕ ʊ
பட்டாணி	p ɐ ʈː aː ɳ ɪ
பட்டாம்பூச்சி	p ɐ ʈː aː m b uː t͡ɕː ɪ
பட்டாம்பூச்சிகள்	p ɐ ʈː aː m b uː t͡ɕː ɪ ɡ ɐ ɭ
பட்டி	p ɐ ʈː ɪ
பட்டிகை	p ɐ ʈː ɪ ɡ ɐ ɪ̯
பட்டினி	p ɐ ʈː ɪ n ɪ
பட்டு	p ɐ ʈː ʊ
பட்டுப்பூச்சி	p ɐ ʈː ʊ pː uː t͡ɕː ɪ
பட்டை	p ɐ ʈː ɐ ɪ̯
பணப்பை	p ɐ ɳ ɐ pː ɐ ɪ̯
பணம்	p ɐ ɳ ɐ m
பணவன்	p ɐ ɳ ɐ ʋ ɐ n
பணவீக்கம்	p ɐ ɳ ɐ ʋ iː kː ɐ m
பணாகரம்	p ɐ ɳ aː ɡ ɐ ɾ ɐ m
பணி	p ɐ ɳ ɪ
பணிகோள்	p ɐ ɳ ɪ ɡ oː ɭ
பணிக்கன்	p ɐ ɳ ɪ kː ɐ n
பணிதி	p ɐ ɳ ɪ d̪ ɪ
பணிமுட்டு	p ɐ ɳ ɪ m ʊ ʈː ʊ
பணியாரம்	p ɐ ɳ ɪ j aː ɾ ɐ m
பணிவு	p ɐ ɳ ɪ ʋ ʊ
பணையம்	p ɐ ɳ ɐ ɪ̯ j ɐ m
பண்டபதார்த்தம்	p ɐ ɳ ɖ ɐ b ɐ d̪ aː ɾ t̪ː ɐ m
பண்டம்	p ɐ ɳ ɖ ɐ m
பண்டாரம்	p ɐ ɳ ɖ aː ɾ ɐ m
பண்டாரவாய்க்கால்	p ɐ ɳ ɖ aː ɾ ɐ ʋ aː j kː aː l
பண்டிகை	p ɐ ɳ ɖ ɪ ɡ ɐ ɪ̯
பண்டிதன்	p ɐ ɳ ɖ ɪ d̪ ɐ n
பண்டிதம்	p ɐ ɳ ɖ ɪ d̪ ɐ m
பண்ணவன்	p ɐ ɳː ɐ ʋ ɐ n
பண்ணு	p ɐ ɳː ʊ
பண்ணை	p ɐ ɳː ɐ ɪ̯
பண்பாடு	p ɐ ɳ b aː ɖ ʊ
பண்பு	p ɐ ɳ b ʊ
பதக்கம்	p ɐ d̪ ɐ kː ɐ m
பதப்படுத்து	p ɐ d̪ ɐ pː ɐ ɖ ʊ t̪ː ʊ
பதற்றம்	p ɐ d̪ ɐ rː ɐ m
பதலை	p ɐ d̪ ɐ l ɐ ɪ̯
பதவி	p ɐ d̪ ɐ ʋ ɪ
பதாகை	p ɐ d̪ aː ɡ ɐ ɪ̯
பதி	p ɐ d̪ ɪ
பதினான்கு	p ɐ d̪ ɪ n aː n ɡ ʊ
பதினாயிரம்	p ɐ d̪ ɪ n aː j ɪ ɾ ɐ m
பதினாறு	p ɐ d̪ ɪ n aː r ʊ
பதினெட்டு	p ɐ d̪ ɪ n ɛ ʈː ʊ
பதினேழு	p ɐ d̪ ɪ n eː ɻ ʊ
பதினைந்து	p ɐ d̪ ɪ n ɐ ɪ̯ n̪ d̪ ʊ
பதினொன்று	p ɐ d̪ ɪ n ɔ n r ʊ
பதிப்பகம்	p ɐ d̪ ɪ pː ɐ ɡ ɐ m
பதிப்பு	p ɐ d̪ ɪ pː ʊ
பதிப்புரிமை	p ɐ d̪ ɪ pː ʊ ɾ ɪ m ɐ ɪ̯
பதிமுகம்	p ɐ d̪ ɪ m ʊ ɡ ɐ m
பதிமூன்று	p ɐ d̪ ɪ m uː n r ʊ
பதியம்	p ɐ d̪ ɪ j ɐ m
பதில்	b ɐ d̪ ɪ l
பதில்	p ɐ d̪ ɪ l
பதிவகம்	p ɐ d̪ ɪ ʋ ɐ ɡ ɐ m
பதிவிறக்கம்	p ɐ d̪ ɪ ʋ ɪ r ɐ kː ɐ m
பதிவு	p ɐ d̪ ɪ ʋ ʊ
பதிவேற்றம்	p ɐ d̪ ɪ ʋ eː rː ɐ m
பதுமம்	p ɐ d̪ ʊ m ɐ m
பதுமாசனம்	p ɐ d̪ ʊ m aː t͡ɕ ɐ n ɐ m
பதுளை	p ɐ d̪ ʊ ɭ ɐ ɪ̯
பத்ததி	p ɐ t̪ː ɐ d̪ ɪ
பத்தனம்திட்டா	p ɐ t̪ː ɐ n ɐ m t̪ ɪ ʈː aː
பத்தர்	p ɐ t̪ː ɐ ɾ
பத்தா	p ɐ t̪ː aː
பத்தி	p ɐ t̪ː ɪ
பத்தினி	p ɐ t̪ː ɪ n ɪ
பத்திமை	p ɐ t̪ː ɪ m ɐ ɪ̯
பத்தியம்	p ɐ t̪ː ɪ j ɐ m
பத்திரன்	p ɐ t̪ː ɪ ɾ ɐ n
பத்திரம்	p ɐ t̪ː ɪ ɾ ɐ m
பத்திராசனம்	p ɐ t̪ː ɪ ɾ aː t͡ɕ ɐ n ɐ m
பத்து	p ɐ t̪ː ʊ
பத்துப்பாட்டு	p ɐ t̪ː ʊ pː aː ʈː ʊ
பத்தொன்பது	p ɐ t̪ː ɔ n b ɐ d̪ ʊ
பந்தனம்	p ɐ n̪ d̪ ɐ n ɐ m
பந்தம்	p ɐ n̪ d̪ ɐ m
பந்தர்	p ɐ n̪ d̪ ɐ ɾ
பந்தல்	p ɐ n̪ d̪ ɐ l
பந்தா	b ɐ n̪ d̪ aː
பந்தி	p ɐ n̪ d̪ ɪ
பந்து	p ɐ n̪ d̪ ʊ
பனாயிப்பு	p ɐ n aː j ɪ pː ʊ
பனி	p ɐ n ɪ
பனிக்கட்டி	p ɐ n ɪ kː ɐ ʈː ɪ
பனிக்காற்று	p ɐ n ɪ kː aː rː ʊ
பனிக்கூழ்	p ɐ n ɪ kː uː ɻ
பனிமூட்டம்	p ɐ n ɪ m uː ʈː ɐ m
பனியன்	b ɐ n ɪ j ɐ n
பனியன்கள்	p ɐ n ɪ j ɐ n ɡ ɐ ɭ
பனை	p ɐ n ɐ ɪ̯
பன்னாட்டு	p ɐ nː aː ʈː ʊ
பன்னி	p ɐ nː ɪ
பன்னிரண்டு	p ɐ nː ɪ ɾ ɐ ɳ ɖ ʊ
பன்னீர்	p ɐ nː iː ɾ
பன்றி	p ɐ n r ɪ
பன்றிக்குட்டி	p ɐ n r ɪ kː ʊ ʈː ɪ
பப்படம்	p ɐ pː ɐ ɖ ɐ m
பப்பாளி	p ɐ pː aː ɭ ɪ
பம்பரம்	b ɐ m b ɐ ɾ ɐ m
பம்பரம்	p ɐ m b ɐ ɾ ɐ m
பம்பை	p ɐ m b ɐ ɪ̯
பயணம்	p ɐ j ɐ ɳ ɐ m
பயணி	p ɐ j ɐ ɳ ɪ
பயனர்	p ɐ j ɐ n ɐ ɾ
பயன்	p ɐ j ɐ n
பயன்படு	p ɐ j ɐ n b ɐ ɖ ʊ
பயன்பாடு	p ɐ j ɐ n b aː ɖ ʊ
பயப்படு	b ɐ j ɐ pː ɐ ɖ ʊ
பயமுறுத்து	b ɐ j ɐ m ʊ r ʊ t̪ː ʊ
பயம்	p ɐ j ɐ m
பயறு	p ɐ j ɐ r ʊ
பயிரடைப்பு	p ɐ j ɪ ɾ ɐ ɖ ɐ ɪ̯ pː ʊ
பயிரிடு	p ɐ j ɪ ɾ ɪ ɖ ʊ
பயிருழவு	p ɐ j ɪ ɾ ʊ ɻ ɐ ʋ ʊ
பயிர்	p ɐ j ɪ ɾ
பயிர்க்குடி	p ɐ j ɪ ɾ kː ʊ ɖ ɪ
பயிர்க்குழி	p ɐ j ɪ ɾ kː ʊ ɻ ɪ
பயிர்ச்செலவு	p ɐ j ɪ ɾ t͡ɕː ɛ l ɐ ʋ ʊ
பயிர்த்தொழில்	p ɐ j ɪ ɾ t̪ː ɔ ɻ ɪ l
பயிர்வழி	p ɐ j ɪ ɾ ʋ ɐ ɻ ɪ
பயிற்சி	p ɐ j ɪ r t͡ɕ ɪ
பயிற்சியாளர்	p ɐ j ɪ r t͡ɕ ɪ j aː ɭ ɐ ɾ
பயில்	p ɐ j ɪ l
பய்யன்	p ɐ jː ɐ n
பரங்கி	p ɐ ɾ ɐ ŋ ɡ ɪ
பரணி	p ɐ ɾ ɐ ɳ ɪ
பரதகண்டம்	p ɐ ɾ ɐ d̪ ɐ ɡ ɐ ɳ ɖ ɐ m
பரதநாட்டியம்	b ɐ ɾ ɐ d̪ ɐ n̪ aː ʈː ɪ j ɐ m
பரதநாட்டியம்	p ɐ ɾ ɐ d̪ ɐ n̪ aː ʈː ɪ j ɐ m
பரபரப்பு	p ɐ ɾ ɐ b ɐ ɾ ɐ pː ʊ
பரப்பு	p ɐ ɾ ɐ pː ʊ
பரமபதம்	p ɐ ɾ ɐ m ɐ p ɐ d̪ ɐ m
பரம்பொருள்	p a ɾ̪ a m p o ɾ̪ u ɭ
பரலோகம்	p ɐ ɾ ɐ l oː ɡ ɐ m
பரவசம்	p ɐ ɾ ɐ ʋ ɐ t͡ɕ ɐ m
பரவல்	p ɐ ɾ ɐ ʋ ɐ l
பரவு	p ɐ ɾ ɐ ʋ ʊ
பரவெளி	p ɐ ɾ ɐ ʋ ɛ ɭ ɪ
பராசக்தி	p ɐ ɾ aː t͡ɕ ɐ k t̪ ɪ
பராமரி	p ɐ ɾ aː m ɐ ɾ ɪ
பராமரிப்பு	p ɐ ɾ aː m ɐ ɾ ɪ pː ʊ
பரி	p ɐ ɾ ɪ
பரிசில்	p ɐ ɾ ɪ t͡ɕ ɪ l
பரிசீலனை	p ɐ ɾ ɪ t͡ɕ iː l ɐ n ɐ ɪ̯
பரிசு	p ɐ ɾ ɪ t͡ɕ ʊ
பரிசுத்த	p ɐ ɾ ɪ t͡ɕ ʊ t̪ː ɐ
பரிசுத்தம்	p ɐ ɾ ɪ t͡ɕ ʊ t̪ː ɐ m
பரிசுத்தாவி	p ɐ ɾ ɪ t͡ɕ ʊ t̪ː aː ʋ ɪ
பரிசோதனை	p ɐ ɾ ɪ t͡ɕ oː d̪ ɐ n ɐ ɪ̯
பரிட்சை	p ɐ ɾ ɪ ʈ t͡ɕ ɐ ɪ̯
பரிதானம்	p ɐ ɾ ɪ d̪ aː n ɐ m
பரிதி	p ɐ ɾ ɪ d̪ ɪ
பரிதியம்	p ɐ ɾ ɪ d̪ ɪ j ɐ m
பரிமளம்	p ɐ ɾ ɪ m ɐ ɭ ɐ m
பரிமாற்றம்	p ɐ ɾ ɪ m aː rː ɐ m
பரிவாரம்	p ɐ ɾ ɪ ʋ aː ɾ ɐ m
பரிவு	p ɐ ɾ ɪ ʋ ʊ
பரீட்சை	p ɐ ɾ iː ʈ t͡ɕ ɐ ɪ̯
பரு	p ɐ ɾ ʊ
பருந்து	p ɐ ɾ ʊ n̪ d̪ ʊ
பருப்பதம்	p ɐ ɾ ʊ pː ɐ d̪ ɐ m
பருப்பு	p ɐ ɾ ʊ pː ʊ
பருப்பொருள்	p ɐ ɾ ʊ pː ɔ ɾ ʊ ɭ
பருவக்காற்று	p ɐ ɾ ʊ ʋ ɐ kː aː rː ʊ
பருவங்கள்	p ɐ ɾ ʊ ʋ ɐ ŋ ɡ ɐ ɭ
பருவதம்	p ɐ ɾ ʊ ʋ ɐ d̪ ɐ m
பருவமழை	p ɐ ɾ ʊ ʋ ɐ m ɐ ɻ ɐ ɪ̯
பருவுழவு	p ɐ ɾ ʊ ʋ ʊ ɻ ɐ ʋ ʊ
பரோட்டா	b ɐ ɾ oː ʈː aː
பரோட்டா	p ɐ ɾ oː ʈː aː
பர்ணம்	p ɐ ɾ ɳ ɐ m
பர்வதம்	p ɐ ɾ ʋ ɐ d̪ ɐ m
பற	p ɐ r ɐ
பறக்கும்தட்டு	p ɐ r ɐ kː ʊ m t̪ ɐ ʈː ʊ
பறங்கிப்பாஷாணம்	p ɐ r ɐ ŋ ɡ ɪ pː aː ʂ aː ɳ ɐ m
பறந்தலை	p ɐ r ɐ n̪ d̪ ɐ l ɐ ɪ̯
பறப்பன்	p ɐ r ɐ pː ɐ n
பறவை	p ɐ r ɐ ʋ ɐ ɪ̯
பறவையியல்	p ɐ r ɐ ʋ ɐ ɪ̯ j ɪ j ɐ l
பறி	p ɐ r ɪ
பறை	p ɐ r ɐ ɪ̯
பற்கள்	p ɐ r k ɐ ɭ
பற்தூரிகை	p ɐ r t̪ uː ɾ ɪ ɡ ɐ ɪ̯
பற்பசை	p ɐ r p ɐ t͡ɕ ɐ ɪ̯
பற்றவை	p ɐ rː ɐ ʋ ɐ ɪ̯
பற்றாக்குறை	p ɐ rː aː kː ʊ r ɐ ɪ̯
பற்றி	p ɐ rː ɪ
பற்று	p ɐ rː ʊ
பல	p ɐ l ɐ
பலகை	p ɐ l ɐ ɡ ɐ ɪ̯
பலப்பம்	p ɐ l ɐ pː ɐ m
பலம்	b ɐ l ɐ m
பலம்	p ɐ l ɐ m
பலர்	p ɐ l ɐ ɾ
பலவீனம்	b ɐ l ɐ ʋ iː n ɐ m
பலவு	p ɐ l ɐ ʋ ʊ
பலா	p ɐ l aː
பலாசம்	p ɐ l aː t͡ɕ ɐ m
பலாப்பழம்	p ɐ l aː pː ɐ ɻ ɐ m
பலி	b ɐ l ɪ
பலி	p ɐ l ɪ
பலிகடா	p ɐ l i k ɐ ɖ aː
பலிபீடம்	b ɐ l ɪ b iː ɖ ɐ m
பலுக்கல்	p ɐ l ʊ kː ɐ l
பல்	p ɐ l
பல்கலைக்கழகம்	p ɐ l ɡ ɐ l ɐ ɪ̯ kː ɐ ɻ ɐ ɡ ɐ m
பல்காலும்	p ɐ l ɡ aː l ʊ m
பல்லக்கு	p ɐ l l ɐ kː ʊ
பல்லணம்	p ɐ l l ɐ ɳ ɐ m
பல்லவர்	p ɐ l l ɐ ʋ ɐ ɾ
பல்லாண்டு	p ɐ l l aː ɳ ɖ ʊ
பல்லி	b ɐ l l ɪ
பல்லி	p ɐ l l ɪ
பல்வலம்	p ɐ l ʋ ɐ l ɐ m
பல்வேறு	p ɐ l ʋ eː r ʊ
பல்வைத்தியன்	p ɐ l ʋ ɐ ɪ̯ t̪ː ɪ j ɐ n
பளகு	p ɐ ɭ ɐ ɡ ʊ
பளக்கு	p ɐ ɭ ɐ kː ʊ
பளபள	p a ɭ a p a ɭ a
பளிச்சிடு	p ɐ ɭ ɪ t͡ɕː ɪ ɖ ʊ
பளு	p ɐ ɭ ʊ
பள்ளக்குடி	p ɐ ɭː ɐ kː ʊ ɖ ɪ
பள்ளத்தாக்கு	p ɐ ɭː ɐ t̪ː aː kː ʊ
பள்ளம்	p ɐ ɭː ɐ m
பள்ளி	p ɐ ɭː ɪ
பள்ளிக்கல்வி	p ɐ ɭː ɪ kː ɐ l ʋ ɪ
பள்ளிக்கூடம்	p ɐ ɭː ɪ kː uː ɖ ɐ m
பள்ளிவாசல்	p ɐ ɭː ɪ ʋ aː t͡ɕ ɐ l
பழகு	p ɐ ɻ ɐ ɡ ʊ
பழக்கம்	p ɐ ɻ ɐ kː ɐ m
பழச்சாறு	p ɐ ɻ ɐ t͡ɕː aː r ʊ
பழந்தமிழ்	p ɐ ɻ ɐ n̪ d̪ ɐ m ɪ ɻ
பழமை	p ɐ ɻ ɐ m ɐ ɪ̯
பழமொழி	p ɐ ɻ ɐ m ɔ ɻ ɪ
பழம்	p ɐ ɻ ɐ m
பழம்பாடம்	p ɐ ɻ ɐ m b aː ɖ ɐ m
பழி	p ɐ ɻ ɪ
பழிச்சு	p ɐ ɻ ɪ t͡ɕː ʊ
பழீயம்	p ɐ ɻ iː j ɐ m
பழு	p ɐ ɻ ʊ
பழுது	p ɐ ɻ ʊ d̪ ʊ
பழுப்பு	p ɐ ɻ ʊ pː ʊ
பழுவம்	p ɐ ɻ ʊ ʋ ɐ m
பழைய	p ɐ ɻ ɐ ɪ̯ j ɐ
பவளங்கள்	p ɐ ʋ ɐ ɭ ɐ ŋ ɡ ɐ ɭ
பவளப்பாறை	p ɐ ʋ ɐ ɭ ɐ pː aː r ɐ ɪ̯
பவளம்	p ɐ ʋ ɐ ɭ ɐ m
பவழம்	p ɐ ʋ ɐ ɻ ɐ m
பவிகம்	p ɐ ʋ ɪ ɡ ɐ m
பவிஷு	p ɐ ʋ ɪ ʂ ʊ
பவுன்	p ɐ ʋ ʊ n
பவுல்	p ɐ ʋ ʊ l
பவ்வம்	p ɐ ʋː ɐ m
பாகம்	b aː ɡ ɐ m
பாகம்	p aː ɡ ɐ m
பாகற்காய்	p aː ɡ ɐ r k aː j
பாகு	p aː ɡ ʊ
பாகுபடு	p aː ɡ ʊ b ɐ ɖ ʊ
பாசம்	p aː t͡ɕ ɐ m
பாசி	p aː t͡ɕ ɪ
பாசுரம்	p aː t͡ɕ ʊ ɾ ɐ m
பாசை	b aː t͡ɕ ɐ ɪ̯
பாசை	p aː t͡ɕ ɐ ɪ̯
பாடகர்	p aː ɖ ɐ ɡ ɐ ɾ
பாடசாலை	p aː ɖ ɐ t͡ɕ aː l ɐ ɪ̯
பாடணம்	p aː ɖ ɐ ɳ ɐ m
பாடம்	p aː ɖ ɐ m
பாடம்போற்று	p aː ɖ ɐ m b oː rː ʊ
பாடல்	p aː ɖ ɐ l
பாடு	p aː ɖ ʊ
பாட்டன்	p aː ʈː ɐ n
பாட்டி	p aː ʈː ɪ
பாட்டு	p aː ʈː ʊ
பாணன்	b aː ɳ ɐ n
பாணன்	p aː ɳ ɐ n
பாணம்	b aː ɳ ɐ m
பாண்டிச்சேரி	p aː ɳ ɖ ɪ t͡ɕː eː ɾ ɪ
பாண்டியர்	p aː ɳ ɖ ɪ j ɐ ɾ
பாதம்	p aː d̪ ɐ m
பாதலத்தாம்பி	p aː d̪ ɐ l ɐ t̪ː aː m b ɪ
பாதாம்	b aː d̪ aː m
பாதாளம்	p aː d̪ aː ɭ ɐ m
பாதி	b aː d̪ ɪ
பாதி	p aː d̪ ɪ
பாதிச்சாமம்	p aː d̪ ɪ t͡ɕː aː m ɐ m
பாதிடு	p aː d̪ ɪ ɖ ʊ
பாதிப்பு	b aː d̪ ɪ pː ʊ
பாதிரியார்	p aː d̪ ɪ ɾ ɪ j aː ɾ
பாதுகா	p aː d̪ ʊ ɡ aː
பாதுகாப்பு	p aː d̪ ʊ ɡ aː pː ʊ
பாதை	p aː d̪ ɐ ɪ̯
பாதைகள்	p aː d̪ ɐ ɪ̯ ɡ ɐ ɭ
பாத்தி	p aː t̪ː ɪ
பாத்திரம்	p aː t̪ː ɪ ɾ ɐ m
பானம்	b aː n ɐ m
பானை	p aː n ɐ ɪ̯
பாப்பா	p aː pː aː
பாப்பாத்தி	p aː pː aː t̪ː ɪ
பாம்பன்	p aː m b ɐ n
பாம்பாட்டி	p aː m b aː ʈː ɪ
பாம்பு	p aː m b ʊ
பாயசம்	p aː j ɐ t͡ɕ ɐ m
பாயா	p aː j aː
பாய்	p aː j
பாய்மரம்	p aː j m ɐ ɾ ɐ m
பாரசீகம்	p aː ɾ ɐ t͡ɕ iː ɡ ɐ m
பாரதம்	b aː ɾ ɐ d̪ ɐ m
பாரம்	b aː ɾ ɐ m
பாரம்	p aː ɾ ɐ m
பாரம்பரியம்	p aː ɾ ɐ m b ɐ ɾ ɪ j ɐ m
பாராட்டு	p aː ɾ aː ʈː ʊ
பாராளுமன்றம்	p aː ɾ aː ɭ ʊ m ɐ n r ɐ m
பாரிசவாதம்	p aː ɾ ɪ t͡ɕ ɐ ʋ aː d̪ ɐ m
பாரியை	p aː ɾ ɪ j ɐ ɪ̯
பாரிஸ்	p aː ɾ ɪ s
பார்	p aː ɾ
பார்லி	p aː ɾ l ɪ
பார்வை	p aː ɾ ʋ ɐ ɪ̯
பார்வையாளர்	p aː ɾ ʋ ɐ ɪ̯ j aː ɭ ɐ ɾ
பாறை	p aː r ɐ ɪ̯
பாறையியல்	p aː r ɐ ɪ̯ j ɪ j ɐ l
பாற்கடல்	p aː r k ɐ ɖ ɐ l
பாற்பசு	p aː r p ɐ t͡ɕ ʊ
பாலக்காடு	p aː l ɐ kː aː ɖ ʊ
பாலம்	p aː l ɐ m
பாலாறு	p aː l aː r ʊ
பாலினம்	p aː l ɪ n ɐ m
பாலுறவு	p aː l ʊ r ɐ ʋ ʊ
பாலூட்டி	p aː l uː ʈː ɪ
பாலூட்டிகள்	p aː l uː ʈː ɪ ɡ ɐ ɭ
பாலை	p aː l ɐ ɪ̯
பாலைவனம்	p aː l ɐ ɪ̯ ʋ ɐ n ɐ m
பால்	p aː l
பால்புதுமை	p aː l b ʊ d̪ ʊ m ɐ ɪ̯
பாழ்	p aː ɻ
பாவம்	p aː ʋ ɐ m
பாவிப்பு	p aː ʋ ɪ pː ʊ
பாஷை	b aː ʂ ɐ ɪ̯
பாஷ்கொர்டொஸ்தான்	b aː ʂ k ɔ ɾ ɖ ɔ s t̪ aː n
பாஷ்தூ	p aː ʂ t̪ uː
பிகு	p ɪ ɡ ʊ
பிகுபண்ணு	p ɪ ɡ ʊ b ɐ ɳː ʊ
பிகுப்பட்டை	p ɪ ɡ ʊ pː ɐ ʈː ɐ ɪ̯
பிகுவேற்று	p ɪ ɡ ʊ ʋ eː rː ʊ
பிக்ஷு	b ɪ k ʂ ʊ
பிங்கதிருட்டி	p ɪ ŋ ɡ ɐ d̪ ɪ ɾ ʊ ʈː ɪ
பிங்கம்	p ɪ ŋ ɡ ɐ m
பிங்கலகேசி	p ɪ ŋ ɡ ɐ l ɐ ɡ eː t͡ɕ ɪ
பிங்கலம்	p ɪ ŋ ɡ ɐ l ɐ m
பிங்கலை	p ɪ ŋ ɡ ɐ l ɐ ɪ̯
பிசகு	p ɪ t͡ɕ ɐ ɡ ʊ
பிசகுசொல்லு	p ɪ t͡ɕ ɐ ɡ ʊ t͡ɕ ɔ l l ʊ
பிசகுநாறு	p ɪ t͡ɕ ɐ ɡ ʊ n̪ aː r ʊ
பிசக்கு	p ɪ t͡ɕ ɐ kː ʊ
பிசங்கம்	p ɪ t͡ɕ ɐ ŋ ɡ ɐ m
பிசங்கற்சீலை	p ɪ t͡ɕ ɐ ŋ ɡ ɐ r t͡ɕ iː l ɐ ɪ̯
பிசங்கு	p ɪ t͡ɕ ɐ ŋ ɡ ʊ
பிசண்டம்	p ɪ t͡ɕ ɐ ɳ ɖ ɐ m
பிசண்டிலன்	p ɪ t͡ɕ ɐ ɳ ɖ ɪ l ɐ n
பிசனம்	p ɪ t͡ɕ ɐ n ɐ m
பிசம்	p ɪ t͡ɕ ɐ m
பிசறு	p ɪ t͡ɕ ɐ r ʊ
பிசறுதல்	p ɪ t͡ɕ ɐ r ʊ d̪ ɐ l
பிசாசக்கை	p ɪ t͡ɕ aː t͡ɕ ɐ kː ɐ ɪ̯
பிசாசடித்தல்	p ɪ t͡ɕ aː t͡ɕ ɐ ɖ ɪ t̪ː ɐ l
பிசாசன்	p ɪ t͡ɕ aː t͡ɕ ɐ n
பிசாசர்	p ɪ t͡ɕ aː t͡ɕ ɐ ɾ
பிசாசாடுதல்	p ɪ t͡ɕ aː t͡ɕ aː ɖ ʊ d̪ ɐ l
பிசாசுபிடித்தல்	p ɪ t͡ɕ aː t͡ɕ ʊ b ɪ ɖ ɪ t̪ː ɐ l
பிசாத்து	p ɪ t͡ɕ aː t̪ː ʊ
பிசான்	p ɪ t͡ɕ aː n
பிசி	p ɪ t͡ɕ ɪ
பிசிதாசனர்	p ɪ t͡ɕ ɪ d̪ aː t͡ɕ ɐ n ɐ ɾ
பிசினரக்கு	p ɪ t͡ɕ ɪ n ɐ ɾ ɐ kː ʊ
பிசினரிசி	p ɪ t͡ɕ ɪ n ɐ ɾ ɪ t͡ɕ ɪ
பிசினி	p ɪ t͡ɕ ɪ n ɪ
பிசின்	p ɪ t͡ɕ ɪ n
பிசின்பட்டை	p ɪ t͡ɕ ɪ n b ɐ ʈː ɐ ɪ̯
பிசிர்தல்	p ɪ t͡ɕ ɪ ɾ d̪ ɐ l
பிசிறுலாடு	p ɪ t͡ɕ ɪ r ʊ l aː ɖ ʊ
பிசுகு	p ɪ t͡ɕ ʊ ɡ ʊ
பிசுகுதல்	p ɪ t͡ɕ ʊ ɡ ʊ d̪ ɐ l
பிசுக்கோத்து	p ɪ t͡ɕ ʊ kː oː t̪ː ʊ
பிசுனம்	p ɪ t͡ɕ ʊ n ɐ m
பிசுபிசு	p ɪ t͡ɕ ʊ b ɪ t͡ɕ ʊ
பிசுபிசுத்தல்	p ɪ t͡ɕ ʊ b ɪ t͡ɕ ʊ t̪ː ɐ l
பிசுபிசுத்தவன்	p ɪ t͡ɕ ʊ b ɪ t͡ɕ ʊ t̪ː ɐ ʋ ɐ n
பிசுபிசெனல்	p ɪ t͡ɕ ʊ b ɪ t͡ɕ ɛ n ɐ l
பிசுமந்தச்சூரணம்	p ɪ t͡ɕ ʊ m ɐ n̪ d̪ ɐ t͡ɕː uː ɾ ɐ ɳ ɐ m
பிசை	p ɪ t͡ɕ ɐ ɪ̯
பிசைதல்	p ɪ t͡ɕ ɐ ɪ̯ d̪ ɐ l
பிச்சு	p ɪ t͡ɕː ʊ
பிச்சுநெட்டி	p ɪ t͡ɕː ʊ n̪ ɛ ʈː ɪ
பிச்சுப்பை	p ɪ t͡ɕː ʊ pː ɐ ɪ̯
பிச்சை	p ɪ t͡ɕː ɐ ɪ̯
பிச்சைத்தனம்	p ɪ t͡ɕː ɐ ɪ̯ t̪ː ɐ n ɐ m
பிச்சைவாரி	p ɪ t͡ɕː ɐ ɪ̯ ʋ aː ɾ ɪ
பிஞ்சிற்பழு	p ɪ ɲ d͡ʑ ɪ r p ɐ ɻ ʊ
பிஞ்சு	p ɪ ɲ d͡ʑ ʊ
பிடுங்கு	p ɪ ɖ ʊ ŋ ɡ ʊ
பிட்கு	p ɪ ʈ k ʊ
பிட்டு	p ɪ ʈː ʊ
பிணந்தின்னி	p ɪ ɳ ɐ n̪ d̪ ɪ nː ɪ
பிணம்	p ɪ ɳ ɐ m
பிண்டம்	p ɪ ɳ ɖ ɐ m
பிண்டி	p ɪ ɳ ɖ ɪ
பிதா	p ɪ d̪ aː
பிதுங்கு	p ɪ d̪ ʊ ŋ ɡ ʊ
பித்தப்பை	p ɪ t̪ː ɐ pː ɐ ɪ̯
பித்தம்	p ɪ t̪ː ɐ m
பினாங்கு	p ɪ n aː ŋ ɡ ʊ
பின்	p ɪ n
பின்கட்டுமாறுகட்டு	p ɪ n ɡ ɐ ʈː ʊ m aː r ʊ ɡ ɐ ʈː ʊ
பின்னப்படுத்து	p ɪ nː ɐ pː ɐ ɖ ʊ t̪ː ʊ
பின்னம்	p ɪ nː ɐ m
பின்னவன்	p ɪ nː ɐ ʋ ɐ n
பின்னவள்	p ɪ nː ɐ ʋ ɐ ɭ
பின்னாடி	p ɪ nː aː ɖ ɪ
பின்னாற்போ	p ɪ nː aː r p oː
பின்னாலே	p ɪ nː aː l eː
பின்னிரக்கம்	p ɪ nː ɪ ɾ ɐ kː ɐ m
பின்னு	p ɪ nː ʊ
பின்னும்	p ɪ nː ʊ m
பின்பனி	p ɪ n b ɐ n ɪ
பின்பு	p ɪ n b ʊ
பின்போடு	p ɪ n b oː ɖ ʊ
பின்போடுதல்	p ɪ n b oː ɖ ʊ d̪ ɐ l
பின்மொழிநிலையல்	p ɪ n m ɔ ɻ ɪ n̪ ɪ l ɐ ɪ̯ j ɐ l
பின்லாந்து	p ɪ n l aː n̪ d̪ ʊ
பின்வாங்கு	p ɪ n ʋ aː ŋ ɡ ʊ
பிப்ரவரி	p ɪ b ɾ ɐ ʋ ɐ ɾ ɪ
பிய்	p ɪ j
பிரகடனம்	p ɪ ɾ ɐ ɡ ɐ ɖ ɐ n ɐ m
பிரகஸ்பதி	b r ɨ h ɐ s p a d̪ ɪ
பிரகஸ்பதி	b ɪ ɾ ɐ ɡ ɐ s p ɐ d̪ ɪ
பிரகாசம்	p ɪ ɾ ɐ ɡ aː t͡ɕ ɐ m
பிரகாசிதம்	p ɪ ɾ ɐ ɡ aː t͡ɕ ɪ d̪ ɐ m
பிரகாரம்	p ɪ ɾ ɐ ɡ aː ɾ ɐ m
பிரசங்கங்கள்	p ɪ ɾ ɐ t͡ɕ ɐ ŋ ɡ ɐ ŋ ɡ ɐ ɭ
பிரசங்கம்	p ɪ ɾ ɐ t͡ɕ ɐ ŋ ɡ ɐ m
பிரசங்கி	p ɪ ɾ ɐ t͡ɕ ɐ ŋ ɡ ɪ
பிரசாதம்	p ɪ ɾ ɐ t͡ɕ aː d̪ ɐ m
பிரசினம்	p ɪ ɾ ɐ t͡ɕ ɪ n ɐ m
பிரசேசுவரன்	p ɪ ɾ ɐ t͡ɕ eː t͡ɕ ʊ ʋ ɐ ɾ ɐ n
பிரச்சனை	p ɪ ɾ ɐ t͡ɕː ɐ n ɐ ɪ̯
பிரச்சனைகள்	p ɪ ɾ ɐ t͡ɕː ɐ n ɐ ɪ̯ ɡ ɐ ɭ
பிரச்சினை	p ɪ ɾ ɐ t͡ɕː ɪ n ɐ ɪ̯
பிரச்சினைகள்	p ɪ ɾ ɐ t͡ɕː ɪ n ɐ ɪ̯ ɡ ɐ ɭ
பிரஞ்சு	p ɪ ɾ ɐ ɲ d͡ʑ ʊ
பிரதமம்	p ɪ ɾ ɐ d̪ ɐ m ɐ m
பிரதிமை	p ɪ ɾ ɐ d̪ ɪ m ɐ ɪ̯
பிரதிஷ்டை	p ɪ ɾ ɐ d̪ ɪ ʂ ʈ ɐ ɪ̯
பிரதேசம்	p ɪ ɾ ɐ d̪ eː t͡ɕ ɐ m
பிரபஞ்சம்	p ɪ ɾ ɐ b ɐ ɲ d͡ʑ ɐ m
பிரபந்தம்	p ɪ ɾ ɐ b ɐ n̪ d̪ ɐ m
பிரபந்தம்	p ɾ ɐ b ɐ n̪ d̪ ɐ m
பிரபலம்	p ɪ ɾ ɐ b ɐ l ɐ m
பிரபாகரன்	p ɪ ɾ ɐ b aː ɡ ɐ ɾ ɐ n
பிரபாகரன்	p ɾ a b aː k a ɾ a n
பிரபு	p ɪ ɾ ɐ b ʊ
பிரபை	p ɪ ɾ ɐ b ɐ ɪ̯
பிரபோதிகை	p ɪ ɾ ɐ b oː d̪ ɪ ɡ ɐ ɪ̯
பிரமாணம்	p ɪ ɾ ɐ m aː ɳ ɐ m
பிரமாதமான	p ɪ ɾ ɐ m aː d̪ ɐ m aː n ɐ
பிரமை	b ɪ ɾ ɐ m ɐ ɪ̯
பிரமை	p ɪ ɾ ɐ m ɐ ɪ̯
பிரம்மபுத்திரா	p ɪ ɾ ɐ mː ɐ b ʊ t̪ː ɪ ɾ aː
பிரயோசனம்	p ɪ ɾ ɐ j oː t͡ɕ ɐ n ɐ m
பிரயோஜனம்	p ɪ ɾ ɐ j oː d͡ʑ ɐ n ɐ m
பிரளயம்	p ɪ ɾ ɐ ɭ ɐ j ɐ m
பிரளயம்	p ɾ ɐ ɭ ɐ j ɐ m
பிராசாதம்	p ɪ ɾ aː t͡ɕ aː d̪ ɐ m
பிராசீரம்	p ɪ ɾ aː t͡ɕ iː ɾ ɐ m
பிராட்டி	p ɪ ɾ aː ʈː ɪ
பிராணவாயு	p ɪ ɾ aː ɳ ɐ ʋ aː j ʊ
பிராத்தல்	p ɪ ɾ aː t̪ː ɐ l
பிராந்தியம்	p ɪ ɾ aː n̪ d̪ ɪ j ɐ m
பிரான்ஸ்	p ɪ ɾ aː n s
பிராயம்	p ɪ ɾ aː j ɐ m
பிரார்த்தனை	p ɪ ɾ aː ɾ t̪ː ɐ n ɐ ɪ̯
பிரி	p ɪ ɾ ɪ
பிரியன்	p ɪ ɾ ɪ j ɐ n
பிரியப்படுத்து	p ɪ ɾ ɪ j ɐ pː ɐ ɖ ʊ t̪ː ʊ
பிரியம்	p ɪ ɾ ɪ j ɐ m
பிரிவு	p ɪ ɾ ɪ ʋ ʊ
பிருதிவி	p ɪ ɾ ʊ d̪ ɪ ʋ ɪ
பிருத்தியன்	p ɪ ɾ ʊ t̪ː ɪ j ɐ n
பிரேதம்	p ɪ ɾ eː d̪ ɐ m
பிற	p ɪ r ɐ
பிறகிடு	p ɪ r ɐ ɡ ɪ ɖ ʊ
பிறகு	p ɪ r ɐ ɡ ʊ
பிறகுகாண்ணு	p ɪ r ɐ ɡ ʊ ɡ aː ɳː ʊ
பிறங்கு	p ɪ r ɐ ŋ ɡ ʊ
பிறந்தநாள்	p ɪ r ɐ n̪ d̪ ɐ n̪ aː ɭ
பிறந்தவம்	p ɪ r ɐ n̪ d̪ ɐ ʋ ɐ m
பிறந்தை	p ɪ r ɐ n̪ d̪ ɐ ɪ̯
பிறப்பிலி	p ɪ r ɐ pː ɪ l ɪ
பிறப்பு	p ɪ r ɐ pː ʊ
பிறப்புவழி	p ɪ r ɐ pː ʊ ʋ ɐ ɻ ɪ
பிறழ்	p ɪ r ɐ ɻ
பிறவி	p ɪ r ɐ ʋ ɪ
பிறவிக்கடல்	p ɪ r ɐ ʋ ɪ kː ɐ ɖ ɐ l
பிறவிக்குணம்	p ɪ r ɐ ʋ ɪ kː ʊ ɳ ɐ m
பிறவிக்குருடன்	p ɪ r ɐ ʋ ɪ kː ʊ ɾ ʊ ɖ ɐ n
பிறவிப்பயன்	p ɪ r ɐ ʋ ɪ pː ɐ j ɐ n
பிறாண்டு	p ɪ r aː ɳ ɖ ʊ
பிறிதின்கிழமை	p ɪ r ɪ d̪ ɪ n ɡ ɪ ɻ ɐ m ɐ ɪ̯
பிறிதுசாபம்	p ɪ r ɪ d̪ ʊ t͡ɕ aː b ɐ m
பிறை	p ɪ r ɐ ɪ̯
பிறைதொழு	p ɪ r ɐ ɪ̯ d̪ ɔ ɻ ʊ
பிறைதொழுதல்	p ɪ r ɐ ɪ̯ d̪ ɔ ɻ ʊ d̪ ɐ l
பிற்கழி	p ɪ r k ɐ ɻ ɪ
பிற்காலி	p ɪ r k aː l ɪ
பிற்கு	p ɪ r k ʊ
பிற்கூழை	p ɪ r k uː ɻ ɐ ɪ̯
பிற்சாமம்	p ɪ r t͡ɕ aː m ɐ m
பிற்பகல்	p ɪ r p ɐ ɡ ɐ l
பிற்பக்கம்	p ɪ r p ɐ kː ɐ m
பிற்படை	p ɪ r p ɐ ɖ ɐ ɪ̯
பிற்பாடர்	p ɪ r p aː ɖ ɐ ɾ
பிலிப்பீன்சு	p ɪ l ɪ pː iː n t͡ɕ ʊ
பிலிப்பைன்ஸ்	p ɪ l ɪ pː ɐ ɪ̯ n s
பிலிம்பி	p ɪ l ɪ m b ɪ
பில்லி	p ɪ l l ɪ
பிளிறு	p ɪ ɭ ɪ r ʊ
பிளிற்று	p ɪ ɭ ɪ rː ʊ
பிள்ளை	p ɪ ɭː ɐ ɪ̯
பிள்ளையாரெறும்பு	p ɪ ɭː ɐ ɪ̯ j aː ɾ ɛ r ʊ m b ʊ
பிள்ளையார்	p ɪ ɭː ɐ ɪ̯ j aː ɾ
பிள்ளையார்பையன்	p ɪ ɭː ɐ ɪ̯ j aː ɾ b ɐ ɪ̯ j ɐ n
பிழக்கு	p ɪ ɻ ɐ kː ʊ
பிழம்பு	p ɪ ɻ ɐ m b ʊ
பிழி	p ɪ ɻ ɪ
பிழை	p ɪ ɻ ɐ ɪ̯
பிழைப்பு	p ɪ ɻ ɐ ɪ̯ pː ʊ
பீ	p iː
பீகார்	b iː h aː ɾ
பீகார்	b iː ɡ aː ɾ
பீசுகோலா	p iː t͡ɕ ʊ ɡ oː l aː
பீடி	b iː ɖ ɪ
பீடிப்பு	p iː ɖ ɪ pː ʊ
பீட்ரூட்	p iː ʈ ɾ uː ʈ
பீரிதம்	p iː ɾ ɪ d̪ ɐ m
பீர்க்கங்காய்	p iː ɾ kː ɐ ŋ ɡ aː j
பீர்க்கம்	p iː ɾ kː ɐ m
புகடு	p ʊ ɡ ɐ ɖ ʊ
புகட்டு	p ʊ ɡ ɐ ʈː ʊ
புகலிடம்	p ʊ ɡ ɐ l ɪ ɖ ɐ m
புகல்	p ʊ ɡ ɐ l
புகல்வு	p ʊ ɡ ɐ l ʋ ʊ
புகழ்	p ʊ ɡ ɐ ɻ
புகு	p ʊ ɡ ʊ
புகுது	p ʊ ɡ ʊ d̪ ʊ
புகுத்து	p ʊ ɡ ʊ t̪ː ʊ
புகை	p ʊ ɡ ɐ ɪ̯
புகைப்படங்கள்	p ʊ ɡ ɐ ɪ̯ pː ɐ ɖ ɐ ŋ ɡ ɐ ɭ
புகைப்படம்	p ʊ ɡ ɐ ɪ̯ pː ɐ ɖ ɐ m
புகைவண்டி	p ʊ ɡ ɐ ɪ̯ ʋ ɐ ɳ ɖ ɪ
புக்கில்	p ʊ kː ɪ l
புசி	p ʊ t͡ɕ ɪ
புசிப்பு	p ʊ t͡ɕ ɪ pː ʊ
புஜம்	b ʊ d͡ʑ ɐ m
புடவை	p ʊ ɖ ɐ ʋ ɐ ɪ̯
புடை	p ʊ ɖ ɐ ɪ̯
புடைபெயர்ச்சி	p ʊ ɖ ɐ ɪ̯ b ɛ j ɐ ɾ t͡ɕː ɪ
புடைப்பு	p ʊ ɖ ɐ ɪ̯ pː ʊ
புடைமண்	p ʊ ɖ ɐ ɪ̯ m ɐ ɳ
புடைவை	p ʊ ɖ ɐ ɪ̯ ʋ ɐ ɪ̯
புட்டி	p ʊ ʈː ɪ
புட்பம்	p ʊ ʈ p ɐ m
புட்பராகம்	p ʊ ʈ p ɐ ɾ aː ɡ ɐ m
புட்பாகம்	p ʊ ʈ p aː ɡ ɐ m
புணர்	p ʊ ɳ ɐ ɾ
புணர்ச்சி	p ʊ ɳ ɐ ɾ t͡ɕː ɪ
புண்	p ʊ ɳ
புண்டரம்	p ʊ ɳ ɖ ɐ ɾ ɐ m
புண்டை	p ʊ ɳ ɖ ɐ ɪ̯
புண்ணாக்கு	p ʊ ɳː aː kː ʊ
புண்ணியம்	p ʊ ɳː ɪ j ɐ m
புதன்	b ʊ d̪ ɐ n
புதன்கிழமை	b ʊ d̪ ɐ n ɡ ɪ ɻ ɐ m ɐ ɪ̯
புதல்வன்	p ʊ d̪ ɐ l ʋ ɐ n
புதினம்	p ʊ d̪ ɪ n ɐ m
புதினா	p ʊ d̪ ɪ n aː
புதிய	p ʊ d̪ ɪ j ɐ
புது	p ʊ d̪ ʊ
புதுக்கோட்டை	p ʊ d̪ ʊ kː oː ʈː ɐ ɪ̯
புதுச்சேரி	p ʊ d̪ ʊ t͡ɕː eː ɾ ɪ
புதுமர்	p ʊ d̪ ʊ m ɐ ɾ
புதுமை	p ʊ d̪ ʊ m ɐ ɪ̯
புதுவருஷம்	p ʊ d̪ ʊ ʋ ɐ ɾ ʊ ʂ ɐ m
புதை	p ʊ d̪ ɐ ɪ̯
புதையல்	p ʊ d̪ ɐ ɪ̯ j ɐ l
புத்தகம்	p ʊ t̪ː ɐ ɡ ɐ m
புத்தன்	p ʊ t̪ː ɐ n
புத்தாண்டு	p ʊ t̪ː aː ɳ ɖ ʊ
புத்தி	b ʊ d̪ d̪ ɪ
புத்திரன்	p ʊ t̪ː ɪ ɾ ɐ n
புத்ராஜெயா	p ʊ t̪ ɾ aː d͡ʑ ɛ j aː
புனல்	p ʊ n ɐ l
புனிதன்	p ʊ n ɪ d̪ ɐ n
புனிதம்	p ʊ n ɪ d̪ ɐ m
புனுகு	p ʊ n ʊ ɡ ʊ
புனை	p ʊ n ɐ ɪ̯
புனைவு	p ʊ n ɐ ɪ̯ ʋ ʊ
புன்னை	p ʊ nː ɐ ɪ̯
புயம்	p ʊ j ɐ m
புயற்காற்று	p ʊ j ɐ r k aː rː ʊ
புயல்	p ʊ j ɐ l
புரட்டாசி	p ʊ ɾ ɐ ʈː aː t͡ɕ ɪ
புரள்	p ʊ ɾ ɐ ɭ
புரவு	p ʊ ɾ ɐ ʋ ʊ
புராணம்	p ʊ ɾ aː ɳ ɐ m
புரி	p ʊ ɾ ɪ
புரிந்து	p ʊ ɾ ɪ n̪ d̪ ʊ
புரியாத்தியா	p ʊ ɾ ɪ j aː t̪ː ɪ j aː
புரிவு	p ʊ ɾ ɪ ʋ ʊ
புருவம்	p ʊ ɾ ʊ ʋ ɐ m
புருஷன்	p ʊ ɾ ʊ ʂ ɐ n
புரூணை	p ʊ ɾ uː ɳ ɐ ɪ̯
புறம்	p ʊ r ɐ m
புறவு	p ʊ r ɐ ʋ ʊ
புறா	p ʊ r aː
புற்கலம்	p ʊ r k ɐ l ɐ m
புற்று	p ʊ rː ʊ
புற்றுநோய்	p ʊ rː ʊ n̪ oː j
புலனாய்வு	p ʊ l ɐ n aː j ʋ ʊ
புலமை	p ʊ l ɐ m ɐ ɪ̯
புலம்பல்	p ʊ l ɐ m b ɐ l
புலம்பு	p ʊ l ɐ m b ʊ
புலவன்	p ʊ l ɐ ʋ ɐ n
புலவர்	p ʊ l ɐ ʋ ɐ ɾ
புலி	p ʊ l ɪ
புலிகள்	p ʊ l ɪ ɡ ɐ ɭ
புல்லாங்குழல்	p ʊ l l aː ŋ ɡ ʊ ɻ ɐ l
புல்லுத்தடுக்குஞ்சூரைச்செடி	p ʊ l l ʊ t̪ː ɐ ɖ ʊ kː ʊ ɲ d͡ʑ uː ɾ ɐ ɪ̯ t͡ɕː ɛ ɖ ɪ
புளி	p ʊ ɭ ɪ
புளிச்செவ்வந்தி	p ʊ ɭ ɪ t͡ɕː ɛ ʋː ɐ n̪ d̪ ɪ
புள்ளி	p ʊ ɭː ɪ
புழு	p ʊ ɻ ʊ
புழுதி	p ʊ ɻ ʊ d̪ ɪ
புழுத்துளை	p ʊ ɻ ʊ t̪ː ʊ ɭ ɐ ɪ̯
புவனி	b ʊ ʋ ɐ n ɪ
புவி	p ʊ ʋ ɪ
புவியிடங்காட்டி	p ʊ ʋ ɪ j ɪ ɖ ɐ ŋ ɡ aː ʈː ɪ
புவியியல்	p ʊ ʋ ɪ j ɪ j ɐ l
புஷபராகம்	p ʊ ʂ ɐ b ɐ ɾ aː ɡ ɐ m
புஷ்பம்	p ʊ ʂ p ɐ m
புஷ்பராகம்	p ʊ ʂ p ɐ ɾ aː ɡ ɐ m
புஸ்தகம்	p ʊ s t̪ ɐ ɡ ɐ m
பூ	p uː
பூகண்டம்	p uː ɡ ɐ ɳ ɖ ɐ m
பூகம்பம்	b uː ɡ ɐ m b ɐ m
பூகம்பம்	p uː ɡ ɐ m b ɐ m
பூகோளம்	b uː ɡ oː ɭ ɐ m
பூங்காற்று	p uː ŋ ɡ aː rː ʊ
பூசணம்	p uː t͡ɕ ɐ ɳ ɐ m
பூசாரி	p uː t͡ɕ aː ɾ ɪ
பூசு	p uː t͡ɕ ʊ
பூசை	p uː d͡ʑ a ɪ̯
பூசை	p uː t͡ɕ ɐ ɪ̯
பூச்ச	p uː t͡ɕː ɐ
பூச்சி	p uː t͡ɕː ɪ
பூச்சியம்	p uː t͡ɕː ɪ j ɐ m
பூஜியம்	p uː d͡ʑ ɪ j ɐ m
பூஜை	p uː d͡ʑ ɐ ɪ̯
பூஜ்யம்	p uː d͡ʑ j ɐ m
பூஞை	p uː ɲ ɐ ɪ̯
பூஞ்சணம்	p uː ɲ d͡ʑ ɐ ɳ ɐ m
பூஞ்சல்	p uː ɲ d͡ʑ ɐ l
பூஞ்சு	p uː ɲ d͡ʑ ʊ
பூஞ்சை	p uː ɲ d͡ʑ ɐ ɪ̯
பூடகம்	p uː ɖ ɐ ɡ ɐ m
பூடு	p uː ɖ ʊ
பூட்டன்	p uː ʈː ɐ n
பூட்டு	p uː ʈː ʊ
பூட்டை	p uː ʈː ɐ ɪ̯
பூட்டைக்கிணறு	p uː ʈː ɐ ɪ̯ kː ɪ ɳ ɐ r ʊ
பூணூல்	p uː ɳ uː l
பூண்	p uː ɳ
பூண்டு	p uː ɳ ɖ ʊ
பூதம்	b uː d̪ ɐ m
பூதம்	p uː d̪ ɐ m
பூதவுடல்	b uː d̪ ɐ ʋ ʊ ɖ ɐ l
பூனை	p uː n ɐ ɪ̯
பூனைகள்	p uː n ɐ ɪ̯ ɡ ɐ ɭ
பூப்பு	p uː pː ʊ
பூமி	b uː m ɪ
பூமிசாஸ்திரம்	p uː m ɪ t͡ɕ aː s t̪ ɪ ɾ ɐ m
பூரணமி	p uː ɾ ɐ ɳ ɐ m ɪ
பூரணம்	p uː ɾ ɐ ɳ ɐ m
பூரியம்	p uː ɾ ɪ j ɐ m
பூர்ணம்	p uː ɾ ɳ ɐ m
பூலாங்கிழங்கு	p uː l aː ŋ ɡ ɪ ɻ ɐ ŋ ɡ ʊ
பூலாஞ்சி	p uː l aː ɲ d͡ʑ ɪ
பூளை	p uː ɭ ɐ ɪ̯
பூவிதழ்	p uː ʋ ɪ d̪ ɐ ɻ
பெங்களூரு	b ɛ ŋ ɡ ɐ ɭ uː ɾ ʊ
பெங்களூர்	b ɛ ŋ ɡ ɐ ɭ uː ɾ
பெங்காலி	b ɛ ŋ ɡ aː l ɪ
பெஞ்சமின்	b ɛ ɲ d͡ʑ ɐ m ɪ n
பெட்டி	p ɛ ʈː ɪ
பெட்ரோல்	p ɛ ʈ ɾ oː l
பெண்	p ɛ ɳ
பெண்கரு	p ɛ ɳ ɡ ɐ ɾ ʊ
பெண்கள்	p ɛ ɳ ɡ ɐ ɭ
பெண்குறி	p ɛ ɳ ɡ ʊ r ɪ
பெண்சனம்	p ɛ ɳ t͡ɕ ɐ n ɐ m
பெண்டாட்டி	p ɛ ɳ ɖ aː ʈː ɪ
பெண்ணியம்	p ɛ ɳː ɪ j ɐ m
பெண்பால்	p ɛ ɳ b aː l
பெண்மை	p ɛ ɳ m ɐ ɪ̯
பென்யமீன்	p ɛ n j ɐ m iː n
பெயரடை	p ɛ j ɐ ɾ ɐ ɖ ɐ ɪ̯
பெயரெச்சம்	p ɛ j ɐ ɾ ɛ t͡ɕː ɐ m
பெயர்	p ɛ j ɐ ɾ
பெயர்க்கு	p ɛ j ɐ ɾ kː ʊ
பெயர்ச்சி	p ɛ j ɐ ɾ t͡ɕː ɪ
பெயர்ச்சொல்	p ɛ j ɐ ɾ t͡ɕː ɔ l
பெயர்த்திரிசொல்	p ɛ j ɐ ɾ t̪ː ɪ ɾ ɪ t͡ɕ ɔ l
பெயர்த்துரை	p ɛ j ɐ ɾ t̪ː ʊ ɾ ɐ ɪ̯
பெயர்புறம்	p ɛ j ɐ ɾ b ʊ r ɐ m
பெயர்ப்படு	p ɛ j ɐ ɾ pː ɐ ɖ ʊ
பெயர்ப்பு	p ɛ j ɐ ɾ pː ʊ
பெயர்வழி	p ɛ j ɐ ɾ ʋ ɐ ɻ ɪ
பெயர்வேற்றுமை	p ɛ j ɐ ɾ ʋ eː rː ʊ m ɐ ɪ̯
பெயலை	p ɛ j ɐ l ɐ ɪ̯
பெய்	p ɛ j
பெய்துரை	p ɛ j d̪ ʊ ɾ ɐ ɪ̯
பெரம்பலூர்	p ɛ ɾ ɐ m b ɐ l uː ɾ
பெரிய	p ɛ ɾ ɪ j ɐ
பெரியப்பா	p ɛ ɾ ɪ j ɐ pː aː
பெரியவர்	p ɛ ɾ ɪ j ɐ ʋ ɐ ɾ
பெரியவெள்ளிக்கிழமை	p ɛ ɾ ɪ j ɐ ʋ ɛ ɭː ɪ kː ɪ ɻ ɐ m ɐ ɪ̯
பெரியார்	p ɛ ɾ ɪ j aː ɾ
பெரியோன்	p ɛ ɾ ɪ j oː n
பெரு	p ɛ ɾ ʊ
பெருகு	p ɛ ɾ ʊ ɡ ʊ
பெருக்கம்	p ɛ ɾ ʊ kː ɐ m
பெருக்கல்	p ɛ ɾ ʊ kː ɐ l
பெருக்கல்வாய்பாடு	p ɛ ɾ ʊ kː ɐ l ʋ aː j b aː ɖ ʊ
பெருக்கு	p ɛ ɾ ʊ kː ʊ
பெருங்கடல்	p ɛ ɾ ʊ ŋ ɡ ɐ ɖ ɐ l
பெருங்கடல்கள்	p ɛ ɾ ʊ ŋ ɡ ɐ ɖ ɐ l ɡ ɐ ɭ
பெருங்காயம்	p ɛ ɾ ʊ ŋ ɡ aː j ɐ m
பெருச்சாளி	p ɛ ɾ ʊ t͡ɕː aː ɭ ɪ
பெருஞ்சீரகம்	p ɛ ɾ ʊ ɲ d͡ʑ iː ɾ ɐ ɡ ɐ m
பெருநெஞ்சு	p ɛ ɾ ʊ n̪ ɛ ɲ d͡ʑ ʊ
பெருந்தாரா	p ɛ ɾ ʊ n̪ d̪ aː ɾ aː
பெருந்துத்தி	p ɛ ɾ ʊ n̪ d̪ ʊ t̪ː ɪ
பெருந்தொற்று	p ɛ ɾ ʊ n̪ d̪ ɔ rː ʊ
பெருமருந்து	p ɛ ɾ ʊ m ɐ ɾ ʊ n̪ d̪ ʊ
பெருமழை	p ɛ ɾ ʊ m ɐ ɻ ɐ ɪ̯
பெருமூச்சு	p ɛ ɾ ʊ m uː t͡ɕː ʊ
பெருமூச்சுவிடு	p ɛ ɾ ʊ m uː t͡ɕː ʊ ʋ ɪ ɖ ʊ
பெருமை	p ɛ ɾ ʊ m ɐ ɪ̯
பெரும்பான்மை	p ɛ ɾ ʊ m b aː n m ɐ ɪ̯
பெரும்பாலும்	p ɛ ɾ ʊ m b aː l ʊ m
பெரும்பாழ்	p ɛ ɾ ʊ m b aː ɻ
பெர்லின்	p ɛ ɾ l ɪ n
பெர்லிஸ்	p ɛ ɾ l ɪ s
பெறு	p ɛ r ʊ
பெற்றம்	p ɛ rː ɐ m
பெற்றவன்	p ɛ rː ɐ ʋ ɐ n
பெற்றி	p ɛ rː ɪ
பெற்றிமை	p ɛ rː ɪ m ɐ ɪ̯
பெளதிகம்	p ɛ ɭ ɐ d̪ ɪ ɡ ɐ m
பேக்கு	b eː kː ʊ
பேசி	p eː t͡ɕ ɪ
பேசு	p eː t͡ɕ ʊ
பேச்சாளர்	p eː t͡ɕː aː ɭ ɐ ɾ
பேச்சு	p eː t͡ɕː ʊ
பேச்சுவார்த்தை	p eː t͡ɕː ʊ ʋ aː ɾ t̪ː ɐ ɪ̯
பேஜார்	b eː d͡ʑ aː ɾ
பேஜோ	p eː d͡ʑ oː
பேடி	p eː ɖ ɪ
பேதிமருந்து	p eː d̪ ɪ m ɐ ɾ ʊ n̪ d̪ ʊ
பேதுரு	p eː d̪ ʊ ɾ ʊ
பேதை	p eː d̪ ɐ ɪ̯
பேனா	p eː n aː
பேன்	p eː n
பேய்	p eː j
பேய்க்கணவாய்	p eː j kː ɐ ɳ ɐ ʋ aː j
பேய்க்கருங்காலி	p eː j kː ɐ ɾ ʊ ŋ ɡ aː l ɪ
பேய்மருட்டி	p eː j m ɐ ɾ ʊ ʈː ɪ
பேரம்	b eː ɾ ɐ m
பேரரசு	p eː ɾ ɐ ɾ ɐ t͡ɕ ʊ
பேரருவி	p eː ɾ ɐ ɾ ʊ ʋ ɪ
பேராக்	p eː ɾ aː k
பேராசிரியர்	p eː ɾ aː t͡ɕ ɪ ɾ ɪ j ɐ ɾ
பேராசை	p eː ɾ aː t͡ɕ ɐ ɪ̯
பேராசைக்காரன்	p eː ɾ aː t͡ɕ ɐ ɪ̯ kː aː ɾ ɐ n
பேராசைக்காரர்கள்	p eː ɾ aː t͡ɕ ɐ ɪ̯ kː aː ɾ ɐ ɾ ɡ ɐ ɭ
பேராலயம்	p eː ɾ aː l ɐ j ɐ m
பேரினம்	p eː ɾ ɪ n ɐ m
பேருந்து	p eː ɾ ʊ n̪ d̪ ʊ
பேரூர்	p eː ɾ uː ɾ
பேரொலி	p eː ɾ ɔ l ɪ
பேர்	p eː ɾ
பேறு	p eː r ʊ
பேழை	p eː ɻ ɐ ɪ̯
பை	p ɐ ɪ̯
பைத்தியம்	p ɐ ɪ̯ t̪ː ɪ j ɐ m
பையன்	p ɐ ɪ̯ j ɐ n
பையுள்	p ɐ ɪ̯ j ʊ ɭ
பைவன்	p ɐ ɪ̯ ʋ ɐ n
பொக்கிஷம்	p ɔ kː ɪ ʂ ɐ m
பொக்கை	b ɔ kː ɐ ɪ̯
பொங்கல்	p ɔ ŋ ɡ ɐ l
பொங்கு	p ɔ ŋ ɡ ʊ
பொடி	p ɔ ɖ ɪ
பொட்டு	p ɔ ʈː ʊ
பொது	p ɔ d̪ ʊ
பொதுமக்கள்	p ɔ d̪ ʊ m ɐ kː ɐ ɭ
பொதுமை	p ɔ d̪ ʊ m ɐ ɪ̯
பொத்தாறு	p ɔ t̪ː aː r ʊ
பொத்தாறுக்கட்டை	p ɔ t̪ː aː r ʊ kː ɐ ʈː ɐ ɪ̯
பொத்து	p ɔ t̪ː ʊ
பொந்து	p ɔ n̪ d̪ ʊ
பொன்	p ɔ n
பொன்னாங்காணி	p ɔ nː aː ŋ ɡ aː ɳ ɪ
பொன்னி	p ɔ nː ɪ
பொன்னெழுத்து	p ɔ nː ɛ ɻ ʊ t̪ː ʊ
பொன்வண்டு	p ɔ n ʋ ɐ ɳ ɖ ʊ
பொம்மலாட்டம்	p ɔ mː ɐ l aː ʈː ɐ m
பொம்மை	b ɔ mː ɐ ɪ̯
பொய்கை	p ɔ j ɡ ɐ ɪ̯
பொய்யன்	p ɔ jː ɐ n
பொரி	p ɔ ɾ ɪ
பொருட்பெயர்	p ɔ ɾ ʊ ʈ p ɛ j ɐ ɾ
பொருது	p ɔ ɾ ʊ d̪ ʊ
பொருத்தம்	p ɔ ɾ ʊ t̪ː ɐ m
பொருத்து	p ɔ ɾ ʊ t̪ː ʊ
பொருந்து	p ɔ ɾ ʊ n̪ d̪ ʊ
பொருளட்டவணை	p ɔ ɾ ʊ ɭ ɐ ʈː ɐ ʋ ɐ ɳ ɐ ɪ̯
பொருளாதாரம்	p ɔ ɾ ʊ ɭ aː d̪ aː ɾ ɐ m
பொருள்	p ɔ ɾ ʊ ɭ
பொருவாய்	p ɔ ɾ ʊ ʋ aː j
பொறியாளர்	p ɔ r ɪ j aː ɭ ɐ ɾ
பொறியியல்	p ɔ r ɪ j ɪ j ɐ l
பொறு	p ɔ r ʊ
பொறுப்பு	p ɔ r ʊ pː ʊ
பொறுமை	p ɔ r ʊ m ɐ ɪ̯
பொலிவு	p ɔ l ɪ ʋ ʊ
பொல்லாப்பு	p ɔ l l aː pː ʊ
பொழில்	p ɔ ɻ ɪ l
பொழுது	p ɔ ɻ ʊ d̪ ʊ
போ	p oː
போகி	b oː ɡ ɪ
போகி	p oː ɡ ɪ
போக்கு	p oː kː ʊ
போக்குவரத்து	p oː kː ʊ ʋ ɐ ɾ ɐ t̪ː ʊ
போஜனம்	b oː d͡ʑ ɐ n ɐ m
போஜனம்	p oː d͡ʑ ɐ n ɐ m
போடு	p oː ɖ ʊ
போட்டு	b oː ʈː ʊ
போணம்	p oː ɳ ɐ m
போதாமை	p oː d̪ aː m ɐ ɪ̯
போதி	p oː d̪ ɪ
போதிகைப்பலகை	p oː d̪ ɪ ɡ ɐ ɪ̯ pː ɐ l ɐ ɡ ɐ ɪ̯
போதியார்	p oː d̪ ɪ j aː ɾ
போது	p oː d̪ ʊ
போதை	p oː d̪ ɐ ɪ̯
போதைப்பழக்கம்	p oː d̪ ɐ ɪ̯ pː ɐ ɻ ɐ kː ɐ m
போதைப்பொருள்	p oː d̪ ɐ ɪ̯ pː ɔ ɾ ʊ ɭ
போதைமருந்து	p oː d̪ ɐ ɪ̯ m ɐ ɾ ʊ n̪ d̪ ʊ
போத்து	p oː t̪ː ʊ
போன	p oː n ɐ
போனகம்	p oː n ɐ ɡ ɐ m
போன்ற	p oː n r ɐ
போன்றீயம்	p oː n r iː j ɐ m
போபால்	p oː b aː l
போயர்	p oː j ɐ ɾ
போராடு	p oː ɾ aː ɖ ʊ
போராட்டம்	p oː ɾ aː ʈː ɐ m
போராளி	p oː ɾ aː ɭ ɪ
போர்	p oː ɾ
போர்க்களம்	p oː ɾ kː ɐ ɭ ɐ m
போர்டு	p oː ɾ ɖ ʊ
போர்வை	p oː ɾ ʋ ɐ ɪ̯
போறை	p oː r ɐ ɪ̯
போற்று	p oː rː ʊ
போற்றுநர்	p oː rː ʊ n̪ ɐ ɾ
போல	p oː l ɐ
போலிஷ்	p oː l ɪ ʂ
போலீசு	p oː l iː t͡ɕ ʊ
போல்	p oː l
பௌமம்	p ɐ ʊ̯ m ɐ m
பௌமஸ்நானம்	p ɐ ʊ̯ m ɐ s n̪ aː n ɐ m
ப்	i p
ப்	i pː ɯ
ப்	p
ம	m ɐ
மக	m ɐ h ɐ
மக	m ɐ ɡ ɐ
மகன்	m ɐ ɡ ɐ n
மகப்பேறு	m ɐ ɡ ɐ pː eː r ʊ
மகரக்குறுக்கம்	m ɐ ɡ ɐ ɾ ɐ kː ʊ r ʊ kː ɐ m
மகரந்தம்	m ɐ ɡ ɐ ɾ ɐ n̪ d̪ ɐ m
மகரம்	m ɐ ɡ ɐ ɾ ɐ m
மகரவாழை	m ɐ ɡ ɐ ɾ ɐ ʋ aː ɻ ɐ ɪ̯
மகளிர்	m ɐ ɡ ɐ ɭ ɪ ɾ
மகள்	m ɐ ɡ ɐ ɭ
மகாதேவன்	m ɐ ɡ aː d̪ eː ʋ ɐ n
மகாபலிபுரம்	m a h aː b a l i p u ɾ a m
மகாபலிபுரம்	m a ɡ aː b a l i p u ɾ a m
மகாபாரதம்	m ɐ ɡ aː b aː ɾ ɐ d̪ ɐ m
மகாராட்டிரம்	m ɐ ɡ aː ɾ aː ʈː ɪ ɾ ɐ m
மகிமை	m ɐ h ɪ m ɐ ɪ̯
மகிமை	m ɐ ɡ ɪ m ɐ ɪ̯
மகிழம்	m ɐ ɡ ɪ ɻ ɐ m
மகிழுந்து	m ɐ ɡ ɪ ɻ ʊ n̪ d̪ ʊ
மகிழ்	m ɐ ɡ ɪ ɻ
மகிழ்ச்சி	m ɐ ɡ ɪ ɻ t͡ɕː ɪ
மகிழ்வன்	m ɐ ɡ ɪ ɻ ʋ ɐ n
மகிழ்வி	m ɐ ɡ ɪ ɻ ʋ ɪ
மகுடம்	m ɐ ɡ ʊ ɖ ɐ m
மகேசன்	m ɐ ɡ eː t͡ɕ ɐ n
மகேந்திரன்	m ɐ ɡ eː n̪ d̪ ɪ ɾ ɐ n
மக்கம்	m ɐ kː ɐ m
மக்களாட்சி	m ɐ kː ɐ ɭ aː ʈ t͡ɕ ɪ
மக்கள்	m ɐ kː ɐ ɭ
மக்கு	m ɐ kː ʊ
மங்கனிறம்	m ɐ ŋ ɡ ɐ n ɪ r ɐ m
மங்கலியன்	m ɐ ŋ ɡ ɐ l ɪ j ɐ n
மங்களம்	m ɐ ŋ ɡ ɐ ɭ ɐ m
மங்குசுத்தான்	m ɐ ŋ ɡ ʊ t͡ɕ ʊ t̪ː aː n
மங்கை	m ɐ ŋ ɡ ɐ ɪ̯
மசக்கை	m ɐ t͡ɕ ɐ kː ɐ ɪ̯
மசூதி	m ɐ t͡ɕ uː d̪ ɪ
மச்சம்	m ɐ t͡ɕː ɐ m
மச்சான்	m ɐ t͡ɕː aː n
மச்சினன்	m ɐ t͡ɕː ɪ n ɐ n
மஞ்சட்கொழுப்பன்	m ɐ ɲ d͡ʑ ɐ ʈ k ɔ ɻ ʊ pː ɐ n
மஞ்சட்சாமந்தி	m ɐ ɲ d͡ʑ ɐ ʈ t͡ɕ aː m ɐ n̪ d̪ ɪ
மஞ்சன்	m ɐ ɲ d͡ʑ ɐ n
மஞ்சள்	m ɐ ɲ d͡ʑ ɐ ɭ
மஞ்சள்முள்ளங்கி	m ɐ ɲ d͡ʑ ɐ ɭ m ʊ ɭː ɐ ŋ ɡ ɪ
மஞ்சிகை	m ɐ ɲ d͡ʑ ɪ ɡ ɐ ɪ̯
மஞ்சு	m ɐ ɲ d͡ʑ ʊ
மஞ்ஞை	m ɐ ɲː ɐ ɪ̯
மடக்கம்	m ɐ ɖ ɐ kː ɐ m
மடங்கல்	m ɐ ɖ ɐ ŋ ɡ ɐ l
மடந்தை	m ɐ ɖ ɐ n̪ d̪ ɐ ɪ̯
மடல்	m ɐ ɖ ɐ l
மடிக்கணினி	m ɐ ɖ ɪ kː ɐ ɳ ɪ n ɪ
மடுத்தல்	m ɐ ɖ ʊ t̪ː ɐ l
மடை	m ɐ ɖ ɐ ɪ̯
மட்டக்களப்பு	m ɐ ʈː ɐ kː ɐ ɭ ɐ pː ʊ
மட்டம்	m ɐ ʈː ɐ m
மட்டு	m ɐ ʈː ʊ
மட்டுக்கோணம்	m ɐ ʈː ʊ kː oː ɳ ɐ m
மட்டுக்கோல்	m ɐ ʈː ʊ kː oː l
மட்டுத்தப்பு	m ɐ ʈː ʊ t̪ː ɐ pː ʊ
மட்டுத்திட்டம்	m ɐ ʈː ʊ t̪ː ɪ ʈː ɐ m
மட்டும்	m ɐ ʈː ʊ m
மட்பகைவன்	m ɐ ʈ p ɐ ɡ ɐ ɪ̯ ʋ ɐ n
மட்பாண்டம்	m ɐ ʈ p aː ɳ ɖ ɐ m
மணத்து	m ɐ ɳ ɐ t̪ː ʊ
மணப்பெண்	m ɐ ɳ ɐ pː ɛ ɳ
மணமகன்	m ɐ ɳ ɐ m ɐ ɡ ɐ n
மணம்	m ɐ ɳ ɐ m
மணல்	m ɐ ɳ ɐ l
மணவாட்டி	m ɐ ɳ ɐ ʋ aː ʈː ɪ
மணவாளன்	m ɐ ɳ ɐ ʋ aː ɭ ɐ n
மணவிலக்கு	m ɐ ɳ ɐ ʋ ɪ l ɐ kː ʊ
மணி	m ɐ ɳ ɪ
மணிக்கட்டு	m ɐ ɳ ɪ kː ɐ ʈː ʊ
மணித்தக்காளி	m ɐ ɳ ɪ t̪ː ɐ kː aː ɭ ɪ
மணித்துளி	m ɐ ɳ ɪ t̪ː ʊ ɭ ɪ
மணிப்புரி	m ɐ ɳ ɪ pː ʊ ɾ ɪ
மணிப்பூர்	m ɐ ɳ ɪ pː uː ɾ
மணிமகுடம்	m ɐ ɳ ɪ m ɐ ɡ ʊ ɖ ɐ m
மணிமேகலை	m ɐ ɳ ɪ m eː ɡ ɐ l ɐ ɪ̯
மணை	m ɐ ɳ ɐ ɪ̯
மண்	m ɐ ɳ
மண்டக்கம்	m ɐ ɳ ɖ ɐ kː ɐ m
மண்டபம்	m ɐ ɳ ɖ ɐ b ɐ m
மண்டலம்	m ɐ ɳ ɖ ɐ l ɐ m
மண்டி	m ɐ ɳ ɖ ɪ
மண்டை	m ɐ ɳ ɖ ɐ ɪ̯
மண்ணீட்டாளர்	m ɐ ɳː iː ʈː aː ɭ ɐ ɾ
மண்ணெண்ணெய்	m ɐ ɳː ɛ ɳː ɛ j
மண்தைலம்	m ɐ ɳ d̪ ɐ ɪ̯ l ɐ m
மண்வளம்	m ɐ ɳ ʋ ɐ ɭ ɐ m
மண்வெட்டி	m ɐ ɳ ʋ ɛ ʈː ɪ
மதகு	m ɐ d̪ ɐ ɡ ʊ
மதனி	m ɐ d̪ ɐ n ɪ
மதம்	m ɐ d̪ ɐ m
மதறாஸ்	m ɐ d̪ ɐ r aː s
மதி	m ɐ d̪ ɪ
மதிக்கத்தக்க	m ɐ d̪ ɪ kː ɐ t̪ː ɐ kː ɐ
மதிநுட்பமிக்க	m ɐ d̪ ɪ n̪ ʊ ʈ p ɐ m ɪ kː ɐ
மதிப்பு	m ɐ d̪ ɪ pː ʊ
மதிய	m ɐ d̪ ɪ j ɐ
மதியம்	m ɐ d̪ ɪ j ɐ m
மதிராஸ்	m ɐ d̪ ɪ ɾ aː s
மதில்	m ɐ d̪ ɪ l
மது	m ɐ d̪ ʊ
மதுசூதன்	m ɐ d̪ ʊ t͡ɕ uː d̪ ɐ n
மதுரம்	m ɐ d̪ ʊ ɾ ɐ m
மதுரை	m ɐ d̪ ʊ ɾ ɐ ɪ̯
மத்தளம்	m ɐ t̪ː ɐ ɭ ɐ m
மத்திய	m ɐ t̪ː ɪ j ɐ
மத்தியகாலம்	m ɐ t̪ː ɪ j ɐ ɡ aː l ɐ m
மத்தேயு	m ɐ t̪ː eː j ʊ
மத்ரித்	m ɐ t̪ ɾ ɪ t̪
மத்ஸ்யம்	m ɐ t̪ s j ɐ m
மந்தம்	m ɐ n̪ d̪ ɐ m
மந்தாரம்	m ɐ n̪ d̪ aː ɾ ɐ m
மந்தினி	m ɐ n̪ d̪ ɪ n ɪ
மந்திரகூர்மை	m ɐ n̪ d̪ ɪ ɾ ɐ ɡ uː ɾ m ɐ ɪ̯
மந்திரம்	m ɐ n̪ d̪ ɪ ɾ ɐ m
மந்திரர்	m ɐ n̪ d̪ ɪ ɾ ɐ ɾ
மந்திரஸ்நானம்	m ɐ n̪ d̪ ɪ ɾ ɐ s n̪ aː n ɐ m
மந்திரி	m ɐ n̪ d̪ ɪ ɾ ɪ
மந்து	m ɐ n̪ d̪ ʊ
மந்துரை	m ɐ n̪ d̪ ʊ ɾ ɐ ɪ̯
மந்தை	m ɐ n̪ d̪ ɐ ɪ̯
மந்தைவெளி	m ɐ n̪ d̪ ɐ ɪ̯ ʋ ɛ ɭ ɪ
மன	m ɐ n ɐ
மனக்குறை	m ɐ n ɐ kː ʊ r ɐ ɪ̯
மனசாட்சி	m ɐ n ɐ t͡ɕ aː ʈ t͡ɕ ɪ
மனசு	m ɐ n ɐ t͡ɕ ʊ
மனது	m ɐ n ɐ d̪ ʊ
மனநலம்	m ɐ n ɐ n̪ ɐ l ɐ m
மனநிலை	m ɐ n ɐ n̪ ɪ l ɐ ɪ̯
மனந்தளர்	m ɐ n ɐ n̪ d̪ ɐ ɭ ɐ ɾ
மனனம்	m ɐ n ɐ n ɐ m
மனப்பதைப்பு	m ɐ n ɐ pː ɐ d̪ ɐ ɪ̯ pː ʊ
மனப்பாங்கு	m ɐ n ɐ pː aː ŋ ɡ ʊ
மனப்போக்கு	m ɐ n ɐ pː oː kː ʊ
மனமாற்றம்	m ɐ n ɐ m aː rː ɐ m
மனம்	m ɐ n ɐ m
மனஸ்தாபம்	m ɐ n ɐ s t̪ aː b ɐ m
மனிதன்	m ɐ n ɪ d̪ ɐ n
மனிதவளம்	m ɐ n ɪ d̪ ɐ ʋ ɐ ɭ ɐ m
மனிதவியல்	m ɐ n ɪ d̪ ɐ ʋ ɪ j ɐ l
மனுஷன்	m ɐ n ʊ ʂ ɐ n
மனை	m ɐ n ɐ ɪ̯
மனைவி	m ɐ n ɐ ɪ̯ ʋ ɪ
மனோபாவம்	m ɐ n oː b aː ʋ ɐ m
மன்	m ɐ n
மன்னன்	m ɐ nː ɐ n
மன்னி	m ɐ nː ɪ
மன்னிப்பு	m ɐ nː ɪ pː ʊ
மன்னு	m ɐ nː ʊ
மன்னும்	m ɐ nː ʊ m
மன்றம்	m ɐ n r ɐ m
மன்றாட்டு	m ɐ n r aː ʈː ʊ
மன்வந்தரம்	m ɐ n ʋ ɐ n̪ d̪ ɐ ɾ ɐ m
மப்பு	m ɐ b b ʊ
மப்பு	m ɐ pː ʊ
மம்மர்	m ɐ mː ɐ ɾ
மம்மல்	m ɐ mː ɐ l
மயக்கடி	m ɐ j ɐ kː ɐ ɖ ɪ
மயக்கம்	m ɐ j ɐ kː ɐ m
மயங்கு	m ɐ j ɐ ŋ ɡ ʊ
மயடம்	m ɐ j ɐ ɖ ɐ m
மயண்டை	m ɐ j ɐ ɳ ɖ ɐ ɪ̯
மயர்வு	m ɐ j ɐ ɾ ʋ ʊ
மயல்	m ɐ j ɐ l
மயிரிழவு	m ɐ j ɪ ɾ ɪ ɻ ɐ ʋ ʊ
மயிர்	m ɐ j ɪ ɾ
மயிர்முடி	m ɐ j ɪ ɾ m ʊ ɖ ɪ
மயிற்கொன்றை	m ɐ j ɪ r k ɔ n r ɐ ɪ̯
மயிலாடுதுறை	m ɐ j ɪ l aː ɖ ʊ d̪ ʊ r ɐ ɪ̯
மயிலை	m ɐ j ɪ l ɐ ɪ̯
மயில்	m ɐ j ɪ l
மயூரம்	m ɐ j uː ɾ ɐ m
மயூராசனம்	m ɐ j uː ɾ aː t͡ɕ ɐ n ɐ m
மரகதம்	m ɐ ɾ ɐ ɡ ɐ d̪ ɐ m
மரக்கட்டை	m ɐ ɾ ɐ kː ɐ ʈː ɐ ɪ̯
மரக்கலம்	m ɐ ɾ ɐ kː ɐ l ɐ m
மரங்கள்	m ɐ ɾ ɐ ŋ ɡ ɐ ɭ
மரணம்	m ɐ ɾ ɐ ɳ ɐ m
மரத்தக்காளி	m ɐ ɾ ɐ t̪ː ɐ kː aː ɭ ɪ
மரபணு	m ɐ ɾ ɐ b ɐ ɳ ʊ
மரம்	m ɐ ɾ ɐ m
மரவள்ளி	m ɐ ɾ ɐ ʋ ɐ ɭː ɪ
மரி	m ɐ ɾ ɪ
மரியாதை	m ɐ ɾ ɪ j aː d̪ ɐ ɪ̯
மருங்கு	m ɐ ɾ ʊ ŋ ɡ ʊ
மருட்டு	m ɐ ɾ ʊ ʈː ʊ
மருட்டுதல்	m ɐ ɾ ʊ ʈː ʊ d̪ ɐ l
மருதாணி	m ɐ ɾ ʊ d̪ aː ɳ ɪ
மருத்துவமனை	m ɐ ɾ ʊ t̪ː ʊ ʋ ɐ m ɐ n ɐ ɪ̯
மருத்துவம்	m ɐ ɾ ʊ t̪ː ʊ ʋ ɐ m
மருத்துவர்	m ɐ ɾ ʊ t̪ː ʊ ʋ ɐ ɾ
மருநிலம்	m ɐ ɾ ʊ n̪ ɪ l ɐ m
மருந்தகம்	m ɐ ɾ ʊ n̪ d̪ ɐ ɡ ɐ m
மருந்தாளர்	m ɐ ɾ ʊ n̪ d̪ aː ɭ ɐ ɾ
மருந்து	m ɐ ɾ ʊ n̪ d̪ ʊ
மருந்துக்கடை	m ɐ ɾ ʊ n̪ d̪ ʊ kː ɐ ɖ ɐ ɪ̯
மருப்பு	m ɐ ɾ ʊ pː ʊ
மருமகன்	m ɐ ɾ ʊ m ɐ h ɐ n
மருமகன்	m ɐ ɾ ʊ m ɐ ɡ ɐ n
மருமகள்	m ɐ ɾ ʊ m ɐ h ɐ ɭ
மருமகள்	m ɐ ɾ ʊ m ɐ ɡ ɐ ɭ
மருவு	m ɐ ɾ ʊ ʋ ʊ
மர்தோவியா	m ɐ ɾ d̪ oː ʋ ɪ j aː
மற	m ɐ r ɐ
மறு	m ɐ r ʊ
மறுகால்	m ɐ r ʊ ɡ aː l
மறுகு	m ɐ r ʊ ɡ ʊ
மறுக்க	m ɐ r ʊ kː ɐ
மறுக்கம்	m ɐ r ʊ kː ɐ m
மறுசுழற்சி	m ɐ r ʊ t͡ɕ ʊ ɻ ɐ r t͡ɕ ɪ
மறுசொல்	m ɐ r ʊ t͡ɕ ɔ l
மறுநாள்	m ɐ r ʊ n̪ aː ɭ
மறுபடியும்	m ɐ r ʊ b ɐ ɖ ɪ j ʊ m
மறுபரிசீலனை	m ɐ r ʊ b ɐ ɾ ɪ t͡ɕ iː l ɐ n ɐ ɪ̯
மறுமொழி	m ɐ r ʊ m ɔ ɻ ɪ
மறுரூபம்	m ɐ r ʊ ɾ uː b ɐ m
மறை	m ɐ r ɐ ɪ̯
மற்ற	m ɐ rː ɐ
மற்றப்படி	m ɐ rː ɐ pː ɐ ɖ ɪ
மற்று	m ɐ rː ʊ
மற்றும்	m ɐ rː ʊ m
மற்றை	m ɐ rː ɐ ɪ̯
மலக்கழிவு	m ɐ l ɐ kː ɐ ɻ ɪ ʋ ʊ
மலக்கு	m ɐ l ɐ kː ʊ
மலச்சிக்கல்	m ɐ l ɐ t͡ɕː ɪ kː ɐ l
மலப்புறம்	m ɐ l ɐ pː ʊ r ɐ m
மலம்	m ɐ l ɐ m
மலர்	m ɐ l ɐ ɾ
மலர்க்கடை	m ɐ l ɐ ɾ kː ɐ ɖ ɐ ɪ̯
மலர்ச்சி	m ɐ l ɐ ɾ t͡ɕː ɪ
மலாக்கா	m ɐ l aː kː aː
மலேசியா	m ɐ l eː t͡ɕ ɪ j aː
மலை	m ɐ l ɐ ɪ̯
மலைகலக்கி	m ɐ l ɐ ɪ̯ ɡ ɐ l ɐ kː ɪ
மலைக்கொய்யா	m ɐ l ɐ ɪ̯ kː ɔ jː aː
மலைப்பாம்பு	m ɐ l ɐ ɪ̯ pː aː m b ʊ
மலைப்புன்கு	m ɐ l ɐ ɪ̯ pː ʊ n ɡ ʊ
மலைப்பேரீச்சு	m ɐ l ɐ ɪ̯ pː eː ɾ iː t͡ɕː ʊ
மலையாளம்	m ɐ l ɐ ɪ̯ j aː ɭ ɐ m
மலையாழம்	m ɐ l ɐ ɪ̯ j aː ɻ ɐ m
மலைவு	m ɐ l ɐ ɪ̯ ʋ ʊ
மலைவேங்கை	m ɐ l ɐ ɪ̯ ʋ eː ŋ ɡ ɐ ɪ̯
மல்கியா	m ɐ l ɡ ɪ j aː
மல்லி	m ɐ l l ɪ
மல்லிகை	m ɐ l l ɪ ɡ ɐ ɪ̯
மழலை	m ɐ ɻ ɐ l ɐ ɪ̯
மழு	m ɐ ɻ ʊ
மழை	m ɐ ɻ ɐ ɪ̯
மழைக்காலம்	m ɐ ɻ ɐ ɪ̯ kː aː l ɐ m
மழைத்துளி	m ɐ ɻ ɐ ɪ̯ t̪ː ʊ ɭ ɪ
மழைநீர்	m ɐ ɻ ɐ ɪ̯ n̪ iː ɾ
மழைபெய்	m ɐ ɻ ɐ ɪ̯ b ɛ j
மவன்	m ɐ ʋ ɐ n
மஹாபாரதம்	m ɐ h aː b aː ɾ ɐ d̪ ɐ m
மஹால்	m ɐ h aː l
மா	m aː
மாகாணம்	m aː ɡ aː ɳ ɐ m
மாங்காய்	m aː ŋ ɡ aː j
மாங்கிஸ்	m aː ŋ ɡ ɪ s
மாசம்	m aː t͡ɕ ɐ m
மாசவிடாய்	m aː t͡ɕ ɐ ʋ ɪ ɖ aː j
மாசி	m aː t͡ɕ ɪ
மாச்சல்	m aː t͡ɕː ɐ l
மாஜி	m aː d͡ʑ ɪ
மாடம்	m aː ɖ ɐ m
மாடி	m aː ɖ ɪ
மாடு	m aː ɖ ʊ
மாட்டிடையன்	m aː ʈː ɪ ɖ ɐ ɪ̯ j ɐ n
மாட்டிறைச்சி	m aː ʈː ɪ r ɐ ɪ̯ t͡ɕː ɪ
மாட்டு	m aː ʈː ʊ
மாட்டுக்கிடை	m aː ʈː ʊ kː ɪ ɖ ɐ ɪ̯
மாட்டுவண்டி	m aː ʈː ʊ ʋ ɐ ɳ ɖ ɪ
மாணவகம்	m aː ɳ ɐ ʋ ɐ ɡ ɐ m
மாணவன்	m aː ɳ ɐ ʋ ɐ n
மாணாக்கி	m aː ɳ aː kː ɪ
மாணிக்கம்	m aː ɳ ɪ kː ɐ m
மாண்	m aː ɳ
மாண்டரின்	m aː ɳ ɖ ɐ ɾ ɪ n
மாண்டல்	m aː ɳ ɖ ɐ l
மாண்பு	m aː ɳ b ʊ
மாண்புமிகு	m aː ɳ b ʊ m ɪ ɡ ʊ
மாதங்கள்	m aː d̪ ɐ ŋ ɡ ɐ ɭ
மாதனம்	m aː d̪ ɐ n ɐ m
மாதம்	m aː d̪ ɐ m
மாதறி	m aː d̪ ɐ r ɪ
மாதவன்	m aː d̪ ɐ ʋ ɐ n
மாதா	m aː d̪ aː
மாதிரி	m aː d̪ ɪ ɾ ɪ
மாதிரு	m aː d̪ ɪ ɾ ʊ
மாதுபாகம்	m aː d̪ ʊ b aː ɡ ɐ m
மாதுளம்	m aː d̪ ʊ ɭ ɐ m
மாதுளை	m aː d̪ ʊ ɭ ɐ ɪ̯
மாத்திரை	m aː t̪ː ɪ ɾ ɐ ɪ̯
மாத்து	m aː t̪ː ʊ
மாநாடு	m aː n̪ aː ɖ ʊ
மாநிலம்	m aː n̪ ɪ l ɐ m
மாந்தர்	m aː n̪ d̪ ɐ ɾ
மானம்	m aː n ɐ m
மானிடன்	m aː n ɪ ɖ ɐ n
மானிடவியல்	m aː n ɪ ɖ ɐ ʋ ɪ j ɐ l
மான்	m aː n
மான்கள்	m aː n ɡ ɐ ɭ
மாப்பிசின்	m aː pː ɪ t͡ɕ ɪ n
மாப்பிள்ளை	m aː pː ɪ ɭː ɐ ɪ̯
மாப்பு	m aː pː ʊ
மாமனார்	m aː m ɐ n aː ɾ
மாமன்	m aː m ɐ n
மாமன்னன்	m aː m ɐ nː ɐ n
மாமரம்	m aː m ɐ ɾ ɐ m
மாமல்லபுரம்	m aː m a l l a p u ɾ a m
மாமல்லபுரம்	m aː m ɐ l l ɐ b ʊ ɾ ɐ m
மாமல்லபுரம்	m aː m ɐ l l ɐ p u ɾ ɐ m
மாமா	m aː m aː
மாமிசம்	m aː m ɪ t͡ɕ ɐ m
மாமியார்	m aː m ɪ j aː ɾ
மாம்பழம்	m aː m b ɐ ɻ ɐ m
மாம்பிஞ்சு	m aː m b ɪ ɲ d͡ʑ ʊ
மாயிழை	m aː j ɪ ɻ ɐ ɪ̯
மாயோள்	m aː j oː ɭ
மாய்	m aː j
மாய்ச்சி	m aː j t͡ɕː ɪ
மாரடைப்பு	m aː ɾ ɐ ɖ ɐ ɪ̯ pː ʊ
மாரி	m aː ɾ ɪ
மாரிகாலம்	m aː ɾ ɪ ɡ aː l ɐ m
மாருதி	m aː ɾ ʊ d̪ ɪ
மார்	m aː ɾ
மார்கழி	m aː ɾ ɡ ɐ ɻ ɪ
மார்க்கம்	m aː ɾ kː ɐ m
மார்ச்	m aː ɾ t͡ɕ
மார்பகம்	m aː ɾ b ɐ ɡ ɐ m
மார்பு	m aː ɾ b ʊ
மாறு	m aː r ʊ
மாறுபாடு	m aː r ʊ b aː ɖ ʊ
மாற்றம்	m aː rː ɐ m
மாற்று	m aː rː ʊ
மாற்றுத்திறனாளி	m aː rː ʊ t̪ː ɪ r ɐ n aː ɭ ɪ
மாற்றுமருந்து	m aː rː ʊ m ɐ ɾ ʊ n̪ d̪ ʊ
மாலை	m aː l ɐ ɪ̯
மாலோன்	m aː l oː n
மால்	m aː l
மாளிகை	m aː ɭ ɪ ɡ ɐ ɪ̯
மாழை	m aː ɻ ɐ ɪ̯
மாவட்டம்	m aː ʋ ɐ ʈː ɐ m
மாவு	m aː ʋ ʊ
மாஸ்	m aː s
மிக	m ɪ ɡ ɐ
மிகவும்	m ɪ ɡ ɐ ʋ ʊ m
மிகாவேல்	m ɪ ɡ aː ʋ eː l
மிகு	m ɪ ɡ ʊ
மிகுதல்	m ɪ ɡ ʊ d̪ ɐ l
மிகுதி	m ɪ ɡ ʊ d̪ ɪ
மிகுதியும்	m ɪ ɡ ʊ d̪ ɪ j ʊ m
மிகுந்த	m ɪ ɡ ʊ n̪ d̪ ɐ
மிகை	m ɪ ɡ ɐ ɪ̯
மிசோரம்	m ɪ t͡ɕ oː ɾ ɐ m
மிச்சம்	m ɪ t͡ɕː ɐ m
மிஞ்சு	m ɪ ɲ d͡ʑ ʊ
மிடையீரர்	m ɪ ɖ ɐ ɪ̯ j iː ɾ ɐ ɾ
மிட்டாய்	m ɪ ʈː aː j
மித	m ɪ d̪ ɐ
மிதழ்	m ɪ d̪ ɐ ɻ
மிதவை	m ɪ d̪ ɐ ʋ ɐ ɪ̯
மிதியடி	m ɪ d̪ ɪ j ɐ ɖ ɪ
மிதுனம்	m ɪ d̪ ʊ n ɐ m
மினுக்கம்	m ɪ n ʊ kː ɐ m
மினுக்கு	m ɪ n ʊ kː ʊ
மினுங்கு	m ɪ n ʊ ŋ ɡ ʊ
மினுமினுப்பு	m ɪ n ʊ m ɪ n ʊ pː ʊ
மின்	m ɪ n
மின்சாரம்	m ɪ n t͡ɕ aː ɾ ɐ m
மின்சாரவண்டி	m ɪ n t͡ɕ aː ɾ ɐ ʋ ɐ ɳ ɖ ɪ
மின்னஞ்சல்	m ɪ nː ɐ ɲ d͡ʑ ɐ l
மின்னணு	m ɪ nː ɐ ɳ ʊ
மின்னல்	m ɪ nː ɐ l
மின்னு	m ɪ nː ʊ
மியான்மர்	m ɪ j aː n m ɐ ɾ
மிரட்டு	m ɪ ɾ ɐ ʈː ʊ
மிருகசீருடம்	m ɪ ɾ ʊ ɡ ɐ t͡ɕ iː ɾ ʊ ɖ ɐ m
மிருகம்	m ɪ ɾ ʊ ɡ ɐ m
மிருதங்கம்	m ɪ ɾ ʊ d̪ ɐ ŋ ɡ ɐ m
மிருதம்	m ɪ ɾ ʊ d̪ ɐ m
மிருது	m ɪ ɾ ʊ d̪ ʊ
மிருத்தியு	m ɪ ɾ ʊ t̪ː ɪ j ʊ
மிறை	m ɪ r ɐ ɪ̯
மிலேச்சன்	m ɪ l eː t͡ɕː ɐ n
மிளகாய்	m ɨ ɭ ɛː
மிளகாய்	m ɪ ɭ ɐ ɡ aː j
மிளகு	m ɪ ɭ ɐ h ʊ
மிளகு	m ɪ ɭ ɐ ɡ ʊ
மிளகுத்தண்ணீர்	m ɪ ɭ ɐ ɡ ʊ t̪ː ɐ ɳː iː ɾ
மீ	m iː
மீகடத்தி	m iː k ɐ ɖ ɐ t̪ː i
மீகா	m iː ɡ aː
மீக்கணினி	m iː kː ɐ ɳ ɪ n ɪ
மீக்கூர்	m iː kː uː ɾ
மீக்கூறல்	m iː kː uː r ɐ l
மீக்கூற்றம்	m iː kː uː rː ɐ m
மீக்கோள்	m iː kː oː ɭ
மீசு	m iː t͡ɕ ʊ
மீசை	m iː t͡ɕ ɐ ɪ̯
மீச்செலவு	m iː t͡ɕː ɛ l ɐ ʋ ʊ
மீட்டு	m iː ʈː ʊ
மீண்டும்	m iː ɳ ɖ ʊ m
மீதூர்	m iː d̪ uː ɾ
மீநாயகன்	m iː n̪ aː j ɐ ɡ ɐ n
மீனம்	m iː n ɐ m
மீனவர்	m iː n ɐ ʋ ɐ ɾ
மீனாக்ஷி	m iː n aː k ʂ ɪ
மீனாட்சி	m iː n aː ʈ t͡ɕ ɪ
மீன்	m iː n
மீன்காரன்	m iː n ɡ aː ɾ ɐ n
மீன்சிறகு	m iː n t͡ɕ ɪ r ɐ ɡ ʊ
மீன்வெட்டி	m iː n ʋ ɛ ʈː ɪ
மீன்வேட்டை	m iː n ʋ eː ʈː ɐ ɪ̯
மீப்பு	m iː pː ʊ
மீளி	m iː ɭ ɪ
மீள்	m iː ɭ
மீள்மம்	m iː ɭ m ɐ m
முகக்குறி	m ʊ ɡ ɐ kː ʊ r ɪ
முகடு	m ʊ ɡ ɐ ɖ ʊ
முகநூல்	m ʊ ɡ ɐ n̪ uː l
முகம்	m ʊ ɡ ɐ m
முகர்	m ʊ ɡ ɐ ɾ
முகவுரை	m ʊ ɡ ɐ ʋ ʊ ɾ ɐ ɪ̯
முகில்	m ʊ ɡ ɪ l
முகை	m ʊ ɡ ɐ ɪ̯
முக்கா	m ʊ kː aː
முக்காலி	m ʊ kː aː l ɪ
முக்கால்	m ʊ kː aː l
முக்கியமான	m ʊ kː ɪ j ɐ m aː n ɐ
முக்கியம்	m ʊ kː ɪ j ɐ m
முக்கோணம்	m ʊ kː oː ɳ ɐ m
முசு	m ʊ t͡ɕ ʊ
முச்சம்	m ʊ t͡ɕː ɐ m
முடக்கு	m ʊ ɖ ɐ kː ʊ
முடி	m ʊ ɖ ɪ
முடிச்சு	m ʊ ɖ ɪ t͡ɕː ʊ
முடியாட்சி	m ʊ ɖ ɪ j aː ʈ t͡ɕ ɪ
முடிவிலி	m ʊ ɖ ɪ ʋ ɪ l ɪ
முடிவு	m ʊ ɖ ɪ ʋ ʊ
முடுக்கு	m ʊ ɖ ʊ kː ʊ
முட்கொன்றை	m ʊ ʈ k ɔ n r ɐ ɪ̯
முட்செவ்வந்தி	m ʊ ʈ t͡ɕ ɛ ʋː ɐ n̪ d̪ ɪ
முட்டாள்	m ʊ ʈː aː ɭ
முட்டு	m ʊ ʈː ʊ
முட்டுக்கால்	m ʊ ʈː ʊ kː aː l
முட்டை	m ʊ ʈː ɐ ɪ̯
முண்டகம்	m ʊ ɳ ɖ ɐ ɡ ɐ m
முதன்மை	m ʊ d̪ ɐ n m ɐ ɪ̯
முதலாளி	m ʊ d̪ ɐ l aː ɭ ɪ
முதலியார்	m ʊ d̪ ɐ l ɪ j aː ɾ
முதலீடு	m ʊ d̪ ɐ l iː ɖ ʊ
முதலுதவி	m ʊ d̪ ɐ l ʊ d̪ ɐ ʋ ɪ
முதலை	m ʊ d̪ ɐ l ɐ ɪ̯
முதல்	m ʊ d̪ ɐ l
முதல்வர்	m ʊ d̪ ɐ l ʋ ɐ ɾ
முதிர்	m ʊ d̪ ɪ ɾ
முதிர்ச்சி	m ʊ d̪ ɪ ɾ t͡ɕː ɪ
முதுகு	m ʊ d̪ ʊ ɡ ʊ
முதுகுநாணி	m ʊ d̪ ʊ ɡ ʊ n̪ aː ɳ ɪ
முதுமை	m ʊ d̪ ʊ m ɐ ɪ̯
முதுவேனில்	m ʊ d̪ ʊ ʋ eː n ɪ l
முத்தமிடு	m ʊ t̪ː ɐ m ɪ ɖ ʊ
முத்தமிழ்	m ʊ t̪ː ɐ m ɪ ɻ
முத்தம்	m ʊ t̪ː ɐ m
முத்தாசனம்	m ʊ t̪ː aː t͡ɕ ɐ n ɐ m
முத்தாடு	m ʊ t̪ː aː ɖ ʊ
முத்திக்கை	m ʊ t̪ː ɪ kː ɐ ɪ̯
முத்து	m ʊ t̪ː ʊ
முந்திரி	m ʊ n̪ d̪ ɪ ɾ ɪ
முன்	m ʊ n
முன்கை	m ʊ n ɡ ɐ ɪ̯
முன்னடியார்	m ʊ nː ɐ ɖ ɪ j aː ɾ
முன்னடியில்	m ʊ nː ɐ ɖ ɪ j ɪ l
முன்னணி	m ʊ nː ɐ ɳ ɪ
முன்னதாக	m ʊ nː ɐ d̪ aː ɡ ɐ
முன்னர்	m ʊ nː ɐ ɾ
முன்னாடி	m ʊ nː aː ɖ ɪ
முன்னுற	m ʊ nː ʊ r ɐ
முன்னூறு	m ʊ nː uː r ʊ
முன்னே	m ʊ nː eː
முன்னேற்றம்	m ʊ nː eː rː ɐ m
முன்னொட்டு	m ʊ nː ɔ ʈː ʊ
முன்னோர்	m ʊ nː oː ɾ
முன்பனி	m ʊ n b ɐ n ɪ
முன்பால்	m ʊ n b aː l
முன்பிற்படி	m ʊ n b ɪ r p ɐ ɖ ɪ
முன்பிலாண்டு	m ʊ n b ɪ l aː ɳ ɖ ʊ
முன்பில்	m ʊ n b ɪ l
முன்பு	m ʊ n b ʊ
முன்புருவம்	m ʊ n b ʊ ɾ ʊ ʋ ɐ m
முன்மாதிரி	m ʊ n m aː d̪ ɪ ɾ ɪ
முன்முகனை	m ʊ n m ʊ ɡ ɐ n ɐ ɪ̯
முன்றுறை	m ʊ n r ʊ r ɐ ɪ̯
முப்பது	m ʊ pː ɐ d̪ ʊ
முப்பாட்டன்	m ʊ pː aː ʈː ɐ n
முப்பால்	m ʊ pː aː l
முப்புள்ளி	m ʊ pː ʊ ɭː ɪ
முப்புவனம்	m ʊ pː ʊ ʋ ɐ n ɐ m
மும்பை	m ʊ m b ɐ ɪ̯
மும்மாரி	m ʊ mː aː ɾ ɪ
மும்மை	m ʊ mː ɐ ɪ̯
முயற்சி	m ʊ j ɐ r t͡ɕ ɪ
முயற்செவி	m ʊ j ɐ r t͡ɕ ɛ ʋ ɪ
முயல்	m ʊ j ɐ l
முரசு	m ʊ ɾ ɐ t͡ɕ ʊ
முரடு	m ʊ ɾ ɐ ɖ ʊ
முரணுரை	m ʊ ɾ ɐ ɳ ʊ ɾ ɐ ɪ̯
முரண்	m ʊ ɾ ɐ ɳ
முரண்டு	m ʊ ɾ ɐ ɳ ɖ ʊ
முரண்டுதல்	m ʊ ɾ ɐ ɳ ɖ ʊ d̪ ɐ l
முரண்மொழி	m ʊ ɾ ɐ ɳ m ɔ ɻ ɪ
முரளீதரன்	m ʊ ɾ ɐ ɭ iː d̪ ɐ ɾ ɐ n
முரி	m ʊ ɾ ɪ
முருகன்	m ʊ ɾ ʊ ɡ ɐ n
முருங்கை	m ʊ ɾ ʊ ŋ ɡ ɐ ɪ̯
முறுக்கு	m ʊ r ʊ kː ʊ
முறை	m ʊ r ɐ ɪ̯
முறைமை	m ʊ r ɐ ɪ̯ m ɐ ɪ̯
முறையீடு	m ʊ r ɐ ɪ̯ j iː ɖ ʊ
முற்கோள்	m ʊ r k oː ɭ
முற்பகல்	m ʊ r p ɐ ɡ ɐ l
முற்படு	m ʊ r p ɐ ɖ ʊ
முற்றிலும்	m ʊ rː ɪ l ʊ m
முற்று	m ʊ rː ʊ
முலாம்	m ʊ l aː m
முலாம்பூசு	m ʊ l aː m b uː t͡ɕ ʊ
முலை	m ʊ l ɐ ɪ̯
முலைக்கச்சு	m ʊ l ɐ ɪ̯ kː ɐ t͡ɕː ʊ
முலையூட்டி	m ʊ l ɐ ɪ̯ j uː ʈː ɪ
முளரி	m ʊ ɭ ɐ ɾ ɪ
முளை	m ʊ ɭ ɐ ɪ̯
முளைக்கீரை	m ʊ ɭ ɐ ɪ̯ kː iː ɾ ɐ ɪ̯
முள்	m ʊ ɭ
முள்கு	m ʊ ɭ ɡ ʊ
முள்நாறி	m ʊ ɭ n̪ aː r ɪ
முள்மகிழ்	m ʊ ɭ m ɐ ɡ ɪ ɻ
முள்ளங்கி	m ʊ ɭː ɐ ŋ ɡ ɪ
முள்ளங்கிழங்கு	m ʊ ɭː ɐ ŋ ɡ ɪ ɻ ɐ ŋ ɡ ʊ
முள்ளம்பன்றி	m ʊ ɭː ɐ m b ɐ n r ɪ
முள்ளம்பன்றிகள்	m ʊ ɭː ɐ m b ɐ n r ɪ ɡ ɐ ɭ
முள்ளம்பலாச்சை	m ʊ ɭː ɐ m b ɐ l aː t͡ɕː ɐ ɪ̯
முள்ளிலவு	m ʊ ɭː ɪ l ɐ ʋ ʊ
முள்ளுக்களா	m ʊ ɭː ʊ kː ɐ ɭ aː
முள்ளுமுருக்கு	m ʊ ɭː ʊ m ʊ ɾ ʊ kː ʊ
முள்வாளை	m ʊ ɭ ʋ aː ɭ ɐ ɪ̯
முள்வேலி	m ʊ ɭ ʋ eː l ɪ
முழங்கால்	m ʊ ɻ ɐ ŋ ɡ aː l
முழங்கை	m ʊ ɻ ɐ ŋ ɡ ɐ ɪ̯
முழம்	m ʊ ɻ ɐ m
முழி	m ʊ ɻ ɪ
முழு	m ʊ ɻ ʊ
முழுங்கு	m ʊ ɻ ʊ ŋ ɡ ʊ
முழுமதி	m ʊ ɻ ʊ m ɐ d̪ ɪ
முழுமை	m ʊ ɻ ʊ m ɐ ɪ̯
முழுவதும்	m ʊ ɻ ʊ ʋ ɐ d̪ ʊ m
முழை	m ʊ ɻ ɐ ɪ̯
முஸ்தாஜிரி	m ʊ s t̪ aː d͡ʑ ɪ ɾ ɪ
முஸ்லிம்	m ʊ s l ɪ m
முஸ்லீம்	m ʊ s l iː m
மூக்கண்ணாடி	m uː kː ɐ ɳː aː ɖ ɪ
மூக்கன்	m uː kː ɐ n
மூக்கு	m uː kː ʊ
மூக்குக்கொம்பன்	m uː kː ʊ kː ɔ m b ɐ n
மூக்குத்தி	m uː kː ʊ t̪ː ɪ
மூக்கை	m uː kː ɐ ɪ̯
மூங்கா	m uː ŋ ɡ aː
மூங்கில்	m uː ŋ ɡ ɪ l
மூச்சு	m uː t͡ɕː ʊ
மூச்சுவிடு	m uː t͡ɕː ʊ ʋ ɪ ɖ ʊ
மூஞ்சி	m uː ɲ d͡ʑ ɪ
மூடி	m uː ɖ ɪ
மூடு	m uː ɖ ʊ
மூடுபனி	m uː ɖ ʊ b ɐ n ɪ
மூட்டம்	m uː ʈː ɐ m
மூட்டு	m uː ʈː ʊ
மூட்டை	m uː ʈː ɐ ɪ̯
மூணு	m uː ɳ ʊ
மூதாதையர்	m uː d̪ aː d̪ ɐ ɪ̯ j ɐ ɾ
மூதாய்	m uː d̪ aː j
மூது	m uː d̪ ʊ
மூதுரை	m uː d̪ ʊ ɾ ɐ ɪ̯
மூத்திரம்	m uː t̪ː ɪ ɾ ɐ m
மூன்று	m uː n r ʊ
மூர்ச்சனை	m uː ɾ t͡ɕː ɐ n ɐ ɪ̯
மூர்ச்சி	m uː ɾ t͡ɕː ɪ
மூர்ச்சை	m uː ɾ t͡ɕː ɐ ɪ̯
மூற்றை	m uː rː ɐ ɪ̯
மூலக்கூறு	m uː l ɐ kː uː r ʊ
மூலதனம்	m uː l ɐ d̪ ɐ n ɐ m
மூலம்	m uː l ɐ m
மூளை	m uː ɭ ɐ ɪ̯
மூழ்கு	m uː ɻ ɡ ʊ
மூவர்	m uː ʋ ɐ ɾ
மூஸா	m uː s aː
மெட்டி	m ɛ ʈː ɪ
மெட்ராஸ்	m ɛ ɖ ɾ aː s
மெது	m ɛ d̪ ʊ
மெதுவான	m ɛ d̪ ʊ ʋ aː n ɐ
மெத்தம்பாரை	m ɛ t̪ː ɐ m b aː ɾ ɐ ɪ̯
மெத்து	m ɛ t̪ː ʊ
மெத்தை	m ɛ t̪ː ɐ ɪ̯
மென்தங்கம்	m ɛ n d̪ ɐ ŋ ɡ ɐ m
மென்னடை	m ɛ nː ɐ ɖ ɐ ɪ̯
மென்பொருள்	m ɛ n b ɔ ɾ ʊ ɭ
மென்மை	m ɛ n m ɐ ɪ̯
மென்வெள்ளி	m ɛ n ʋ ɛ ɭː ɪ
மெய்	m ɛ j
மெய்க்கோள்	m ɛ j kː oː ɭ
மெய்ப்பாட்டிசைக்குறி	m ɛ j pː aː ʈː ɪ t͡ɕ ɐ ɪ̯ kː ʊ r ɪ
மெய்யியல்	m ɛ jː ɪ j ɐ l
மெய்யெழுத்து	m ɛ jː ɛ ɻ ʊ t̪ː ʊ
மெருகு	m ɛ ɾ ʊ ɡ ʊ
மெலிவு	m ɛ l ɪ ʋ ʊ
மெல்	m ɛ l
மெல்லினம்	m ɛ l l ɪ n ɐ m
மெல்லிய	m ɛ l l ɪ j ɐ
மெல்லெழுத்து	m ɛ l l ɛ ɻ ʊ t̪ː ʊ
மே	m eː
மேகம்	m eː h ɐ m
மேகம்	m eː ɡ ɐ m
மேகலை	m eː ɡ ɐ l ɐ ɪ̯
மேகாலயா	m eː ɡ aː l ɐ j aː
மேசை	m eː t͡ɕ ɐ ɪ̯
மேஜை	m eː d͡ʑ ɐ ɪ̯
மேடு	m eː ɖ ʊ
மேடூகம்	m eː ɖ uː ɡ ɐ m
மேட்டிமை	m eː ʈː ɪ m ɐ ɪ̯
மேதினி	m eː d̪ ɪ n ɪ
மேனாடு	m eː n aː ɖ ʊ
மேனீர்	m eː n iː ɾ
மேன்மூடி	m eː n m uː ɖ ɪ
மேன்மை	m eː n m ɐ ɪ̯
மேன்றலை	m eː n r ɐ l ɐ ɪ̯
மேம்படு	m eː m b ɐ ɖ ʊ
மேம்பாடு	m eː m b aː ɖ ʊ
மேம்பாலம்	m eː m b aː l ɐ m
மேயல்	m eː j ɐ l
மேய்	m eː j
மேய்ச்சல்	m eː j t͡ɕː ɐ l
மேய்ப்பன்	m eː j pː ɐ n
மேய்ப்பு	m eː j pː ʊ
மேரை	m eː ɾ ɐ ɪ̯
மேற்கு	m eː r k ʊ
மேற்கூரை	m eː r k uː ɾ ɐ ɪ̯
மேற்கொண்டு	m eː r k ɔ ɳ ɖ ʊ
மேற்கோப்பு	m eː r k oː pː ʊ
மேற்செலவு	m eː r t͡ɕ ɛ l ɐ ʋ ʊ
மேற்படு	m eː r p ɐ ɖ ʊ
மேற்பட்டை	m eː r p ɐ ʈː ɐ ɪ̯
மேற்பார்வை	m eː r p aː ɾ ʋ ɐ ɪ̯
மேற்றளம்	m eː rː ɐ ɭ ɐ m
மேலங்கி	m eː l ɐ ŋ ɡ ɪ
மேலாண்மை	m eː l aː ɳ m ɐ ɪ̯
மேலால்	m eː l aː l
மேலிடு	m eː l ɪ ɖ ʊ
மேலிமை	m eː l ɪ m ɐ ɪ̯
மேலும்	m eː l ʊ m
மேலோடி	m eː l oː ɖ ɪ
மேல்	m eː l
மேஷம்	m eː ʂ ɐ m
மை	m ɐ ɪ̯
மைதா	m ɐ ɪ̯ d̪ aː
மைதானம்	m ɐ ɪ̯ d̪ aː n ɐ m
மைந்தன்	m ɐ ɪ̯ n̪ d̪ ɐ n
மைனா	m ɐ ɪ̯ n aː
மைனி	m ɐ ɪ̯ n ɪ
மைல்	m ɐ ɪ̯ l
மொச்சை	m ɔ t͡ɕː ɐ ɪ̯
மொட்டு	m ɔ ʈː ʊ
மொத	m o d̪ əː
மொத்தம்	m ɔ t̪ː ɐ m
மொய்	m ɔ j
மொய்ம்பு	m ɔ j m b ʊ
மொய்யற்சன்னி	m ɔ jː ɐ r t͡ɕ ɐ nː ɪ
மொழி	m ɔ ɻ ɪ
மொழிபு	m ɔ ɻ ɪ b ʊ
மொழிபெயர்ப்பு	m o ɻ i p e j a ɾ pː u
மொழியியல்	m ɔ ɻ ɪ j ɪ j ɐ l
மோ	m oː
மோகினியாட்டம்	m oː ɡ ɪ n ɪ j aː ʈː ɐ m
மோசம்	m oː t͡ɕ ɐ m
மோசே	m oː t͡ɕ eː
மோடு	m oː ɖ ʊ
மோதிரம்	m oː d̪ ɪ ɾ ɐ m
மோது	m oː d̪ ʊ
மோத்தை	m oː t̪ː ɐ ɪ̯
மோர்	m oː ɾ
மௌனம்	m ɐ ʊ̯ n ɐ m
மௌவல்	m ɐ ʊ̯ ʋ ɐ l
ம்	i m
ம்	i mː ɯ
ம்	m
ய	j ɐ
யக்கியோபவீதம்	j ɐ kː ɪ j oː b ɐ ʋ iː d̪ ɐ m
யமன்	j ɐ m ɐ n
யமுனை	j ɐ m ʊ n ɐ ɪ̯
யஹ்யா	j ɐ h j aː
யாகுவம்	j aː ɡ ʊ ʋ ɐ m
யாங்கண்	j aː ŋ ɡ ɐ ɳ
யாங்கு	j aː ŋ ɡ ʊ
யாது	j aː d̪ ʊ
யானம்	j aː n ɐ m
யானை	j aː n ɐ ɪ̯
யானைமதம்	j aː n ɐ ɪ̯ m ɐ d̪ ɐ m
யான்	j aː n
யாமம்	j aː m ɐ m
யாம்	j aː m
யாரோ	j aː ɾ oː
யார்	j aː ɾ
யாளி	j aː ɭ ɪ
யாழ்	j aː ɻ
யாழ்ப்பாணம்	j aː ɻ pː aː ɳ ɐ m
யாவது	j aː ʋ ɐ d̪ ʊ
யாவரும்	j aː ʋ ɐ ɾ ʊ m
யாவர்	j aː ʋ ɐ ɾ
யாவள்	j aː ʋ ɐ ɭ
யுகம்	j ʊ ɡ ɐ m
யுத்தம்	j ʊ t̪ː ɐ m
யூகி	j uː ɡ ɪ
யூதம்	j uː d̪ ɐ m
யோகக்ஷேமம்	j oː ɡ ɐ k ʂ eː m ɐ m
யோகசேமம்	j oː ɡ ɐ t͡ɕ eː m ɐ m
யோகட்சேமம்	j oː ɡ ɐ ʈ t͡ɕ eː m ɐ m
யோகம்	j oː ɡ ɐ m
யோகஸ்நானம்	j oː ɡ ɐ s n̪ aː n ɐ m
யோசனை	j oː t͡ɕ ɐ n ɐ ɪ̯
யோசி	j oː t͡ɕ ɪ
யோசுவா	j oː t͡ɕ ʊ ʋ aː
யோனி	j oː n ɪ
யோவான்	j oː ʋ aː n
யோவேல்	j oː ʋ eː l
ய்	i j
ய்	j
ர	ɾ ɐ
ரகசியம்	ɾ ɐ h ɐ s ɪ j ɐ m
ரகசியம்	ɾ ɐ ɡ ɐ t͡ɕ ɪ j ɐ m
ரகம்	ɾ ɐ ɡ ɐ m
ரக்ஷகன்	ɾ ɐ k ʂ ɐ ɡ ɐ n
ரக்ஷி	ɾ ɐ k ʂ ɪ
ரங்கநாதன்	ɾ ɐ ŋ ɡ ɐ n̪ aː d̪ ɐ n
ரங்கு	ɾ ɐ ŋ ɡ ʊ
ரசகற்பூரம்	ɾ a s a k a r p uː ɾ a m
ரசகற்பூரம்	ɾ ɐ s ɐ k ɐ r p uː ɾ ɐ m
ரசம்	ɾ ɐ t͡ɕ ɐ m
ரஜா	ɾ ɐ d͡ʑ aː
ரஞ்சிதம்	ɾ ɐ ɲ d͡ʑ ɪ d̪ ɐ m
ரத்தபித்தரோகம்	ɾ ɐ t̪ː ɐ b ɪ t̪ː ɐ ɾ oː ɡ ɐ m
ரத்தபூமி	ɾ ɐ t̪ː ɐ b uː m ɪ
ரத்தமசூரிகை	ɾ ɐ t̪ː ɐ m ɐ t͡ɕ uː ɾ ɪ ɡ ɐ ɪ̯
ரத்தம்	ɾ ɐ t̪ː ɐ m
ரத்தினம்	ɾ ɐ t̪ː ɪ n ɐ m
ரந்திரம்	ɾ ɐ n̪ d̪ ɪ ɾ ɐ m
ரப்பர்	ɾ ɐ pː ɐ ɾ
ரமலான்	ɾ ɐ m ɐ l aː n
ரம்சான்	ɾ ɐ m t͡ɕ aː n
ரம்பம்	ɾ ɐ m b ɐ m
ரம்மியம்	ɾ ɐ mː ɪ j ɐ m
ரயத்	ɾ ɐ j ɐ t̪
ரவை	ɾ ɐ ʋ ɐ ɪ̯
ரஷ்யா	ɾ ɐ ʂ j aː
ராகவன்	ɾ aː ɡ ɐ ʋ ɐ n
ராஜஸ்தான்	ɾ aː d͡ʑ ɐ s t̪ aː n
ராஜா	ɾ aː d͡ʑ aː
ராஜாத்தி	ɾ aː d͡ʑ aː t̪ː ɪ
ராஜிநாமா	ɾ aː d͡ʑ ɪ n̪ aː m aː
ராஜீயவாதி	ɾ aː d͡ʑ iː j ɐ ʋ aː d̪ ɪ
ராஜ்யம்	ɾ aː d͡ʑ j ɐ m
ராணி	ɾ aː ɳ ɪ
ராணிப்பேட்டை	ɾ aː ɳ ɪ pː eː ʈː ɐ ɪ̯
ராணுவம்	ɾ aː ɳ ʊ ʋ ɐ m
ராத்திரி	ɾ aː t̪ː ɪ ɾ ɪ
ராப்போஜனம்	ɾ aː pː oː d͡ʑ ɐ n ɐ m
ராமநாதன்	ɾ aː m ɐ n̪ aː d̪ ɐ n
ராமநாதபுரம்	ɾ aː m ɐ n̪ aː d̪ ɐ b ʊ ɾ ɐ m
ராமேசுவரம்	ɾ aː m eː t͡ɕ ʊ ʋ ɐ ɾ ɐ m
ராயன்	ɾ aː j ɐ n
ரிஷபம்	ɾ ɪ ʂ ɐ b ɐ m
ரிஷி	ɾ ɪ ʂ ɪ
ருசரகம்	ɾ ʊ t͡ɕ ɐ ɾ ɐ ɡ ɐ m
ருத்திரசடை	ɾ ʊ t̪ː ɪ ɾ ɐ t͡ɕ ɐ ɖ ɐ ɪ̯
ருப்புலக்கை	ɾ ʊ pː ʊ l ɐ kː ɐ ɪ̯
ரும்மான்	ɾ ʊ mː aː n
ரூத்	ɾ uː t̪
ரூபம்	ɾ uː b ɐ m
ரூபாய்	ɾ uː b aː j
ரெண்டு	ɾ ɛ ɳ ɖ ʊ
ரெம்பு	ɾ ɛ m b ʊ
ரேகை	ɾ eː h ɐ ɪ̯
ரேகை	ɾ eː ɡ ɐ ɪ̯
ரேவதி	ɾ eː ʋ ə t̪ ɪ
ரேவு	ɾ eː ʋ ʊ
ரொட்டி	ɾ ɔ ʈː ɪ
ரொம்ப	ɾ ɔ m b ɐ
ரொம்பு	ɾ ɔ m b ʊ
ரொஷ்டு	ɾ ɔ ʂ ʈ ʊ
ரோகம்	ɾ oː ɡ ɐ m
ரோகிணி	ɾ oː ɡ ɪ ɳ ɪ
ரோஜா	ɾ oː d͡ʑ aː
ரோஜாக்கள்	ɾ oː d͡ʑ aː kː ɐ ɭ
ரோஜ்	ɾ oː d͡ʑ
ரோஜ்கார்	ɾ oː d͡ʑ k aː ɾ
ரோதம்	ɾ oː d̪ ɐ m
ரோபோ	ɾ oː b oː
ரோமம்	ɾ oː m ɐ m
ரோமாபுரி	ɾ oː m aː b ʊ ɾ ɪ
ரோமாபுரி	ɾ oː m aː p u ɾ i
ரோம்	ɾ oː m
ரோஹிணி	ɾ oː h ɪ ɳ ɪ
ர்	i ɾ
ர்	i ɾ ɾ ɯ
ர்	ɾ
ற	r ɐ
றகரம்	r ɐ ɡ ɐ ɾ ɐ m
ற்	r
ல	l ɐ
லகரி	l ɐ ɡ ɐ ɾ ɪ
லக்குவா	l ɐ kː ʊ ʋ aː
லக்ஷணம்	l ɐ k ʂ ɐ ɳ ɐ m
லக்ஷம்	l ɐ k ʂ ɐ m
லக்ஷி	l ɐ k ʂ ɪ
லங்கர்	l ɐ ŋ ɡ ɐ ɾ
லஞ்சம்	l ɐ ɲ d͡ʑ ɐ m
லடாக்	l ɐ ɖ aː k
லடாய்	l ɐ ɖ aː j
லட்சம்	l ɐ ʈ t͡ɕ ɐ m
லட்டு	l ɐ ʈː ʊ
லதி	l ɐ d̪ ɪ
லதை	l ɐ d̪ ɐ ɪ̯
லத்தாடு	l ɐ t̪ː aː ɖ ʊ
லாடம்	l aː ɖ ɐ m
லாபம்	l aː b ɐ m
லாபுவான்	l aː b ʊ ʋ aː n
லாவோஸ்	l aː ʋ oː s
லிஸ்பன்	l ɪ s p ɐ n
லீக்டன்ஸ்டைன்	l iː k ʈ ɐ n s ʈ ɐ ɪ̯ n
லுங்கி	l ʊ ŋ ɡ ɪ
லேஞ்சி	l eː ɲ d͡ʑ ɪ
லொடுக்கு	l ɔ ɖ ʊ kː ʊ
லொள்ளு	l ɔ ɭː ʊ
லோககதி	l oː ɡ ɐ ɡ ɐ d̪ ɪ
லோகம்	l oː ɡ ɐ m
ல்	i l
ல்	i l l ɯ
ல்	l
ள	ɭ ɐ
ள்	ɭ
ழ	ɻ ɐ
ழ்	i ɻ
ழ்	ɻ
வ	ʋ ɐ
வகு	ʋ ɐ ɡ ʊ
வகுத்தல்	ʋ ɐ ɡ ʊ t̪ː ɐ l
வகுப்பு	ʋ ɐ ɡ ʊ pː ʊ
வகை	ʋ ɐ ɡ ɐ ɪ̯
வகைபாட்டியல்	ʋ ɐ ɡ ɐ ɪ̯ b aː ʈː ɪ j ɐ l
வக்கணம்	ʋ ɐ kː ɐ ɳ ɐ m
வக்கிரகட்கம்	ʋ ɐ kː ɪ ɾ ɐ ɡ ɐ ʈ k ɐ m
வக்திரம்	ʋ ɐ k t̪ ɪ ɾ ɐ m
வங்கணம்	ʋ ɐ ŋ ɡ ɐ ɳ ɐ m
வங்காளதேசம்	ʋ ɐ ŋ ɡ aː ɭ ɐ d̪ eː t͡ɕ ɐ m
வங்காளம்	ʋ ɐ ŋ ɡ aː ɭ ɐ m
வங்கி	ʋ ɐ ŋ ɡ ɪ
வங்கிக்கடன்	ʋ ɐ ŋ ɡ ɪ kː ɐ ɖ ɐ n
வங்கிக்கணக்கு	ʋ ɐ ŋ ɡ ɪ kː ɐ ɳ ɐ kː ʊ
வங்கியம்	ʋ ɐ ŋ ɡ ɪ j ɐ m
வசதி	ʋ ɐ t͡ɕ ɐ d̪ ɪ
வசந்தம்	ʋ ɐ t͡ɕ ɐ n̪ d̪ ɐ m
வசனம்	ʋ ɐ t͡ɕ ɐ n ɐ m
வசம்பு	ʋ ɐ t͡ɕ ɐ m b ʊ
வசி	ʋ ɐ t͡ɕ ɪ
வசியம்	ʋ ɐ t͡ɕ ɪ j ɐ m
வசீகரம்	ʋ ɐ t͡ɕ iː ɡ ɐ ɾ ɐ m
வச்சநாபி	ʋ ɐ t͡ɕː ɐ n̪ aː b ɪ
வஞ்சப்புகழ்ச்சி	ʋ ɐ ɲ d͡ʑ ɐ pː ʊ ɡ ɐ ɻ t͡ɕː ɪ
வஞ்சம்	ʋ ɐ ɲ d͡ʑ ɐ m
வஞ்சி	ʋ ɐ ɲ d͡ʑ ɪ
வட	ʋ ɐ ɖ ɐ
வடகம்	ʋ ɐ ɖ ɐ ɡ ɐ m
வடகறி	ʋ ɐ ɖ ɐ ɡ ɐ r ɪ
வடக்கன்	ʋ ɐ ɖ ɐ kː ɐ n
வடக்கு	ʋ ɐ ɖ ɐ kː ʊ
வடசொல்	ʋ ɐ ɖ ɐ t͡ɕ ɔ l
வடமேற்கு	ʋ ɐ ɖ ɐ m eː r k ʊ
வடமொழி	ʋ ɐ ɖ ɐ m ɔ ɻ ɪ
வடமொழியெழுத்து	ʋ ɐ ɖ ɐ m ɔ ɻ ɪ j ɛ ɻ ʊ t̪ː ʊ
வடி	ʋ ɐ ɖ ɪ
வடிகட்டு	ʋ ɐ ɖ ɪ ɡ ɐ ʈː ʊ
வடிவமைப்பு	ʋ ɐ ɖ ɪ ʋ ɐ m ɐ ɪ̯ pː ʊ
வடிவம்	ʋ ɐ ɖ ɪ ʋ ɐ m
வடிவியல்	ʋ ɐ ɖ ɪ ʋ ɪ j ɐ l
வடிவு	ʋ ɐ ɖ ɪ ʋ ʊ
வடு	ʋ ɐ ɖ ʊ
வடை	ʋ ɐ ɖ ɐ ɪ̯
வடைப்பருப்பு	ʋ ɐ ɖ ɐ ɪ̯ pː ɐ ɾ ʊ pː ʊ
வட்டி	ʋ ɐ ʈː ɪ
வட்டெழுத்து	ʋ ɐ ʈː ɛ ɻ ʊ t̪ː ʊ
வணக்கம்	ʋ ɐ ɳ ɐ kː ɐ m
வணங்கு	ʋ ɐ ɳ ɐ ŋ ɡ ʊ
வண்டி	ʋ ɐ ɳ ɖ ɪ
வண்டு	ʋ ɐ ɳ ɖ ʊ
வண்ணத்துப்பூச்சி	ʋ ɐ ɳː ɐ t̪ː ʊ pː uː t͡ɕː ɪ
வண்ணத்துப்பூச்சிகள்	ʋ ɐ ɳː ɐ t̪ː ʊ pː uː t͡ɕː ɪ ɡ ɐ ɭ
வண்ணம்	ʋ ɐ ɳː ɐ m
வண்ணாத்தான்	ʋ ɐ ɳː aː t̪ː aː n
வண்ணாத்திப்பூச்சி	ʋ ɐ ɳː aː t̪ː ɪ pː uː t͡ɕː ɪ
வதந்தி	ʋ ɐ d̪ ɐ n̪ d̪ ɪ
வதனம்	ʋ ɐ d̪ ɐ n ɐ m
வதம்	ʋ ɐ d̪ ɐ m
வதி	ʋ ɐ d̪ ɪ
வனம்	ʋ ɐ n ɐ m
வனாந்தரம்	ʋ ɐ n aː n̪ d̪ ɐ ɾ ɐ m
வன்கடத்தி	ʋ ɐ n k ɐ ɖ ɐ t̪ː i
வன்தங்கம்	ʋ ɐ n d̪ ɐ ŋ ɡ ɐ m
வன்னியர்	ʋ ɐ nː ɪ j ɐ ɾ
வன்பால்	ʋ ɐ n b aː l
வன்பொருள்	ʋ ɐ n b ɔ ɾ ʊ ɭ
வன்முறை	ʋ ɐ n m ʊ r ɐ ɪ̯
வன்மை	ʋ ɐ n m ɐ ɪ̯
வன்வெள்ளி	ʋ ɐ n ʋ ɛ ɭː ɪ
வமிசம்	ʋ ɐ m ɪ t͡ɕ ɐ m
வமிசாவளி	ʋ ɐ m ɪ t͡ɕ aː ʋ ɐ ɭ ɪ
வம்சம்	ʋ ɐ m t͡ɕ ɐ m
வயசு	ʋ ɐ j ɐ t͡ɕ ʊ
வயது	ʋ ɐ j ɐ d̪ ʊ
வயநாடு	ʋ ɐ j ɐ n̪ aː ɖ ʊ
வயல்	ʋ ɐ j ɐ l
வரகு	ʋ ɐ ɾ ɐ ɡ ʊ
வரடம்	ʋ ɐ ɾ ɐ ɖ ɐ m
வரணம்	ʋ ɐ ɾ ɐ ɳ ɐ m
வரதட்சணை	ʋ ɐ ɾ ɐ d̪ ɐ ʈ t͡ɕ ɐ ɳ ɐ ɪ̯
வரத்து	ʋ ɐ ɾ ɐ t̪ː ʊ
வரன்முறை	ʋ ɐ ɾ ɐ n m ʊ r ɐ ɪ̯
வரப்பண்ணு	ʋ ɐ ɾ ɐ pː ɐ ɳː ʊ
வரப்பு	ʋ ɐ ɾ ɐ pː ʊ
வரம்	ʋ ɐ ɾ ɐ m
வரம்பு	ʋ ɐ ɾ ɐ m b ʊ
வரலாறு	ʋ ɐ ɾ ɐ l aː r ʊ
வரலாற்று	ʋ ɐ ɾ ɐ l aː rː ʊ
வரவு	ʋ ɐ ɾ ɐ ʋ ʊ
வரவேற்கிறேன்	ʋ ɐ ɾ ɐ ʋ eː r k ɪ r eː n
வரி	ʋ ɐ ɾ ɪ
வரிக்குதிரை	ʋ ɐ ɾ ɪ kː ʊ d̪ ɪ ɾ ɐ ɪ̯
வரிசை	ʋ ɐ ɾ ɪ t͡ɕ ɐ ɪ̯
வரிச்சல்	ʋ ɐ ɾ ɪ t͡ɕː ɐ l
வருகமஞ்சள்	ʋ ɐ ɾ ʊ ɡ ɐ m ɐ ɲ d͡ʑ ɐ ɭ
வருக்கணம்	ʋ ɐ ɾ ʊ kː ɐ ɳ ɐ m
வருடப்பிறப்பு	ʋ ɐ ɾ ʊ ɖ ɐ pː ɪ r ɐ pː ʊ
வருடம்	ʋ ɐ ɾ ʊ ɖ ɐ m
வருணனை	ʋ ɐ ɾ ʊ ɳ ɐ n ɐ ɪ̯
வருணன்	ʋ ɐ ɾ ʊ ɳ ɐ n
வருத்தங்கள்	ʋ ɐ ɾ ʊ t̪ː ɐ ŋ ɡ ɐ ɭ
வருத்தம்	ʋ ɐ ɾ ʊ t̪ː ɐ m
வருத்தி	ʋ ɐ ɾ ʊ t̪ː ɪ
வருத்து	ʋ ɐ ɾ ʊ t̪ː ʊ
வருந்து	ʋ ɐ ɾ ʊ n̪ d̪ ʊ
வருபொருள்	ʋ ɐ ɾ ʊ b ɔ ɾ ʊ ɭ
வருபோகம்	ʋ ɐ ɾ ʊ b oː ɡ ɐ m
வரும்	ʋ ɐ ɾ ʊ m
வரும்படி	ʋ ɐ ɾ ʊ m b ɐ ɖ ɪ
வருவி	ʋ ɐ ɾ ʊ ʋ ɪ
வருஷம்	ʋ ɐ ɾ ʊ ʂ ɐ m
வரை	ʋ ɐ ɾ ɐ ɪ̯
வரைபடம்	ʋ ɐ ɾ ɐ ɪ̯ b ɐ ɖ ɐ m
வரையாடு	ʋ ɐ ɾ ɐ ɪ̯ j aː ɖ ʊ
வர்ணம்	ʋ ɐ ɾ ɳ ɐ m
வர்ணி	ʋ ɐ ɾ ɳ ɪ
வர்ஷம்	ʋ ɐ ɾ ʂ ɐ m
வறடு	ʋ ɐ r ɐ ɖ ʊ
வறட்சி	ʋ ɐ r ɐ ʈ t͡ɕ ɪ
வறட்டி	ʋ ɐ r ɐ ʈː ɪ
வறம்	ʋ ɐ r ɐ m
வறு	ʋ ɐ r ʊ
வறுநிலம்	ʋ ɐ r ʊ n̪ ɪ l ɐ m
வறுமை	ʋ ɐ r ʊ m ɐ ɪ̯
வற்பு	ʋ ɐ r p ʊ
வற்றம்	ʋ ɐ rː ɐ m
வற்றல்	ʋ ɐ rː ɐ l
வலங்கம்	ʋ ɐ l ɐ ŋ ɡ ɐ m
வலசை	ʋ ɐ l ɐ t͡ɕ ɐ ɪ̯
வலது	ʋ ɐ l ɐ d̪ ʊ
வலம்	ʋ ɐ l ɐ m
வலாகம்	ʋ ɐ l aː ɡ ɐ m
வலி	ʋ ɐ l ɪ
வலிப்பு	ʋ ɐ l ɪ pː ʊ
வலிமை	ʋ ɐ l ɪ m ɐ ɪ̯
வலுப்பு	ʋ ɐ l ʊ pː ʊ
வலுமை	ʋ ɐ l ʊ m ɐ ɪ̯
வலை	ʋ ɐ l ɐ ɪ̯
வலைஒளி	ʋ ɐ l ɐ ɪ̯ ɔ ɭ ɪ
வலைத்தளம்	ʋ ɐ l ɐ ɪ̯ t̪ː ɐ ɭ ɐ m
வலைப்பக்கம்	ʋ ɐ l ɐ ɪ̯ pː ɐ kː ɐ m
வலைப்பின்னல்	ʋ ɐ l ɐ ɪ̯ pː ɪ nː ɐ l
வலைப்பின்னல்கள்	ʋ ɐ l ɐ ɪ̯ pː ɪ nː ɐ l ɡ ɐ ɭ
வலையமைப்பு	ʋ ɐ l ɐ ɪ̯ j ɐ m ɐ ɪ̯ pː ʊ
வலையொளி	ʋ ɐ l ɐ ɪ̯ j ɔ ɭ ɪ
வல்	ʋ ɐ l
வல்ல	ʋ ɐ l l ɐ
வல்லடி	ʋ ɐ l l ɐ ɖ ɪ
வல்லபம்	ʋ ɐ l l ɐ b ɐ m
வல்லமை	ʋ ɐ l l ɐ m ɐ ɪ̯
வல்லரி	ʋ ɐ l l ɐ ɾ ɪ
வல்லவன்	ʋ ɐ l l ɐ ʋ ɐ n
வல்லாமை	ʋ ɐ l l aː m ɐ ɪ̯
வல்லாரை	ʋ ɐ l l aː ɾ ɐ ɪ̯
வல்லிதின்	ʋ ɐ l l ɪ d̪ ɪ n
வல்லினம்	ʋ ɐ l l ɪ n ɐ m
வல்லுநர்	ʋ ɐ l l ʊ n̪ ɐ ɾ
வல்லுரம்	ʋ ɐ l l ʊ ɾ ɐ m
வல்லுளி	ʋ ɐ l l ʊ ɭ ɪ
வல்லூற்று	ʋ ɐ l l uː rː ʊ
வல்லெழுத்து	ʋ ɐ l l ɛ ɻ ʊ t̪ː ʊ
வல்லேறு	ʋ ɐ l l eː r ʊ
வல்லை	ʋ ɐ l l ɐ ɪ̯
வளப்பம்	ʋ ɐ ɭ ɐ pː ɐ m
வளமை	ʋ ɐ ɭ ɐ m ɐ ɪ̯
வளம்	ʋ ɐ ɭ ɐ m
வளர்	ʋ ɐ ɭ ɐ ɾ
வளர்ச்சி	ʋ ɐ ɭ ɐ ɾ t͡ɕː ɪ
வளர்பிறை	ʋ ɐ ɭ ɐ ɾ b ɪ r ɐ ɪ̯
வளர்ப்பு	ʋ ɐ ɭ ɐ ɾ pː ʊ
வளாகம்	ʋ ɐ ɭ aː ɡ ɐ m
வளி	ʋ ɐ ɭ ɪ
வளை	ʋ ɐ ɭ ɐ ɪ̯
வளையல்	ʋ ɐ ɭ ɐ ɪ̯ j ɐ l
வளைவு	ʋ ɐ ɭ ɐ ɪ̯ ʋ ʊ
வள்ளம்	ʋ ɐ ɭː ɐ m
வள்ளல்	ʋ ɐ ɭː ɐ l
வள்ளி	ʋ ɐ ɭː ɪ
வழக்கமாய்	ʋ ɐ ɻ ɐ kː ɐ m aː j
வழக்கம்	ʋ ɐ ɻ ɐ kː ɐ m
வழக்கறிஞர்	ʋ ɐ ɻ ɐ kː ɐ r ɪ ɲ ɐ ɾ
வழக்கு	ʋ ɐ ɻ ɐ kː ʊ
வழங்காப்பொழுது	ʋ ɐ ɻ ɐ ŋ ɡ aː pː ɔ ɻ ʊ d̪ ʊ
வழங்கு	ʋ ɐ ɻ ɐ ŋ ɡ ʊ
வழலிக்கை	ʋ ɐ ɻ ɐ l ɪ kː ɐ ɪ̯
வழவழப்பு	ʋ ɐ ɻ ɐ ʋ ɐ ɻ ɐ pː ʊ
வழி	ʋ ɐ ɻ ɪ
வழிகாட்டு	ʋ ɐ ɻ ɪ ɡ aː ʈː ʊ
வழிச்செலவு	ʋ ɐ ɻ ɪ t͡ɕː ɛ l ɐ ʋ ʊ
வழிஞ்சி	ʋ ɐ ɻ ɪ ɲ d͡ʑ ɪ
வழிநடை	ʋ ɐ ɻ ɪ n̪ ɐ ɖ ɐ ɪ̯
வழிபாடு	ʋ ɐ ɻ ɪ b aː ɖ ʊ
வழிப்பயணம்	ʋ ɐ ɻ ɪ pː ɐ j ɐ ɳ ɐ m
வழிவகை	ʋ ɐ ɻ ɪ ʋ ɐ ɡ ɐ ɪ̯
வழுக்கு	ʋ ɐ ɻ ʊ kː ʊ
வழுக்கை	ʋ ɐ ɻ ʊ kː ɐ ɪ̯
வழுதலை	ʋ ɐ ɻ ʊ d̪ ɐ l ɐ ɪ̯
வழுவழுப்பு	ʋ ɐ ɻ ʊ ʋ ɐ ɻ ʊ pː ʊ
வவ்வால்	ʋ ɐ ʋː aː l
வவ்வால்கள்	ʋ ɐ ʋː aː l ɡ ɐ ɭ
வவ்வு	ʋ ɐ ʋː ʊ
வஸ்து	ʋ ɐ s t̪ ʊ
வா	ʋ aː
வாகடம்	ʋ aː ɡ ɐ ɖ ɐ m
வாகனம்	ʋ aː ɡ ɐ n ɐ m
வாகம்	ʋ aː ɡ ɐ m
வாகினி	ʋ aː ɡ ɪ n ɪ
வாகியம்	ʋ aː ɡ ɪ j ɐ m
வாக்களி	ʋ aː kː ɐ ɭ ɪ
வாக்களிப்பு	ʋ aː kː ɐ ɭ ɪ pː ʊ
வாக்காடு	ʋ aː kː aː ɖ ʊ
வாக்காட்டு	ʋ aː kː aː ʈː ʊ
வாக்காளர்	ʋ aː kː aː ɭ ɐ ɾ
வாக்கியம்	ʋ aː kː ɪ j ɐ m
வாக்கு	ʋ aː kː ʊ
வாக்குத்தத்தம்	ʋ aː kː ʊ t̪ː ɐ t̪ː ɐ m
வாக்குவாதம்	ʋ aː kː ʊ ʋ aː d̪ ɐ m
வாங்கு	ʋ aː ŋ ɡ ʊ
வாசனை	ʋ aː t͡ɕ ɐ n ɐ ɪ̯
வாசல்	ʋ aː t͡ɕ ɐ l
வாசஸ்தலம்	ʋ aː t͡ɕ ɐ s t̪ ɐ l ɐ m
வாசி	ʋ aː t͡ɕ ɪ
வாசிதம்	ʋ aː t͡ɕ ɪ d̪ ɐ m
வாடகை	ʋ aː ɖ ɐ ɡ ɐ ɪ̯
வாடு	ʋ aː ɖ ʊ
வாட்டம்	ʋ aː ʈː ɐ m
வாட்ஸ்அப்	ʋ aː ʈ s ɐ p
வாணாள்	ʋ aː ɳ aː ɭ
வாணியன்பொருவா	ʋ aː ɳ ɪ j ɐ n b ɔ ɾ ʊ ʋ aː
வாதை	ʋ aː d̪ ɐ ɪ̯
வாத்து	ʋ aː t̪ː ʊ
வாத்துக்கள்	ʋ aː t̪ː ʊ kː ɐ ɭ
வாந்தி	ʋ aː n̪ d̪ ɪ
வானகம்	ʋ aː n ɐ ɡ ɐ m
வானம்	ʋ aː n ɐ m
வானம்பாடி	ʋ aː n ɐ m b aː ɖ i
வானம்பாடி	ʋ aː n ɐ m p aː ɖ i
வானவர்	ʋ aː n ɐ ʋ ɐ ɾ
வானவில்	ʋ aː n ɐ ʋ ɪ l
வானியல்	ʋ aː n ɪ j ɐ l
வானிலை	ʋ aː n ɪ l ɐ ɪ̯
வானூர்தி	ʋ aː n uː ɾ d̪ ɪ
வானொலி	ʋ aː n ɔ l ɪ
வான்	ʋ aː n
வான்கோழி	ʋ aː n ɡ oː ɻ ɪ
வான்படை	ʋ aː n b ɐ ɖ ɐ ɪ̯
வாயன்	ʋ aː j ɐ n
வாயவியஸ்நானம்	ʋ aː j ɐ ʋ ɪ j ɐ s n̪ aː n ɐ m
வாயின்மாடம்	ʋ aː j ɪ n m aː ɖ ɐ m
வாயில்	ʋ aː j ɪ l
வாயு	ʋ aː j ʊ
வாய்	ʋ aː j
வாய்குமட்டல்	ʋ aː j ɡ ʊ m ɐ ʈː ɐ l
வாய்க்கால்	ʋ aː j kː aː l
வாய்ச்சி	ʋ aː j t͡ɕː ɪ
வாய்ச்சுத்தம்	ʋ aː j t͡ɕː ʊ t̪ː ɐ m
வாய்ச்சொலவு	ʋ aː j t͡ɕː ɔ l ɐ ʋ ʊ
வாய்ச்சொல்	ʋ aː j t͡ɕː ɔ l
வாய்தல்	ʋ aː j d̪ ɐ l
வாய்நீர்	ʋ aː j n̪ iː ɾ
வாய்ப்பாட்டு	ʋ aː j pː aː ʈː ʊ
வாய்ப்பு	ʋ aː j pː ʊ
வாய்மை	ʋ aː j m ɐ ɪ̯
வாரணம்	ʋ aː ɾ ɐ ɳ ɐ m
வாரப்படு	ʋ aː ɾ ɐ pː ɐ ɖ ʊ
வாரப்பாடு	ʋ aː ɾ ɐ pː aː ɖ ʊ
வாரம்	ʋ aː ɾ ɐ m
வாராவதி	ʋ aː ɾ aː ʋ ɐ d̪ ɪ
வாரிசு	ʋ aː ɾ ɪ t͡ɕ ʊ
வாரியல்	ʋ aː ɾ ɪ j ɐ l
வாரு	ʋ aː ɾ ʊ
வார்	ʋ aː ɾ
வார்த்தை	ʋ aː ɾ t̪ː ɐ ɪ̯
வார்ப்புரு	ʋ aː ɾ pː ʊ ɾ ʊ
வாலெலும்பு	ʋ aː l ɛ l ʊ m b ʊ
வால்	ʋ aː l
வால்நட்சத்திரம்	ʋ aː l n̪ ɐ ʈ t͡ɕ ɐ t̪ː ɪ ɾ ɐ m
வால்மீன்	ʋ aː l m iː n
வால்மீன்கள்	ʋ aː l m iː n ɡ ɐ ɭ
வால்வெள்ளி	ʋ aː l ʋ ɛ ɭː ɪ
வாளம்	ʋ aː ɭ ɐ m
வாளை	ʋ aː ɭ ɐ ɪ̯
வாள்	ʋ aː ɭ
வாழை	ʋ aː ɻ ɐ ɪ̯
வாழைப்பழம்	ʋ aː ɻ ɐ ɪ̯ pː ɐ ɻ ɐ m
வாழைப்பூ	ʋ aː ɻ ɐ ɪ̯ pː uː
வாழ்	ʋ aː ɻ
வாழ்க்கை	ʋ aː ɻ kː ɐ ɪ̯
வாழ்ச்சி	ʋ aː ɻ t͡ɕː ɪ
வாழ்த்து	ʋ aː ɻ t̪ː ʊ
வாழ்த்துரை	ʋ aː ɻ t̪ː ʊ ɾ ɐ ɪ̯
வாழ்நர்	ʋ aː ɻ n̪ ɐ ɾ
வாழ்நாள்	ʋ aː ɻ n̪ aː ɭ
வாழ்வு	ʋ aː ɻ ʋ ʊ
விகடகவி	ʋ ɪ ɡ ɐ ɖ ɐ ɡ ɐ ʋ ɪ
விகாரம்	ʋ ɪ h aː ɾ ɐ m
விகாரம்	ʋ ɪ ɡ aː ɾ ɐ m
விக்கல்	ʋ ɪ kː ɐ l
விக்கிரகம்	ʋ ɪ kː ɪ ɾ ɐ h ɐ m
விக்கிரகம்	ʋ ɪ kː ɪ ɾ ɐ ɡ ɐ m
விக்கு	ʋ ɪ kː ʊ
விக்சனரி	ʋ ɪ k t͡ɕ ɐ n ɐ ɾ ɪ
விசனம்	ʋ ɪ t͡ɕ ɐ n ɐ m
விசயநகரம்	ʋ ɪ t͡ɕ ɐ j ɐ n̪ ɐ ɡ ɐ ɾ ɐ m
விசாகப்பட்டினம்	ʋ ɪ t͡ɕ aː ɡ ɐ pː ɐ ʈː ɪ n ɐ m
விசாரணை	ʋ ɪ t͡ɕ aː ɾ ɐ ɳ ɐ ɪ̯
விசாலம்	ʋ ɪ t͡ɕ aː l ɐ m
விசித்திரம்	ʋ ɪ t͡ɕ ɪ t̪ː ɪ ɾ ɐ m
விசிறி	ʋ ɪ t͡ɕ ɪ r ɪ
விசுவகருமா	ʋ ɪ t͡ɕ ʊ ʋ ɐ ɡ ɐ ɾ ʊ m aː
விசுவநாதன்	ʋ ɪ t͡ɕ ʊ ʋ ɐ n̪ aː d̪ ɐ n
விசுவாசம்	ʋ ɪ t͡ɕ ʊ ʋ aː t͡ɕ ɐ m
விசேடணம்	ʋ ɪ t͡ɕ eː ɖ ɐ ɳ ɐ m
விசேஷம்	ʋ ɪ t͡ɕ eː ʂ ɐ m
விசைத்தறி	ʋ ɪ t͡ɕ ɐ ɪ̯ t̪ː ɐ r ɪ
விசைப்பலகை	ʋ ɪ t͡ɕ ɐ ɪ̯ pː ɐ l ɐ ɡ ɐ ɪ̯
விச்சுவநாதன்	ʋ ɪ t͡ɕː ʊ ʋ ɐ n̪ aː d̪ ɐ n
விச்சை	ʋ ɪ t͡ɕː ɐ ɪ̯
விஞ்ஞானம்	ʋ ɪ ɲː aː n ɐ m
விட	ʋ ɪ ɖ ɐ
விடம்	ʋ ɪ ɖ ɐ m
விடர்	ʋ ɪ ɖ ɐ ɾ
விடியல்	ʋ ɪ ɖ ɪ j ɐ l
விடிவெள்ளி	ʋ ɪ ɖ ɪ ʋ ɛ ɭː ɪ
விடு	ʋ ɪ ɖ ʊ
விடுதலை	ʋ ɪ ɖ ʊ d̪ ɐ l ɐ ɪ̯
விடுவம்	ʋ ɪ ɖ ʊ ʋ ɐ m
விடுவி	ʋ ɪ ɖ ʊ ʋ ɪ
விடை	ʋ ɪ ɖ ɐ ɪ̯
விட்டம்	ʋ ɪ ʈː ɐ m
விட்டுணுக்கிராந்தி	ʋ ɪ ʈː ʊ ɳ ʊ kː ɪ ɾ aː n̪ d̪ ɪ
விட்டுணுப்பிரியம்	ʋ ɪ ʈː ʊ ɳ ʊ pː ɪ ɾ ɪ j ɐ m
விண்கலம்	ʋ ɪ ɳ ɡ ɐ l ɐ m
விண்ணுளவி	ʋ ɪ ɳː ʊ ɭ ɐ ʋ ɪ
விண்மீன்	ʋ ɪ ɳ m iː n
விண்வீழ்கொள்ளி	ʋ ɪ ɳ ʋ iː ɻ ɡ ɔ ɭː ɪ
விண்வீழ்கொள்ளிகள்	ʋ ɪ ɳ ʋ iː ɻ ɡ ɔ ɭː ɪ ɡ ɐ ɭ
விண்வெளி	ʋ ɪ ɳ ʋ ɛ ɭ ɪ
விதவை	ʋ ɪ d̪ ɐ ʋ ɐ ɪ̯
விதி	ʋ ɪ d̪ ɪ
விதை	ʋ ɪ d̪ ɐ ɪ̯
விதைப்பை	ʋ ɪ d̪ ɐ ɪ̯ pː ɐ ɪ̯
வித்தியாசம்	ʋ ɪ d̪ d̪ ɪ j aː t͡ɕ ɐ m
வித்து	ʋ ɪ t̪ː ʊ
விநாடி	ʋ ɪ n̪ aː ɖ ɪ
விநாயகன்	ʋ ɪ n̪ aː j ɐ ɡ ɐ n
விந்து	ʋ ɪ n̪ d̪ ʊ
வினவு	ʋ ɪ n ɐ ʋ ʊ
வினா	ʋ ɪ n aː
வினாக்கள்	ʋ ɪ n aː kː ɐ ɭ
வினாக்குறி	ʋ ɪ n aː kː ʊ r ɪ
வினாவெழுத்து	ʋ ɪ n aː ʋ ɛ ɻ ʊ t̪ː ʊ
வினை	ʋ ɪ n ɐ ɪ̯
வினைச்சொல்	ʋ ɪ n ɐ ɪ̯ t͡ɕː ɔ l
வினைமுற்று	ʋ ɪ n ɐ ɪ̯ m ʊ rː ʊ
வினைவியம்	ʋ ɪ n ɐ ɪ̯ ʋ ɪ j ɐ m
விபச்சாரம்	ʋ ɪ b ɐ t͡ɕː aː ɾ ɐ m
விபத்தி	ʋ ɪ b ɐ t̪ː ɪ
விபத்து	ʋ ɪ b ɐ t̪ː ʊ
விபுத்துவம்	ʋ ɪ b ʊ t̪ː ʊ ʋ ɐ m
விமரிசம்	ʋ ɪ m ɐ ɾ ɪ t͡ɕ ɐ m
விமர்சனம்	ʋ ɪ m ɐ ɾ t͡ɕ ɐ n ɐ m
விமர்சி	ʋ ɪ m ɐ ɾ t͡ɕ ɪ
விமானம்	ʋ ɪ m aː n ɐ m
விமோசனம்	ʋ ɪ m oː t͡ɕ ɐ n ɐ m
வியட்நாம்	ʋ ɪ j ɐ ʈ n̪ aː m
வியம்	ʋ ɪ j ɐ m
வியர்	ʋ ɪ j ɐ ɾ
வியர்வை	ʋ ɪ j ɐ ɾ ʋ ɐ ɪ̯
வியல்	ʋ ɪ j ɐ l
வியாபாரம்	ʋ ɪ j aː b aː ɾ ɐ m
வியாபாரி	ʋ ɪ j aː b aː ɾ ɪ
வியாபி	ʋ ɪ j aː b ɪ
வியாழக்கிழமை	ʋ ɪ j aː ɻ ɐ kː ɪ ɻ ɐ m ɐ ɪ̯
வியாழன்	ʋ ɪ j aː ɻ ɐ n
வியாழம்	ʋ ɪ j aː ɻ ɐ m
விரக்தி	ʋ ɪ ɾ ɐ k t̪ ɪ
விரதம்	ʋ ɪ ɾ ɐ d̪ ɐ m
விரயம்	ʋ ɪ ɾ ɐ j ɐ m
விரல்	ʋ ɪ ɾ ɐ l
விரி	ʋ ɪ ɾ ɪ
விரிகாசம்	ʋ ɪ ɾ ɪ ɡ aː t͡ɕ ɐ m
விரிகோணம்	ʋ ɪ ɾ ɪ ɡ oː ɳ ɐ m
விரியன்	ʋ ɪ ɾ ɪ j ɐ n
விருகற்பாதம்	ʋ ɪ ɾ ʊ ɡ ɐ r p aː d̪ ɐ m
விருக்ஷம்	ʋ ɪ ɾ ʊ k ʂ ɐ m
விருச்சிகம்	ʋ ɪ ɾ ʊ t͡ɕː ɪ ɡ ɐ m
விருட்சம்	ʋ ɪ ɾ ʊ ʈ t͡ɕ ɐ m
விருதுநகர்	ʋ ɪ ɾ ʊ d̪ ʊ n̪ ɐ ɡ ɐ ɾ
விருத்தசேதனம்	ʋ ɪ ɾ ʊ t̪ː ɐ t͡ɕ eː d̪ ɐ n ɐ m
விருத்தாச்சலம்	ʋ ɪ ɾ ʊ t̪ː aː t͡ɕː ɐ l ɐ m
விருத்தி	ʋ ɪ ɾ ʊ t̪ː ɪ
விருந்து	ʋ ɪ ɾ ʊ n̪ d̪ ʊ
விருப்பம்	ʋ ɪ ɾ ʊ pː ɐ m
விரும்பு	ʋ ɪ ɾ ʊ m b ʊ
விருஷ்டி	ʋ ɪ ɾ ʊ ʂ ʈ ɪ
விரை	ʋ ɪ ɾ ɐ ɪ̯
விரைவில்	ʋ ɪ ɾ ɐ ɪ̯ ʋ ɪ l
விரைவு	ʋ ɪ ɾ ɐ ɪ̯ ʋ ʊ
விரைவுச்சாலை	ʋ ɪ ɾ ɐ ɪ̯ ʋ ʊ t͡ɕː aː l ɐ ɪ̯
விரோதம்	ʋ ɪ ɾ oː d̪ ɐ m
விறகு	ʋ ɪ r ɐ ɡ ʊ
விலகு	ʋ ɪ l ɐ ɡ ʊ
விலங்கி	ʋ ɪ l ɐ ŋ ɡ ɪ
விலங்கியல்	ʋ ɪ l ɐ ŋ ɡ ɪ j ɐ l
விலங்கு	ʋ ɪ l ɐ ŋ ɡ ʊ
விலயம்	ʋ ɪ l ɐ j ɐ m
விலை	ʋ ɪ l ɐ ɪ̯
வில்	ʋ ɪ l
வில்லன்	ʋ ɪ l l ɐ n
வில்வித்தை	ʋ ɪ l ʋ ɪ t̪ː ɐ ɪ̯
விளக்கம்	ʋ ɪ ɭ ɐ kː ɐ m
விளக்கு	ʋ ɪ ɭ ɐ kː ʊ
விளங்கு	ʋ ɪ ɭ ɐ ŋ ɡ ʊ
விளம்பம்	ʋ ɪ ɭ ɐ m b ɐ m
விளம்பரம்	ʋ ɪ ɭ ɐ m b ɐ ɾ ɐ m
விளம்பு	ʋ ɪ ɭ ɐ m b ʊ
விளை	ʋ ɪ ɭ ɐ ɪ̯
விளைஞர்	ʋ ɪ ɭ ɐ ɪ̯ ɲ ɐ ɾ
விளைநிலம்	ʋ ɪ ɭ ɐ ɪ̯ n̪ ɪ l ɐ m
விளைபொருள்	ʋ ɪ ɭ ɐ ɪ̯ b ɔ ɾ ʊ ɭ
விளையாடு	ʋ ɪ ɭ ɐ ɪ̯ j aː ɖ ʊ
விளையாட்டு	ʋ ɪ ɭ ɐ ɪ̯ j aː ʈː ʊ
விளைவி	ʋ ɪ ɭ ɐ ɪ̯ ʋ ɪ
விளைவு	ʋ ɪ ɭ ɐ ɪ̯ ʋ ʊ
விழா	ʋ ɪ ɻ aː
விழி	ʋ ɪ ɻ ɪ
விழு	ʋ ɪ ɻ ʊ
விழுக்காடு	ʋ ɪ ɻ ʊ kː aː ɖ ʊ
விழுங்கு	ʋ ɪ ɻ ʊ ŋ ɡ ʊ
விழுதி	ʋ ɪ ɻ ʊ d̪ ɪ
விழுது	ʋ ɪ ɻ ʊ d̪ ʊ
விழுப்புரம்	ʋ ɪ ɻ ʊ pː ʊ ɾ ɐ m
விழைவு	ʋ ɪ ɻ ɐ ɪ̯ ʋ ʊ
விவகாரம்	ʋ ɪ ʋ ɐ ɡ aː ɾ ɐ m
விவசாயம்	ʋ ɪ ʋ ɐ t͡ɕ aː j ɐ m
விவசாயி	ʋ ɪ ʋ ɐ t͡ɕ aː j ɪ
விவரணம்	ʋ ɪ ʋ ɐ ɾ ɐ ɳ ɐ m
விவரிப்பு	ʋ ɪ ʋ ɐ ɾ ɪ pː ʊ
விவாகம்	ʋ ɪ ʋ aː h ɐ m
விவாகம்	ʋ ɪ ʋ aː ɡ ɐ m
விவாகரத்து	ʋ ɪ ʋ aː ɡ ɐ ɾ ɐ t̪ː ʊ
விவாஹம்	ʋ ɪ ʋ aː h ɐ m
விவிலியம்	ʋ ɪ ʋ ɪ l ɪ j ɐ m
விஷம்	ʋ ɪ ʂ ɐ m
விஷயசூசிகை	ʋ ɪ ʂ ɐ j ɐ t͡ɕ uː t͡ɕ ɪ ɡ ɐ ɪ̯
விஷாதம்	ʋ ɪ ʂ aː d̪ ɐ m
விஷ்ணு	ʋ ɪ ʂ ɳ ʊ
வீங்கு	ʋ iː ŋ ɡ ʊ
வீசு	ʋ iː t͡ɕ ʊ
வீச்சு	ʋ iː t͡ɕː ʊ
வீடு	ʋ iː ɖ ʊ
வீட்டுக்காரி	ʋ iː ʈː ʊ kː aː ɾ ɪ
வீணை	ʋ iː ɳ ɐ ɪ̯
வீதி	ʋ iː d̪ ɪ
வீத்துமம்	ʋ iː t̪ː ʊ m ɐ m
வீரன்	ʋ iː ɾ ɐ n
வீரம்	ʋ iː ɾ ɐ m
வீராங்கனை	ʋ iː ɾ aː ŋ ɡ ɐ n ɐ ɪ̯
வீராசனம்	ʋ iː ɾ aː t͡ɕ ɐ n ɐ m
வெகுளி	ʋ ɛ ɡ ʊ ɭ ɪ
வெகுவசனம்	ʋ ɛ ɡ ʊ ʋ ɐ t͡ɕ ɐ n ɐ m
வெக்கை	ʋ ɛ kː ɐ ɪ̯
வெங்கடாசலபதி	ʋ ɛ ŋ ɡ ɐ ɖ aː t͡ɕ ɐ l ɐ b ɐ d̪ ɪ
வெங்கான்வெளி	ʋ ɛ ŋ ɡ aː n ʋ ɛ ɭ ɪ
வெங்காயம்	ʋ ɛ ŋ ɡ aː j ɐ m
வெடி	ʋ ɛ ɖ ɪ
வெடிமருந்து	ʋ ɛ ɖ ɪ m ɐ ɾ ʊ n̪ d̪ ʊ
வெடியம்	ʋ ɛ ɖ ɪ j ɐ m
வெட்கம்	ʋ ɛ ʈ k ɐ m
வெட்டு	ʋ ɛ ʈː ʊ
வெட்டுக்கிளி	ʋ ɛ ʈː ʊ kː ɪ ɭ ɪ
வெண்	ʋ ɛ ɳ
வெண்கண்டல்	ʋ ɛ ɳ ɡ ɐ ɳ ɖ ɐ l
வெண்கலம்	ʋ ɛ ɳ ɡ ɐ l ɐ m
வெண்டை	ʋ ɛ ɳ ɖ ɐ ɪ̯
வெண்டைக்காய்	ʋ ɛ ɳ ɖ ɐ ɪ̯ kː aː j
வெண்ணெய்	ʋ ɛ ɳː ɛ j
வெண்ணெய்தல்	ʋ ɛ ɳː ɛ j d̪ ɐ l
வெண்பா	ʋ ɛ ɳ b aː
வெண்மை	ʋ ɛ ɳ m ɐ ɪ̯
வெந்தயம்	ʋ ɛ n̪ d̪ ɐ j ɐ m
வெந்நீர்	ʋ ɛ n̪ː iː ɾ
வெப்பநிலை	ʋ ɛ pː ɐ n̪ ɪ l ɐ ɪ̯
வெப்பம்	ʋ ɛ pː ɐ m
வெப்புள்	ʋ ɛ pː ʊ ɭ
வெம்பகல்	ʋ ɛ m b ɐ ɡ ɐ l
வெம்மணல்	ʋ ɛ mː ɐ ɳ ɐ l
வெயில்	ʋ ɛ j ɪ l
வெய்யோன்	ʋ ɛ jː oː n
வெருகு	ʋ ɛ ɾ ʊ ɡ ʊ
வெறி	ʋ ɛ r ɪ
வெறிது	ʋ ɛ r ɪ d̪ ʊ
வெறிப்பு	ʋ ɛ r ɪ pː ʊ
வெறு	ʋ ɛ r ʊ
வெறுங்காய்	ʋ ɛ r ʊ ŋ ɡ aː j
வெறுப்பு	ʋ ɛ r ʊ pː ʊ
வெறுமை	ʋ ɛ r ʊ m ɐ ɪ̯
வெறும்	ʋ ɛ r ʊ m
வெற்றி	ʋ ɛ rː ɪ
வெற்றிலை	ʋ ɛ rː ɪ l ɐ ɪ̯
வெல்	ʋ ɛ l
வெல்லம்	ʋ ɛ l l ɐ m
வெளி	ʋ ɛ ɭ ɪ
வெளிச்சம்	ʋ ɛ ɭ ɪ t͡ɕː ɐ m
வெளிப்படு	ʋ ɛ ɭ ɪ pː ɐ ɖ ʊ
வெளிப்படுத்து	ʋ ɛ ɭ ɪ pː ɐ ɖ ʊ t̪ː ʊ
வெளிமான்	ʋ ɛ ɭ ɪ m aː n
வெளியீடு	ʋ ɛ ɭ ɪ j iː ɖ ʊ
வெள்	ʋ ɛ ɭ
வெள்ளக்காடு	ʋ ɛ ɭː ɐ kː aː ɖ ʊ
வெள்ளக்கால்	ʋ ɛ ɭː ɐ kː aː l
வெள்ளந்தி	ʋ ɛ ɭː ɐ n̪ d̪ ɪ
வெள்ளம்	ʋ ɛ ɭː ɐ m
வெள்ளரா	ʋ ɛ ɭː ɐ ɾ aː
வெள்ளரி	ʋ ɛ ɭː ɐ ɾ ɪ
வெள்ளாடு	ʋ ɛ ɭː aː ɖ ʊ
வெள்ளி	ʋ ɛ ɭː ɪ
வெள்ளிக்கிழமை	ʋ ɛ ɭː ɪ kː ɪ ɻ ɐ m ɐ ɪ̯
வெள்ளுள்ளி	ʋ ɛ ɭː ʊ ɭː ɪ
வெள்ளெழுத்து	ʋ ɛ ɭː ɛ ɻ ʊ t̪ː ʊ
வெள்ளைச்செவ்வந்தி	ʋ ɛ ɭː ɐ ɪ̯ t͡ɕː ɛ ʋː ɐ n̪ d̪ ɪ
வெள்ளைப்பட்டாணி	ʋ ɛ ɭː ɐ ɪ̯ pː ɐ ʈː aː ɳ ɪ
வெள்ளைப்பூலாஞ்சி	ʋ ɛ ɭː ɐ ɪ̯ pː uː l aː ɲ d͡ʑ ɪ
வெள்ளைப்போளம்	ʋ ɛ ɭː ɐ ɪ̯ pː oː ɭ ɐ m
வெள்ளைமூங்கில்	ʋ ɛ ɭː ɐ ɪ̯ m uː ŋ ɡ ɪ l
வெள்வேல்	ʋ ɛ ɭ ʋ eː l
வேகம்	ʋ eː ɡ ɐ m
வேங்கடம்	ʋ eː ŋ ɡ ɐ ɖ ɐ m
வேங்கை	ʋ eː ŋ ɡ ɐ ɪ̯
வேசி	ʋ eː t͡ɕ ɪ
வேசியை	ʋ eː t͡ɕ ɪ j ɐ ɪ̯
வேடன்	ʋ eː ɖ ɐ n
வேடன்	ʋ ɪ̃ː ɖ ɐ n
வேட்டி	ʋ eː ʈː ɪ
வேட்டை	ʋ eː ʈː ɐ ɪ̯
வேட்டையாடு	ʋ eː ʈː ɐ ɪ̯ j aː ɖ ʊ
வேண்டி	ʋ eː ɳ ɖ ɪ
வேண்டிய	ʋ eː ɳ ɖ ɪ j ɐ
வேண்டியமட்டும்	ʋ eː ɳ ɖ ɪ j ɐ m ɐ ʈː ʊ m
வேண்டியவன்	ʋ eː ɳ ɖ ɪ j ɐ ʋ ɐ n
வேண்டு	ʋ eː ɳ ɖ ʊ
வேண்டுகோள்	ʋ eː ɳ ɖ ʊ ɡ oː ɭ
வேதனை	ʋ eː d̪ ɐ n ɐ ɪ̯
வேதனைகள்	ʋ eː d̪ ɐ n ɐ ɪ̯ ɡ ɐ ɭ
வேதம்	ʋ eː d̪ ɐ m
வேதவியல்	ʋ eː d̪ ɐ ʋ ɪ j ɐ l
வேதாகமம்	ʋ eː d̪ aː ɡ ɐ m ɐ m
வேதி	ʋ eː d̪ ɪ
வேதியியல்	ʋ eː d̪ ɪ j ɪ j ɐ l
வேந்தன்	ʋ eː n̪ d̪ ɐ n
வேனில்	ʋ eː n ɪ l
வேப்பமரம்	ʋ eː pː ɐ m ɐ ɾ ɐ m
வேம்பு	ʋ eː m b ʊ
வேய்	ʋ eː j
வேர்	ʋ eː ɾ
வேர்வை	ʋ eː ɾ ʋ ɐ ɪ̯
வேறு	ʋ eː r ʊ
வேறுபாடு	ʋ eː r ʊ b aː ɖ ʊ
வேற்றுகிரகவாசி	ʋ eː rː ʊ ɡ ɪ ɾ ɐ ɡ ɐ ʋ aː t͡ɕ ɪ
வேற்றுமை	ʋ eː rː ʊ m ɐ ɪ̯
வேலி	ʋ eː l ɪ
வேலூர்	ʋ eː l uː ɾ
வேலை	ʋ eː l ɐ ɪ̯
வேலைக்காரன்	ʋ eː l ɐ ɪ̯ kː aː ɾ ɐ n
வேலைக்காரி	ʋ eː l ɐ ɪ̯ kː aː ɾ ɪ
வேலைக்கூலி	ʋ eː l ɐ ɪ̯ kː uː l ɪ
வேலைநாணயம்	ʋ eː l ɐ ɪ̯ n̪ aː ɳ ɐ j ɐ m
வேலைநேரம்	ʋ eː l ɐ ɪ̯ n̪ eː ɾ ɐ m
வேலைமினக்கெட்டவன்	ʋ eː l ɐ ɪ̯ m ɪ n ɐ kː ɛ ʈː ɐ ʋ ɐ n
வேலையாள்	ʋ eː l ɐ ɪ̯ j aː ɭ
வேலைவளர்	ʋ eː l ɐ ɪ̯ ʋ ɐ ɭ ɐ ɾ
வேலைவாங்கு	ʋ eː l ɐ ɪ̯ ʋ aː ŋ ɡ ʊ
வேளாட்டி	ʋ eː ɭ aː ʈː ɪ
வேளாண்மை	ʋ eː ɭ aː ɳ m ɐ ɪ̯
வேளாளர்	ʋ eː ɭ aː ɭ ɐ ɾ
வேளை	ʋ eː ɭ ɐ ɪ̯
வேள்	ʋ eː ɭ
வேள்வி	ʋ eː ɭ ʋ ɪ
வை	ʋ ɐ ɪ̯
வைகாசி	ʋ ɐ ɪ̯ ɡ aː t͡ɕ ɪ
வைசிகன்	ʋ ɐ ɪ̯ t͡ɕ ɪ ɡ ɐ n
வைடூரியம்	ʋ ɐ ɪ̯ ɖ uː ɾ ɪ j ɐ m
வைணவன்	ʋ ɐ ɪ̯ ɳ ɐ ʋ ɐ n
வைணவம்	ʋ ɐ ɪ̯ ɳ ɐ ʋ ɐ m
வைணவி	ʋ ɐ ɪ̯ ɳ ɐ ʋ ɪ
வைத்திரு	ʋ ɐ ɪ̯ t̪ː ɪ ɾ ʊ
வைத்துக்கொள்	ʋ ɐ ɪ̯ t̪ː ʊ kː ɔ ɭ
வைபவம்	ʋ ɐ ɪ̯ b ɐ ʋ ɐ m
வைப்பு	ʋ ɐ ɪ̯ pː ʊ
வையகம்	ʋ ɐ ɪ̯ j ɐ ɡ ɐ m
வையை	ʋ ɐ ɪ̯ j ɐ ɪ̯
வைரம்	ʋ ɐ ɪ̯ ɾ ɐ m
வைவு	ʋ ɐ ɪ̯ ʋ ʊ
வைஷ்ணவம்	ʋ ɐ ɪ̯ ʂ ɳ ɐ ʋ ɐ m
வௌவால்	ʋ ɐ ʊ̯ ʋ aː l
வௌவால்கள்	ʋ ɐ ʊ̯ ʋ aː l ɡ ɐ ɭ
வ்	i ʋ
வ்	i ʋː ɯ
வ்	ʋ
ஶ	ɕ ɐ
ஶல்யம்	ɕ ɐ l j ɐ m
ஶஸ்யம்	ɕ ɐ s j ɐ m
ஶாபம்	ɕ aː b ɐ m
ஶ்	ɕ
ஶ்ரீ	ɕ ɾ iː
ஶ்ரீகாகுளம்	s ɾ iː k aː k u ɭ ɐ m
ஶ்வஶ்ரூ	ɕ ʋ ɐ ɕ ɾ uː
ஷ	ʂ ɐ
ஷ்	ʂ
ஸ	s ɐ
ஸங்கிரஹம்	s ɐ ŋ ɡ ɪ ɾ ɐ h ɐ m
ஸாயகம்	s aː j ɐ ɡ ɐ m
ஸாரட்டு	s aː ɾ ɐ ʈː ʊ
ஸார்த்தகம்	s aː ɾ t̪ː ɐ ɡ ɐ m
ஸாலியானா	s aː l ɪ j aː n aː
ஸாவகாம்	s aː ʋ ɐ ɡ aː m
ஸாஹசர்யம்	s aː h ɐ t͡ɕ ɐ ɾ j ɐ m
ஸாஹுகார்	s aː h ʊ ɡ aː ɾ
ஸீமை	s iː m ɐ ɪ̯
ஸ்	s
ஸ்தலம்	s t̪ ɐ l ɐ m
ஸ்தாபனம்	s t̪ aː b ɐ n ɐ m
ஸ்தாயி	s t̪ aː j ɪ
ஸ்துதி	s t̪ ʊ d̪ ɪ
ஸ்தோத்திரங்கள்	s t̪ oː t̪ː ɪ ɾ ɐ ŋ ɡ ɐ ɭ
ஸ்தோத்திரம்	s t̪ oː t̪ː ɪ ɾ ɐ m
ஸ்த்ரீ	s t̪ ɾ iː
ஸ்நானம்	s n̪ aː n ɐ m
ஸ்பஷ்டம்	s p ɐ ʂ ʈ ɐ m
ஸ்வரம்	s ʋ ɐ ɾ ɐ m
ஸ்வர்ணம்	s ʋ ɐ ɾ ɳ ɐ m
ஸ்வேதம்	s ʋ eː d̪ ɐ m
ஹ	h ɐ
ஹக்காசியா	h ɐ kː aː t͡ɕ ɪ j aː
ஹம்ஸம்	h ɐ m s ɐ m
ஹயக்ரீவன்	h ɐ j ɐ k ɾ iː ʋ ɐ n
ஹரிஜனம்	h ɐ ɾ ɪ d͡ʑ ɐ n ɐ m
ஹாஜ்	h aː d͡ʑ
ஹிஜிரி	h ɪ d͡ʑ ɪ ɾ ɪ
ஹிந்தி	h ɪ n̪ d̪ ɪ
ஹைதராபாத்	h ɐ ɪ̯ d̪ ɐ ɾ aː b aː t̪
ஹொங்கொங்	h ɔ ŋ ɡ ɔ ŋ
ஹ்	h
ஹ்ரஸ்வம்	h ɾ ɐ s ʋ ɐ m
ா	a
ி	i
ீ	iː
ு	u
ூ	uː
ெ	e
ே	eː
ை	a i
ொ	o
ோ	oː
ௌ	a ʊ̯
ௐ	oː m
ௗ	a ʊ̯
