Jõgõperä	ʝ ɤ ɡ ɤ p e r æ
Kabrio	k ɑ b r i o̯
Krissuz	k r i sː u z
Liivtšülä	l iː v t͡ʃ y l æ
Luutsa	l uː t͡s ɑ
Petteri	p e tː e r i
aa	ɑː
aadu	ɑː d u
aapõ	ɑː p ɑ
adrõ	ɑ d r ɑ
aftobussõ	ɑ f t o b u sː ɑ
ahavõ	ɑ h ɑ v ɑ
ahaz	ɑ h ɑ z
ahilõ	ɑ h i l ɑ
ahjo	ɑ h ʝ o
ahjopäälüz	ɑ h ʝ o p æː l y z
ahkõrõ	ɑ h k ɤ r ɑ
ahnõ	ɑ h n ɤ
ahnõz	ɑ h n ɑ z
aho	ɑ h o
ahta	ɑ h t ɑː
ahvõkko	ɑ h v ɑ kː o
ahvõn	ɑ h v ɤ n
aikõ	ɑ i̯ k ɤ
ain	ɑ i̯ n
aintaki	ɑ i̯ n t ɑ k i
airo	ɑ i̯ r o
aisõ	ɑ i̯ s ɑ
aitõ	ɑ i̯ t ɑ
aivo	ɑ i̯ v oː
aivõsõllõ	ɑ i̯ v ɑ s ɤ lː ɑ
aivõz	ɑ i̯ v ɑ z
ajja	ɑ ʝ ɑː
akanõ	ɑ k ɑ n ɑ
akkunaluz	ɑ kː u n ɑ l u z
akkunõ	ɑ kː u n ɑ
akkõ	ɑ kː ɑ
alassi	ɑ l ɑ sː i
alattu	ɑ l ɑ tː u
alaz	ɑ l ɑ z
alka	ɑ l k ɑː
alko	ɑ l k o
alku	ɑ l k u
alkua	ɑ l k u ɑ̯
alla	ɑ l ɑː
allõ	ɑ lː ɑ
altõ	ɑ l t ɑ
alukõrtõ	ɑ l u k ɤ r t ɑ
aluz	ɑ l u z
alõn	ɑ l ɤ n
ammua	ɑ mː u ɑ̯
ammõz	ɑ mː ɑ z
ampua	ɑ m p u ɑ̯
angeli	ɑ ŋ ɡ e l i
angõrjõz	ɑ ŋ ɡ ɤ r ʝ ɑ z
anko	ɑ ŋ k o
anta	ɑ n t ɑː
antõssi	ɑ n t ɤː sː i
anõ	ɑ n ɤ
apajõ	ɑ p ɑ ʝ ɑ
apatõ	ɑ p ɑ t ɑ
api	ɑ p i
apreli	ɑ p r e l i
aragõ	ɑ r ɑ ɡ ɑ
arinõ	ɑ r i n ɑ
arjõ	ɑ r ʝ ɑ
arkõ	ɑ r k ɑ
armo	ɑ r m o
armõz	ɑ r m ɑ z
arpõ	ɑ r p ɑ
artši	ɑ r t͡ʃ i
artšipäive	ɑ r t͡ʃ i p æ i̯ v æ
arva	ɑ r v ɑː
arvo	ɑ r v o
arvotuz	ɑ r v o t u z
arvõ	ɑ r v ɑ
arvõtõ	ɑ r v ɑ t ɑ
assua	ɑ sː u ɑ̯
astia	ɑ s t i ɑ̯
astijõ	ɑ s t i ʝ ɤ
astjõ	ɑ s t ʝ ɑ
augusti	ɑ u̯ ɡ u s t i
aukko	ɑ u̯ kː o
autõ	ɑ u̯ t ɑ
autši	ɑ u̯ t͡ʃ i
avahtuussõ	ɑ v ɑ h t uː sː ɑ
avanto	ɑ v ɑ n t o
avatõ	ɑ v ɑ t ɑ
avitta	ɑ v i tː ɑː
avvautõ	ɑ v ɑ u̯ t ɑ
avõ	ɑ v ɤ
baabukõz	b ɑː b u k ɑ z
baabuškõ	b ɑː b u ʃ k ɑ
borkkõnõ	b o r kː ɑ n ɑ
botškõ	b o t͡ʃ k ɑ
bratko	b r ɑ t k o
bruudõ	b r uː d ɑ
bugrõ	b u ɡ r ɑ
butkõ	b u t k ɑ
bõllu	b ɤ lː u
bõõ	b ɤː
dohtõri	d o h t ɑ r i
dolottõ	d o l o tː ɑ
doro	d o r o
duumõtõ	d uː m ɑ t ɑ
eb	e b
eestä	eː s t æː
eez	eː z
egle	e ɡ l eː
eglin	e ɡ l i n
ei	e i̯
eine	e i̯ n æ
einemaa	e i̯ n æ m ɑː
elisse	e l i sː æ
elliä	e l i æ̯
ellä	e l æː
elmi	e l m i
elo	e l o
eloz	e l o z
eläje	e l æ ʝ æ
eläme	e l æ m æ
elää	e l æː
emintimä	e m i n t i m æ
emä	e m æ
emänte	e m æ n t æ
enipäive	e n i p æ i̯ v æ
enne	e nː e
enne	e nː eː
ennegle	e nː e ɡ l eː
ennepi	e nː e p iː
ennä	e n æː
entin	e n t i n
entši	e n t͡ʃ i
entšisse	e n t͡ʃ iː sː æ
enäpi	e n æ p i
erne	e r n e
esijalkõ	e s i ʝ ɑ l k ɑ
esimein	e s i m e i̯ n
esimespäive	e s i m e s p æ i̯ v æ
etele	e t e l æ
etez	e t e z
ette	e t eː
ette	e tː æ
etti	e tː i
ettsiä	e t͡sː i æ̯
eväz	e v æ z
fevrali	f e v r ɑ l i
frovvõ	f r o vː ɑ
fökle	f ø k l æ
gaadõ	ɡ ɑː d ɑ
garmoni	ɡ ɑ r m o n i
gitari	ɡ i t ɑ r i
glaizõ	ɡ l ɑ i̯ z ɑ
grammõ	ɡ r ɑ mː ɑ
gruušõ	ɡ r uː ʃ ɑ
haakki	h ɑː kː i
haili	h ɑ i̯ l i
haisoa	h ɑ i̯ s o ɑ̯
harakkõ	h ɑ r ɑ kː ɑ
harjokkõ	h ɑ r ʝ o kː ɑ
harma	h ɑ r m ɑː
hattu	h ɑ tː u
haukkua	h ɑ u̯ kː u ɑ̯
haukkõ	h ɑ u̯ kː ɑ
heeno	h eː n o
heittä	h e i̯ tː æː
heitüttä	h e i̯ t y tː æː
helle	h e lː æ
herkkõ	h e r kː ɑ
herttõ	h e r tː ɑ
hiki	h i k i
hiutta	h i u̯ tː ɑː
hoikkõ	h o i̯ kː ɑ
hoogõtõ	h oː ɡ ɑ t ɑ
hooli	h oː l i
hoolia	h oː l i ɑ̯
hoono	h oː n o
hoonopooli	h oː n o p oː l i
hoovõtõ	h oː v ɑ t ɑ
hullu	h u lː u
hämmentä	h æ mː e n t æː
hämäre	h æ m æ r æ
hämöläin	h æ m ø l æ i̯ n
hätä	h æ t æ
häülüä	h æ y̯ l y æ̯
höröläin	h ø r ø l æ i̯ n
hülgete	h y l ɡ æ t æ
hüpäte	h y p æ t æ
hüü	h yː
hüüpiäz	h yː p i æ̯ z
iha	i h ɑ
ihan	i h ɑ n
iho	i h o
iili	iː l i
iiri	iː r i
iivõ	iː v ɑ
ikolookkõ	i k o l oː kː ɑ
ilatõ	i l ɑ t ɑ
ilka	i l k ɑː
ilma	i l m ɑː
ilmaussõ	i l m ɑ u̯ sː ɑ
ilmõ	i l m ɑ
ilo	i l o
ilozuz	i l o z u z
ilozõ	i l o z ɑ
ilvez	i l v e z
ime	i m e
imeä	i m e æ̯
immiä	i m i æ̯
imo	i m o
inemin	i n e m iː n
inimin	i n i m iː n
inkerilain	i ŋ k e r i l ɑ i̯ n
intõ	i n t ɑ
irnua	i r n u ɑ̯
irsi	i r s i
irvi	i r v i
irvieine	i r v i e i̯ n æ
iso	i s o
issua	i sː u ɑ̯
issussõ	i sː uː sː ɑ
isutta	i s u tː ɑː
isä	i s æ
itikkõ	i t i kː ɑ
itku	i t k u
itkõa	i t k ɤ ɑ̯
itä	i t æ
itšee	i t͡ʃ eː
itši	i t͡ʃ i
itšin	i t͡ʃ i n
itšä	i t͡ʃ æ
itšäve	i t͡ʃ æ v æ
ivuz	i v u z
ize	i z e
izintimä	i z i n t i m æ
iäte	i æ̯ t æ
ižori	i ʒ o r i
ižori	i ʒ o r iː
ižorilain	i ʒ o r i l ɑ i̯ n
jaani	ʝ ɑː n i
jaanikukkõ	ʝ ɑː n i k u kː ɑ
jahtua	ʝ ɑ h t u ɑ̯
jakka	ʝ ɑ k ɑː
jako	ʝ ɑ k o
jalgõz	ʝ ɑ l ɡ ɑ z
jalkõ	ʝ ɑ l k ɑ
jalkõlapa	ʝ ɑ l k ɑ l ɑ p ɑ
jalkõzi	ʝ ɑ l k ɑ z iː
jano	ʝ ɑ n o
janvari	ʝ ɑ n v ɑ r i
jarvi	ʝ ɑ r v i
jatka	ʝ ɑ t k ɑː
javo	ʝ ɑ v o
javva	ʝ ɑ v ɑː
jo	ʝ o
joossõ	ʝ oː sː ɑ
joožikkõ	ʝ oː ʒ i kː ɑ
joršši	ʝ o r ʃː i
jotti	ʝ o tː i
julka	ʝ u l k ɑː
jumalõ	ʝ u m ɑ l ɑ
jumalõlintu	ʝ u m ɑ l ɑ l i n t u
jupkõ	ʝ u p k ɑ
jurmõ	ʝ u r m ɑ
juttu	ʝ u tː u
jutõllõ	ʝ u t ɤ lː ɑ
juuli	ʝ uː l i
juumõri	ʝ uː m ɑ r i
juuni	ʝ uː n i
juuri	ʝ uː r i
juutta	ʝ uː tː ɑː
juuttši	ʝ uː t͡ʃː i
juuvvõ	ʝ uː vː ɑ
jältši	ʝ æ l t͡ʃ i
jämmiä	ʝ æ m i æ̯
jänez	ʝ æ n e z
järestä	ʝ æ r e s t æː
järisse	ʝ æ r i sː æ
järtšü	ʝ æ r t͡ʃ y
järvi	ʝ æ r v i
jäsen	ʝ æ s e n
jätaži	ʝ æ t ɑ ʒ i
jättä	ʝ æ tː æː
jää	ʝ æː
jäättüä	ʝ æː tː y æ̯
jäävve	ʝ æː vː æ
jõka	ʝ ɤ k ɑ
jõki	ʝ ɤ k i
jõtši	ʝ ɤ t͡ʃ i
jõulu	ʝ ɤ u̯ l u
jõutu	ʝ ɤ u̯ t u
jõutua	ʝ ɤ u̯ t u ɑ̯
jõvi	ʝ ɤ v i
jõvikõz	ʝ ɤ v i k ɑ z
jürisse	ʝ y r i sː æ
jürkkü	ʝ y r kː y
jürü	ʝ y r y
kaa	k ɑː
kaakko	k ɑː kː o
kaalia	k ɑː l i ɑ̯
kaappi	k ɑː pː i
kaari	k ɑː r i
kaarta	k ɑː r t ɑː
kaaskõ	k ɑː s k ɑ
kaatsõd	k ɑː t͡s ɑ d
kaaz	k ɑː z
kabjõ	k ɑ b ʝ ɑ
kadgõtõ	k ɑ d ɡ ɑ t ɑ
kagluz	k ɑ ɡ l u z
kaglõ	k ɑ ɡ l ɑ
kagrõ	k ɑ ɡ r ɑ
kahs	k ɑ h s
kahsi	k ɑ h s i
kahsteiššümed	k ɑ h s t e i̯ ʃː y m e d
kahstõiššümed	k ɑ h s t ɤ i̯ ʃː y m e d
kahtši	k ɑ h t͡ʃ i
kahõsa	k ɑ h ɤ s ɑː
kahõsateiššümed	k ɑ h ɤ s ɑː t e i̯ ʃː y m e d
kahõsatõiššümed	k ɑ h ɤ s ɑː t ɤ i̯ ʃː y m e d
kaimõ	k ɑ i̯ m ɑ
kainõlo	k ɑ i̯ n ɑ l o
kaiva	k ɑ i̯ v ɑː
kaivo	k ɑ i̯ v o
kajagõ	k ɑ ʝ ɑ ɡ ɑ
kakku	k ɑ kː u
kala	k ɑ l ɑ
kalanikkõ	k ɑ l ɑ n i kː ɑ
kalliz	k ɑ lː i z
kallõz	k ɑ lː ɑ z
kalmo	k ɑ l m o
kalmõ	k ɑ l m ɑ
kamalikkõ	k ɑ m ɑ l i kː ɑ
kammittsõ	k ɑ mː i t͡sː ɑ
kampõlõ	k ɑ m p ɑ l ɑ
kamunistõ	k ɑ m u n i s t ɑ
kana	k ɑ n ɑ
kanamuna	k ɑ n ɑ m u n ɑ
kanavõ	k ɑ n ɑ v ɑ
kane	k ɑ n e
kaned	k ɑ n e d
kangõz	k ɑ ŋ ɡ ɑ z
kankia	k ɑ ŋ k i ɑ̯
kanni	k ɑ n iː
kannuz	k ɑ nː u z
kannõl	k ɑ nː ɤ l
kanta	k ɑ n t ɑː
kanto	k ɑ n t o
kantõ	k ɑ n t ɑ
kanõrvo	k ɑ n ɤ r v o
kapalod	k ɑ p ɑ l o d
kapussõ	k ɑ p u sː ɑ
kargõtõ	k ɑ r ɡ ɑ t ɑ
karjušši	k ɑ r ʝ u ʃː i
karjõ	k ɑ r ʝ ɑ
karjõmaa	k ɑ r ʝ ɑ m ɑː
karka	k ɑ r k ɑː
karkõa	k ɑ r k ɤ ɑ̯
karsia	k ɑ r s i ɑ̯
karsinõ	k ɑ r s i n ɑ
kartõ	k ɑ r t ɑ
karu	k ɑ r u
karvõ	k ɑ r v ɑ
kase	k ɑ s e
kassa	k ɑ sː ɑː
kasse	k ɑ sː eː
kassen	k ɑ sː e n
kasõ	k ɑ s ɤ
katagõ	k ɑ t ɑ ɡ ɑ
katkoa	k ɑ t k o ɑ̯
katta	k ɑ tː ɑː
katti	k ɑ tː i
kattilõ	k ɑ tː i l ɑ
katto	k ɑ tː o
kattsoa	k ɑ t͡sː o ɑ̯
katõ	k ɑ t ɤ
kauga	k ɑ u̯ ɡ ɑː
kauhtõnõ	k ɑ u̯ h t ɑ n ɑ
kaukallõ	k ɑ u̯ k ɑː lː ɑ
kaukalõ	k ɑ u̯ k ɑː l ɤː
kaukolo	k ɑ u̯ k o l o
kauniz	k ɑ u̯ n i z
kaussõ	k ɑ u̯ sː ɑ
kauttõ	k ɑ u̯ tː ɑ
kavalõ	k ɑ v ɑ l ɑ
kavi	k ɑ v i
kazittõ	k ɑ z i tː ɑ
kazva	k ɑ z v ɑː
kazvo	k ɑ z v o
kazvotta	k ɑ z v o tː ɑː
kazvõtta	k ɑ z v ɑ tː ɑː
kehatõ	k e h ɑ t ɑ
kehno	k e h n o
keittä	k e i̯ tː æː
keppi	k e pː i
kerkisse	k e r k iː sː æ
kerkiä	k e r k i æ̯
kerkiäin	k e r k i æ̯ i̯ n
kerttä	k e r tː æː
keräje	k e r æ ʝ æ
keräte	k e r æ t æ
keskolin	k e s k o l i n
kilogrammõ	k i l o ɡ r ɑ mː ɑ
kilometrõ	k i l o m e t r ɑ
kirpittsõ	k i r p i t͡sː ɑ
kirstu	k i r s t u
kittrõõbõ	k i tː r ɤː b ɑ
kittsi	k i t͡sː i
kiuru	k i u̯ r u
kiškõ	k i ʃ k ɑ
klazi	k l ɑ z i
koffi	k o fː i
kohinõ	k o h i n ɑ
kohotõ	k o h o t ɑ
koi	k o i̯
koinia	k o i̯ n i ɑ̯
koipõ	k o i̯ p ɑ
koirõ	k o i̯ r ɑ
koivu	k o i̯ v u
kojjossõ	k o ʝː oː sː ɑ
kokkõ	k o kː ɑ
koko	k o k o
kokutta	k o k u tː ɑː
kolissõ	k o l i sː ɑ
konnõ	k o nː ɑ
kookkõ	k oː kː ɑ
koollõ	k oː lː ɑ
koolõmõ	k oː l ɤ m ɑ
kooppõ	k oː pː ɑ
koori	k oː r i
kooria	k oː r i ɑ̯
koormõ	k oː r m ɑ
kopekkõ	k o p e kː ɑ
kopitta	k o p i tː ɑː
koppiussõ	k o pː i u̯ sː ɑ
korjõtõ	k o r ʝ ɑ t ɑ
kormunõ	k o r m u n ɑ
korria	k o r i ɑ̯
korrõa	k o r ɤ ɑ̯
kossia	k o s i ɑ̯
kotikko	k o t i kː o
kotko	k o t k o
koto	k o t o
koton	k o t o n
kototüü	k o t o t yː
kotti	k o tː i
koukku	k o u̯ kː u
koverõ	k o v e r ɑ
kraappia	k r ɑː pː i ɑ̯
kraaskõ	k r ɑː s k ɑ
kraazgõtõ	k r ɑː z ɡ ɑ t ɑ
kramppi	k r ɑ m pː i
krapu	k r ɑ p u
krottõ	k r o tː ɑ
ku	k u
kuha	k u h ɑ
kuhhõ	k u h ɤː
kuhjõ	k u h ʝ ɑ
kuhõ	k u h ɤ
kui	k u i̯
kuilõz	k u i̯ l ɑ z
kuiva	k u i̯ v ɑː
kuivõ	k u i̯ v ɑ
kuivõtta	k u i̯ v ɑ tː ɑː
kuja	k u ʝ ɑ
kukittsa	k u k i t͡sː ɑː
kukko	k u kː o
kukkua	k u kː u ɑ̯
kukkõ	k u kː ɤ
kukuruza	k u k u r u z ɑ
kukšinõ	k u k ʃ i n ɑ
kulkõa	k u l k ɤ ɑ̯
kullua	k u l u ɑ̯
kulmõ	k u l m ɑ
kulo	k u l o
kultain	k u l t ɑ i̯ n
kultõ	k u l t ɑ
kummitõllõ	k u mː i t ɤ lː ɑ
kummõ	k u mː ɑ
kumpõ	k u m p ɑ
kunikõz	k u n i k ɑ z
kuniz	k u n i z
kunnia	k u nː i ɑ̯
kupo	k u p o
kuraz	k u r ɑ z
kurikkõ	k u r i kː ɑ
kurissa	k u r i sː ɑː
kurjõ	k u r ʝ ɑ
kurkku	k u r kː u
kurnõtõ	k u r n ɑ t ɑ
kurra	k u rː ɑː
kursi	k u r s i
kurtši	k u r t͡ʃ i
kurõa	k u r ɤ ɑ̯
kusi	k u s i
kusirakko	k u s i r ɑ kː o
kussua	k u sː u ɑ̯
kussõ	k u sː ɑ
kuttoa	k u t o ɑ̯
kuttsua	k u t͡sː u ɑ̯
kutu	k u t u
kuu	k uː
kuullõ	k uː lː ɑ
kuulua	k uː l u ɑ̯
kuumõ	k uː m ɑ
kuunõllõ	k uː n ɤ lː ɑ
kuus	k uː s
kuusi	k uː s i
kuusteiššümed	k uː s t e i̯ ʃː y m e d
kuustõiššümed	k uː s t ɤ i̯ ʃː y m e d
kuva	k u v ɑ
kuza	k u z ɑ
kuzale	k u z ɑ l eː
kuzza	k u z ɑː
kuõ	k u ɤ̯
kõhtõ	k ɤ h t ɑ
kõig	k ɤ i̯ ɡ
kõikkina	k ɤ i̯ kː i n ɑː
kõikõlain	k ɤ i̯ k ɤ l ɑ i̯ n
kõlmõd	k ɤ l m ɤ d
kõlmõdteiššümed	k ɤ l m ɤ d t e i̯ ʃː y m e d
kõlmõdtõiššümed	k ɤ l m ɤ d t ɤ i̯ ʃː y m e d
kõlmõtteiššümed	k ɤ l m ɤ d t e i̯ ʃː y m e d
kõlmõttõiššümed	k ɤ l m ɤ d t ɤ i̯ ʃː y m e d
kõlmõz	k ɤ l m ɑ z
kõlmõzpäive	k ɤ l m ɑ z p æ i̯ v æ
kõltain	k ɤ l t ɑ i̯ n
kõltõ	k ɤ l t ɑ
kõlvõtõ	k ɤ l v ɑ t ɑ
kõnsa	k ɤ n s ɑː
kõnsaid	k ɤ n s ɑ i̯ d
kõnz	k ɤ n z
kõnzle	k ɤ n z l eː
kõrjõtõ	k ɤ r ʝ ɑ t ɑ
kõrka	k ɤ r k ɑː
kõrkuz	k ɤ r k uː z
kõrkõa	k ɤ r k ɤ ɑ̯
kõrkõuz	k ɤ r k ɤ u̯ z
kõrsi	k ɤ r s i
kõrtõ	k ɤ r t ɑ
kõrvõ	k ɤ r v ɑ
kõta	k ɤ t ɑ
kõtarõ	k ɤ t ɑ r ɑ
kõva	k ɤ v ɑ
kõvassi	k ɤ v ɑ sː i
köökki	k øː kː i
köühe	k ø y̯ h æ
küll	k y lː
la	l ɑ
laadia	l ɑː d i ɑ̯
laatko	l ɑː t k o
laatkõ	l ɑː t k ɑ
ladvõ	l ɑ d v ɑ
lafkõ	l ɑ f k ɑ
laha	l ɑ h ɑ
lahjõ	l ɑ h ʝ ɑ
lahnõ	l ɑ h n ɑ
laho	l ɑ h o
lahsi	l ɑ h s i
lahti	l ɑ h t i
laihõ	l ɑ i̯ h ɑ
lainõ	l ɑ i̯ n ɤ
laiskuz	l ɑ i̯ s k u z
laiskõ	l ɑ i̯ s k ɑ
laitta	l ɑ i̯ tː ɑː
laivõ	l ɑ i̯ v ɑ
lakka	l ɑ k ɑː
lakõa	l ɑ k ɤ ɑ̯
lammõz	l ɑ mː ɑ z
lamppi	l ɑ m pː i
langõtõ	l ɑ ŋ ɡ ɤ t ɑ
lanttu	l ɑ n tː u
lapa	l ɑ p ɑ
lappia	l ɑ p i ɑ̯
lasku	l ɑ s k u
laskõa	l ɑ s k ɤ ɑ̯
lassu	l ɑ sː u
latši	l ɑ t͡ʃ i
laukopäive	l ɑ u̯ k o p æ i̯ v æ
laula	l ɑ u̯ l ɑː
lauloa	l ɑ u̯ l o ɑ̯
laulu	l ɑ u̯ l u
laulõjõ	l ɑ u̯ l ɑ ʝ ɑ
lauto	l ɑ u̯ t oː
lauttõ	l ɑ u̯ tː ɑ
lautõ	l ɑ u̯ t ɑ
leemi	l eː m i
leeminõ	l eː m i n ɑ
leevve	l eː vː æ
lehme	l e h m æ
lehti	l e h t i
lehto	l e h t o
lehtši	l e h t͡ʃ i
leikõtõ	l e i̯ k ɑ t ɑ
leipe	l e i̯ p æ
lennete	l e nː æ t æ
lentä	l e n t æː
leppe	l e pː æ
leütä	l e y̯ t æː
ležiä	l e ʒ i æ̯
liblõ	l i b l ɑ
lidnõ	l i d n ɑ
liha	l i h ɑ
lihakõz	l i h ɑ k ɤ z
lihavõ	l i h ɑ v ɑ
liika	l iː k ɑː
liikkua	l iː kː u ɑ̯
liikõ	l iː k ɑ
liittsõ	l iː t͡sː ɑ
liivõ	l iː v ɑ
likkossõ	l i k oː sː ɑ
lima	l i m ɑ
limoni	l i m o n i
lina	l i n ɑ
linnõ	l i nː ɑ
linttõ	l i n tː ɑ
lintu	l i n t u
lippia	l i p i ɑ̯
lippiä	l i p i æ̯
lippu	l i pː u
litrõ	l i t r ɑ
litši	l i t͡ʃ i
lizäte	l i z æ t æ
loba	l o b ɑ
lookkõ	l oː kː ɑ
looko	l oː k o
looto	l oː t o
lootõ	l oː t ɑ
loovvõ	l oː vː ɤ
loppua	l o pː u ɑ̯
luhtõ	l u h t ɑ
luikko	l u i̯ kː o
luikõtõ	l u i̯ k ɑ t ɑ
lukku	l u kː u
lukkuz	l u kː u z
lukkõa	l u k ɤ ɑ̯
luku	l u k u
lukõa	l u k ɤ ɑ̯
lumi	l u m i
lummõtõ	l u mː ɑ t ɑ
lunassa	l u n ɑ sː ɑː
lupa	l u p ɑ
lurjuz	l u r ʝ u z
lusti	l u s t i
lutissa	l u t i sː ɑː
luu	l uː
luukkõ	l uː kː ɑ
luuvvõ	l uː vː ɤ
luvatõ	l u v ɑ t ɑ
luzikkõ	l u z i kː ɑ
lägäte	l æ ɡ æ t æ
lähe	l æ h e
lähevesi	l æ h e v e s i
lähteä	l æ h t e æ̯
lämmi	l æ mː iː
lämmittä	l æ mː i tː æː
lämpisse	l æ m p iː sː æ
länsi	l æ n s i
läntü	l æ n t y
läpi	l æ p i
läsive	l æ s i v æ
lässiä	l æ s i æ̯
läsü	l æ s y
lätikko	l æ t i kː o
lõhgõtõ	l ɤ h ɡ ɑ t ɑ
lõhi	l ɤ h i
lõhkoa	l ɤ h k o ɑ̯
lõikõtõ	l ɤ i̯ k ɑ t ɑ
lõimõd	l ɤ i̯ m ɤ d
lõnkõ	l ɤ ŋ k ɑ
lõppu	l ɤ pː u
lõppua	l ɤ pː u ɑ̯
lõpõtta	l ɤ p ɤ tː ɑː
lõukõ	l ɤ u̯ k ɑ
lõunõd	l ɤ u̯ n ɑ d
lõunõttaassõ	l ɤ u̯ n ɑ tː ɑː sː ɑ
lõõkku	l ɤː kː u
lõõkkua	l ɤː kː u ɑ̯
lõõkõ	l ɤː k ɑ
lõõttsu	l ɤː t͡sː u
löülü	l ø y̯ l y
lühsä	l y h s æː
lühüd	l y h y d
lülü	l y l y
lüsi	l y s i
lütšäte	l y t͡ʃ æ t æ
lüüvve	l yː vː æ
maa	m ɑː
maailmõ	m ɑː i l m ɑ
maakangõz	m ɑː k ɑ ŋ ɡ ɑ z
maamuna	m ɑː m u n ɑ
maamõ	m ɑː m ɑ
magatõ	m ɑ ɡ ɑ t ɑ
magjõz	m ɑ ɡ ʝ ɑ z
mahlõ	m ɑ h l ɑ
maho	m ɑ h o
mahsa	m ɑ h s ɑː
mahsõ	m ɑ h s ɑ
mai	m ɑ i̯
maja	m ɑ ʝ ɑ
makkia	m ɑ k i ɑ̯
mako	m ɑ k o
maku	m ɑ k u
makuzõ	m ɑ k u z ɑ
makõa	m ɑ k ɤ ɑ̯
mandolina	m ɑ n d o l i n ɑ
mandõri	m ɑ n d ɤ r i
manitta	m ɑ n i tː ɑː
mansikõz	m ɑ n s i k ɑ z
marjõ	m ɑ r ʝ ɑ
martti	m ɑ r tː i
matalõ	m ɑ t ɑ l ɑ
matkõ	m ɑ t k ɑ
mato	m ɑ t o
matokkain	m ɑ t o kː ɑ i̯ n
matškõ	m ɑ t͡ʃ k ɑ
maõ	m ɑ ɤ̯
mašinõ	m ɑ ʃ i n ɑ
meeleto	m eː l e t oː
meeli	m eː l i
meez	m eː z
menne	m e nː æ
meno	m e n o
meri	m e r i
mesi	m e s i
mesimarjõ	m e s i m ɑ r ʝ ɑ
metrõ	m e t r ɑ
mettse	m e t͡sː æ
mettsekana	m e t͡sː æ k ɑ n ɑ
mettsekittsi	m e t͡sː æ k i t͡sː i
mettsesika	m e t͡sː æ s i k ɑ
mettso	m e t͡sː o
mikkä	m i k æː
mikä	m i k æ
mikäle	m i k æ l eː
milläin	m i lː æ i̯ n
miltin	m i l t i n
minutti	m i n u tː i
missi	m i sː i
mittä	m i t æː
mittõ	m i tː ɑ
miä	m i æ̯
mokomain	m o k o m ɑ i̯ n
mokomõ	m o k o m ɑ
mozgid	m o z ɡ i d
muhku	m u h k u
muilõ	m u i̯ l ɑ
muitõz	m u i̯ t ɤ z
mukka	m u k ɑː
mullikkõ	m u lː i kː ɑ
multõ	m u l t ɑ
muna	m u n ɑ
munavõi	m u n ɑ v ɤ i̯
munnia	m u n i ɑ̯
muragõz	m u r ɑ ɡ ɑ z
murhõ	m u r h ɤ
murria	m u r i ɑ̯
murta	m u r t ɑː
murtšinõ	m u r t͡ʃ i n ɑ
muru	m u r u
murõtta	m u r ɤ tː ɑː
musikõz	m u s i k ɑ z
mussõ	m u sː ɑ
mussõmarjõ	m u sː ɑ m ɑ r ʝ ɑ
muta	m u t ɑ
mutkõ	m u t k ɑ
mutukõz	m u t u k ɑ z
muu	m uː
muudrõ	m uː d r ɑ
muutta	m uː tː ɑː
muuttua	m uː tː u ɑ̯
mähtše	m æ h t͡ʃ æ
mähä	m æ h æ
mälehtä	m æ l e h t æː
mänte	m æ n t æ
mäntšiä	m æ n t͡ʃ i æ̯
märehtiä	m æ r e h t i æ̯
märtše	m æ r t͡ʃ æ
märännü	m æ r æ nː y
mättisse	m æ tː iː sː æ
mätä	m æ t æ
mätäz	m æ t æ z
mätši	m æ t͡ʃ i
mätšikkõ	m æ t͡ʃ i kː ɑ
määkkiä	m æː kː i æ̯
mõisõ	m ɤ i̯ s ɑ
mõla	m ɤ l ɑ
mõlõpõd	m ɤ l ɤ p ɑ d
mõni	m ɤ n i
mõrtõ	m ɤ r t ɑ
mõõkkõ	m ɤː kː ɑ
mõõttu	m ɤː tː u
mörnete	m ø r n æ t æ
mörnä	m ø r n æː
möö	m øː
mügre	m y ɡ r æ
müllü	m y lː y
müttše	m y t͡ʃː æ
müü	m yː
müühe	m yː h æ
müühep	m yː h e p
müühessüä	m yː h æ sː y æ̯
müühä	m yː h æː
müüje	m yː ʝ æ
müükkiä	m yː kː i æ̯
müütä	m yː t æː
müüvve	m yː vː æ
naapuri	n ɑː p u r i
naglõ	n ɑ ɡ l ɑ
nagra	n ɑ ɡ r ɑː
nagriz	n ɑ ɡ r i z
nagrutta	n ɑ ɡ r u tː ɑː
nahkõ	n ɑ h k ɑ
naijjõ	n ɑ ɟː ɑ
nain	n ɑ i̯ n
naitta	n ɑ i̯ tː ɑː
naizikko	n ɑ i̯ z i kː o
napukkõ	n ɑ p u kː ɑ
narria	n ɑ rː i ɑ̯
nato	n ɑ t o
ne	n e
ned	n e d
nee	n eː
need	n eː d
neemi	n eː m i
nenä	n e n æ
nepsiä	n e p s i æ̯
niglõ	n i ɡ l ɑ
nii	n iː
niini	n iː n i
niisi	n iː s i
niiskõ	n iː s k ɑ
niittä	n iː tː æː
niittü	n iː tː y
niku	n i k u
nimi	n i m i
niskõ	n i s k ɑ
nisu	n i s u
no	n o
nojäbri	n o ʝ æ b r i
nokkia	n o kː i ɑ̯
nokkõ	n o kː ɑ
noori	n oː r i
noorikkõ	n oː r i kː ɤ
nooruz	n oː r u z
noorõ	n oː r ɑ
noottõ	n oː tː ɑ
nukkua	n u kː u ɑ̯
nurkkõ	n u r kː ɑ
nurmi	n u r m i
nuumõri	n uː m ɤ r i
nuuzgõtõ	n uː z ɡ ɑ t ɑ
nähä	n æ h æ
näko	n æ k o
nältše	n æ l t͡ʃ æ
nämä	n æ m æ
nämäd	n æ m æ d
nänne	n æ nː æ
näppi	n æ pː i
näre	n æ r e
närriä	n æ r i æ̯
näteli	n æ t e l i
nättšüä	n æ t͡ʃ y æ̯
nääle	n æː l æ
näüttisse	n æ y̯ tː iː sː æ
näüttä	n æ y̯ tː æː
nõdrõ	n ɤ d r ɑ
nõissõ	n ɤ i̯ sː ɑ
nõitoa	n ɤ i̯ t o ɑ̯
nõitõ	n ɤ i̯ t ɑ
nõki	n ɤ k i
nõma	n ɤ m ɑ
nõmmi	n ɤ mː i
nõsatta	n ɤ s ɑ tː ɑː
nõssa	n ɤ sː ɑː
nõtko	n ɤ t k o
nõvvo	n ɤ vː o
nõvvoa	n ɤ vː o ɑ̯
nüd	n y d
nültšiä	n y l t͡ʃ i æ̯
ohka	o h k ɑː
ohto	o h t o
ohtogo	o h t o ɡ o
oita	o i̯ t ɑː
olud	o l u d
omenõ	o m e n ɑ
ono	o n o
oomnikko	oː m n i kː o
oomõn	oː m ɤ n
oonõ	oː n ɤ
ootta	oː tː ɑː
ootõllõ	oː t ɤ lː ɑ
opo	o p o
opõn	o p ɤ n
orjõ	o r ʝ ɑ
orjõmarjõ	o r ʝ ɑ m ɑ r ʝ ɑ
orko	o r k o
paganõ	p ɑ ɡ ɑ n ɑ
paglõ	p ɑ ɡ l ɑ
pagõtõ	p ɑ ɡ ɤ t ɑ
paha	p ɑ h ɑ
pahain	p ɑ h ɑ i̯ n
pahkõ	p ɑ h k ɑ
paikkõ	p ɑ i̯ kː ɑ
paina	p ɑ i̯ n ɑː
paino	p ɑ i̯ n o
paissa	p ɑ i̯ sː ɑː
paizõ	p ɑ i̯ z ɤ
paizõttua	p ɑ i̯ z ɤ tː u ɑ̯
paja	p ɑ ʝ ɑ
pajatta	p ɑ ʝ ɑ tː ɑː
paju	p ɑ ʝ u
pakkain	p ɑ kː ɑ i̯ n
pakko	p ɑ kː o
pako	p ɑ k o
paksu	p ɑ k s u
palgõ	p ɑ l ɡ ɤ
palkkõ	p ɑ l kː ɑ
palko	p ɑ l k o
pannõ	p ɑ nː ɑ
pappi	p ɑ pː i
paraika	p ɑ r ɑ i̯ k ɑː
paraz	p ɑ r ɑ z
parmõz	p ɑ r m ɑ z
parsi	p ɑ r s i
partõ	p ɑ r t ɑ
parvi	p ɑ r v i
parvõz	p ɑ r v ɤ z
parõpi	p ɑ r ɤ p i
paskõ	p ɑ s k ɑ
passibo	p ɑ s s i b o
passibo	p ɑ sː i b o
pata	p ɑ t ɑ
paukka	p ɑ u̯ kː ɑː
peeni	p eː n i
peentõrõ	p eː n t ɤ r ɑ
peerre	p eː rː æ
pehko	p e h k o
pehmiä	p e h m i æ̯
pekki	p e kː i
pelatõ	p e l ɑ t ɑ
pelko	p e l k o
pellete	p e lː æ t æ
pellõvõz	p e lː ɑ v ɑ z
peni	p e n i
penikkõ	p e n i kː ɑ
pere	p e r e
perrä	p e r æː
perttsu	p e r t͡sː u
perze	p e r z e
perä	p e r æ
pesse	p e sː e
pessisse	p e sː iː sː æ
pesä	p e s æ
petelle	p e t e lː æ
pettä	p e tː æː
petäje	p e t æ ʝ æ
petšel	p e t͡ʃ e l
peukolo	p e u̯ k o l o
pihed	p i h e d
pihkõ	p i h k ɑ
piho	p i h o
pihtõ	p i h t ɑ
pii	p iː
piikki	p iː kː i
piikõ	p iː k ɑ
piime	p iː m æ
piippu	p iː pː u
piirgõ	p iː r ɡ ɑ
piiri	p iː r i
pikkõrain	p i kː ɑ r ɑ i̯ n
pilatõ	p i l ɑ t ɑ
pilli	p i lː i
pillittä	p i lː i tː æː
pilvi	p i l v i
pimiä	p i m i æ̯
pimmiä	p i m i æ̯
pinisse	p i n i sː æ
pino	p i n o
pintõ	p i n t ɑ
pissä	p i sː æː
pissü	p i sː yː
pittuz	p i t uː z
pittä	p i t æː
pittše	p i t͡ʃː æ
pitää	p i t æː
plattsi	p l ɑ t͡sː i
plemänikkõ	p l e m æ n i kː ɑ
pletittä	p l e t i tː æː
pliittõ	p l iː tː ɑ
podarkkõ	p o d ɑ r kː ɑ
poduškõ	p o d u ʃ k ɑ
poikain	p o i̯ k ɑ i̯ n
poikõ	p o i̯ k ɑ
poiz	p o i̯ z
pojezdõ	p o ʝ e z d ɑ
pomidora	p o m i d o r ɑ
pominoitta	p o m i n o i̯ tː ɑː
pool	p oː l
pooli	p oː l i
poolõssõ	p oː l ɤ sː ɑ
poolõz	p oː l ɑ z
posti	p o s t i
praavitta	p r ɑː v i tː ɑː
praaviussõ	p r ɑː v i u̯ sː ɑ
praaznikkõ	p r ɑː z n i kː ɑ
progonõ	p r o ɡ o n ɑ
prolivõ	p r o l i v ɑ
proobõtõ	p r oː b ɑ t ɑ
pruukkia	p r uː kː i ɑ̯
puhassa	p u h ɑ sː ɑː
puhaz	p u h ɑ z
puhgõtõ	p u h ɡ ɑ t ɑ
puhhua	p u hː u ɑ̯
puippu	p u i̯ pː u
puissa	p u i̯ sː ɑː
pullo	p u lː o
puna	p u n ɑ
punanõ	p u n ɑ n ɤ
punnoa	p u n o ɑ̯
purikkõ	p u r i kː ɑ
purjõ	p u r ʝ ɤ
purrõ	p u rː ɑ
puu	p uː
puukki	p uː kː i
puuttua	p uː tː u ɑ̯
puuvillõ	p uː v i lː ɑ
puzõrta	p u z ɤ r t ɑː
pähtšene	p æ h t͡ʃ e n e
päi	p æ i̯
päitsed	p æ i̯ t͡s e d
päive	p æ i̯ v æ
päivelintu	p æ i̯ v æ l i n t u
päivüd	p æ i̯ v y d
päre	p æ r e
pää	p æː
pääle	p æː l e
päälle	p æː lː æ
päälte	p æː l t æ
pääluu	p æː l uː
päälüz	p æː l y z
pääse	p æː s æ
pääsko	p æː s k o
põhjain	p ɤ h ʝ ɑ i̯ n
põhjõ	p ɤ h ʝ ɑ
põllõa	p ɤ l ɤ ɑ̯
põlto	p ɤ l t o
põlvi	p ɤ l v i
põrnõ	p ɤ r n ɑ
põrzõz	p ɤ r z ɑ z
põski	p ɤ s k i
põvvi	p ɤ vː i
pöllü	p ø lː y
pööre	p øː r æ
pööriä	p øː r i æ̯
pühtšiä	p y h t͡ʃ i æ̯
pühä	p y h æ
pühäpäive	p y h æ p æ i̯ v æ
pürtšiä	p y r t͡ʃ i æ̯
püssü	p y sː y
püü	p yː
püütä	p yː t æː
ragõ	r ɑ ɡ ɤ
raha	r ɑ h ɑ
rahkõ	r ɑ h k ɑ
rahvõz	r ɑ h v ɑ z
raja	r ɑ ʝ ɑ
rakko	r ɑ kː o
rakkopilli	r ɑ kː o p i lː i
rako	r ɑ k o
rankkõ	r ɑ ŋ kː ɑ
rantõ	r ɑ n t ɑ
raskõz	r ɑ s k ɑ z
rataz	r ɑ t ɑ z
ratiz	r ɑ t i z
rattsa	r ɑ t͡sː ɑː
raukkõ	r ɑ u̯ kː ɑ
rautõ	r ɑ u̯ t ɑ
rautõn	r ɑ u̯ t ɑ n
ravad	r ɑ v ɑ d
ravvu	r ɑ vː u
razvõ	r ɑ z v ɑ
rehellin	r e h e lː iː n
rehtele	r e h t e l æ
reisi	r e i̯ s i
repo	r e p o
reppiä	r e p i æ̯
retši	r e t͡ʃ i
rihenneüz	r i h e n n e y̯ z
rihi	r i h i
rihmõ	r i h m ɑ
riigõ	r iː ɡ ɑ
riijõllõ	r iː ʝ ɤ lː ɑ
riito	r iː t o
riittõ	r iː tː ɑ
rikaz	r i k ɑ z
rikki	r i kː i
rikkoa	r i kː o ɑ̯
rinnõllõ	r i nː ɑ lː ɑ
rintõ	r i n t ɑ
rippua	r i pː u ɑ̯
rissi	r i sː i
roho	r o h o
rohoin	r o h o i̯ n
roitta	r o i̯ tː ɑː
roivõz	r o i̯ v ɑ z
rokkõ	r o kː ɑ
roojõ	r oː ʝ ɑ
roojõkõz	r oː ʝ ɑ k ɑ z
rooko	r oː k o
rookõ	r oː k ɑ
roomõ	r oː m ɑ
rooppõ	r oː pː ɑ
rooskõ	r oː s k ɑ
roosõ	r oː s ɤ
rooto	r oː t o
routõ	r o u̯ t ɑ
ruma	r u m ɑ
rupi	r u p i
ruska	r u s k ɑː
ruskõa	r u s k ɤ ɑ̯
rutto	r u tː o
ruumõz	r uː m ɤ z
ruuto	r uː t o
räkä	r æ k æ
ränne	r æ nː e
rätte	r æ tː e
rääto	r æː t o
räüstez	r æ y̯ s t æ z
rõbakkõ	r ɤ b ɑ kː ɑ
rõhkapi	r ɤ h k ɑː p i
rõhkõa	r ɤ h k ɤ ɑ̯
rõngõz	r ɤ ŋ ɡ ɑ z
rõõskõ	r ɤː s k ɑ
rüiz	r y i̯ z
rüüpete	r yː p æ t æ
saadu	s ɑː d u
saappõgõ	s ɑː pː ɑ ɡ ɑ
saari	s ɑː r i
saatta	s ɑː tː ɑː
saatto	s ɑː tː o
saavvõ	s ɑː vː ɤ
saha	s ɑ h ɑ
sahatõ	s ɑ h ɑ t ɑ
saijõ	s ɑ i̯ ʝ ɑ
saivõr	s ɑ i̯ v ɑ r
sakka	s ɑ k ɑː
sakkassi	s ɑ k ɑː sː i
sakkõli	s ɑ kː ɑ l i
saksõ	s ɑ k s ɑ
saksõlain	s ɑ k s ɑ l ɑ i̯ n
salmi	s ɑ l m i
salvoa	s ɑ l v o ɑ̯
sama	s ɑ m ɑ
sammua	s ɑ mː u ɑ̯
sammutta	s ɑ mː u tː ɑː
sammõl	s ɑ mː ɑ l
sammõz	s ɑ mː ɑ z
sappi	s ɑ pː i
sarajõ	s ɑ r ɑ ʝ ɑ
sarkõ	s ɑ r k ɑ
sarvi	s ɑ r v i
sata	s ɑ t ɑ
sataa	s ɑ t ɑː
satamõ	s ɑ t ɑ m ɑ
sato	s ɑ t o
satta	s ɑ t ɑː
satulõ	s ɑ t u l ɑ
saunõ	s ɑ u̯ n ɑ
savi	s ɑ v i
savu	s ɑ v u
savvi	s ɑ vː i
savvu	s ɑ vː u
see	s eː
seel	s eː l
seelle	s eː lː e
seelte	s eː l t æ
seeme	s eː m eː
seemevõi	s eː m eː v ɤ i̯
segatõ	s e ɡ ɑ t ɑ
seine	s e i̯ n æ
seitse	s e i̯ t͡s eː
seittse	s e i̯ t͡sː eː
seittseteiššümed	s e i̯ t͡sː eː t e i̯ ʃː y m e d
seittsetõiššümed	s e i̯ t͡sː eː t ɤ i̯ ʃː y m e d
seivez	s e i̯ v æ z
seldi	s e l d i
seltše	s e l t͡ʃ æ
seltšeluu	s e l t͡ʃ æ l uː
seltšiä	s e l t͡ʃ i æ̯
seneperäss	s e n e p e r æ sː
seppe	s e pː æ
seukko	s e u̯ kː o
sigarazvõ	s i ɡ ɑː r ɑ z v ɑ
siglõ	s i ɡ l ɑ
siha	s i h ɑ
sihe	s i h e
siikõ	s iː k ɑ
siili	s iː l i
siimõ	s iː m ɑ
siin	s iː n
siini	s iː n i
siipi	s iː p i
siitiä	s iː t i æ̯
siivo	s iː v o
siivollin	s iː v o lː i n
sika	s i k ɑ
silme	s i l m æ
silmerätte	s i l m æ r æ tː e
silmu	s i l m u
siltõ	s i l t ɑ
sini	s i n i
sinin	s i n i n
sinne	s i nː e
siplikõz	s i p l i k ɑ z
sipuli	s i p u l i
sirka	s i r k ɑː
sirkku	s i r kː u
sirkoa	s i r k o ɑ̯
sirppi	s i r pː i
sisavõ	s i s ɑ v ɑ
siso	s i s o
sittoa	s i t o ɑ̯
sittua	s i tː u ɑ̯
sittõ	s i tː ɑ
siz	s i z
siä	s i æ̯
siäl	s i æ̯ l
siälte	s i æ̯ l t æ
siõ	s i ɤ
skripkõ	s k r i p k ɑ
sliivõ	s l iː v ɑ
sokko	s o kː o
soldõtti	s o l d ɑ tː i
soo	s oː
soojõ	s oː ʝ ɑ
soojõtta	s oː ʝ ɤ tː ɑː
soojõtõllõ	s oː ʝ ɤ t ɤ lː ɑ
sooli	s oː l i
soolõ	s oː l ɑ
soolõn	s oː l ɑ n
soolõtõ	s oː l ɑ t ɑ
soomi	s oː m i
soomuz	s oː m u z
soomõ	s oː m ɤː
soomõlain	s oː m ɑ l ɑ i̯ n
sooni	s oː n i
soovia	s oː v i ɑ̯
soppia	s o p i ɑ̯
sopuzõ	s o p u z ɑ
sorkkõ	s o r kː ɑ
sorovnoo	s o r o v n oː
sorra	s o r ɑː
sorsõ	s o r s ɑ
staruhõ	s t ɑ r u h ɑ
stokanõ	s t o k ɑ n ɑ
stuuli	s t uː l i
suitsõd	s u i̯ t͡s ɤ d
suka	s u k ɑ
sukkuri	s u kː u r i
sukkõ	s u kː ɑ
suku	s u k u
sukulain	s u k u l ɑ i̯ n
sukunimi	s u k u n i m i
sula	s u l ɑ
sulatta	s u l ɑ tː ɑː
sulkõ	s u l k ɑ
sulla	s u l ɑː
suppi	s u pː i
surmõ	s u r m ɑ
surrõ	s u rː ɑ
survoa	s u r v o ɑ̯
susi	s u s i
suu	s uː
suukkuri	s uː kː u r i
suupilli	s uː p i lː i
suuri	s uː r i
suurimõ	s uː r i m ɑ
suuruz	s uː r u z
suutkõd	s uː t k ɑ d
suuttua	s uː tː u ɑ̯
suvatõ	s u v ɑ t ɑ
suvi	s u v i
suvvamin	s u v ɑː m iː n
säije	s æ i̯ ʝ e
säkki	s æ kː i
säntšü	s æ n t͡ʃ y
särtši	s æ r t͡ʃ i
särtšiä	s æ r t͡ʃ i æ̯
sää	s æː
sääri	s æː r i
sääski	s æː s k i
sõbrõ	s ɤ b r ɑ
sõisoa	s ɤ i̯ s o ɑ̯
sõissõ	s ɤ i̯ sː ɑ
sõkka	s ɤ k ɑː
sõkõa	s ɤ k ɤ ɑ̯
sõlmu	s ɤ l m u
sõmõrõ	s ɤ m ɤ r ɑ
sõna	s ɤ n ɑ
sõnatširjõ	s ɤ n ɑ t͡ʃ i r ʝ ɑ
sõpa	s ɤ p ɑ
sõppõssõ	s ɤ p ɤː sː ɑ
sõrmi	s ɤ r m i
sõrmuz	s ɤ r m u z
sõrto	s ɤ r t o
sõssõr	s ɤ sː ɑ r
sõta	s ɤ t ɑ
sõtameez	s ɤ t ɑ m eː z
sõtkoa	s ɤ t k o ɑ̯
sõuta	s ɤ u̯ t ɑː
sõzar	s ɤ z ɑ r
süli	s y l i
sültši	s y l t͡ʃ i
sültšiä	s y l t͡ʃ i æ̯
sünnüttä	s y nː y tː æː
süntüä	s y n t y æ̯
süsi	s y s i
süsälikko	s y s æ l i kː o
süttüä	s y tː y æ̯
sütšüzü	s y t͡ʃ y z y
süvä	s y v æ
süä	s y æ̯
süäme	s y æ̯ m eː
süämese	s y æ̯ m e s e
süämesse	s y æ̯ m e sː æ
süämez	s y æ̯ m e z
süämme	s y æ̯ mː eː
süämmese	s y æ̯ mː e s e
süämmesse	s y æ̯ mː e sː æ
süämmez	s y æ̯ mː e z
süü	s yː
süüttä	s yː tː æː
süüttši	s yː t͡ʃː i
süüvve	s yː vː æ
taari	t ɑː r i
taattõ	t ɑː tː ɑ
taaz	t ɑː z
tagga	t ɑ ɡ ɑː
taggaz	t ɑ ɡ ɑː z
taglõ	t ɑ ɡ l ɑ
tahto	t ɑ h t o
tahtoa	t ɑ h t o ɑ̯
taimi	t ɑ i̯ m i
taita	t ɑ i̯ t ɑː
taitšinõ	t ɑ i̯ t͡ʃ i n ɑ
taivõz	t ɑ i̯ v ɑ z
takant	t ɑ k ɑ n t
takaz	t ɑ k ɑ z
taki	t ɑ k i
takka	t ɑ k ɑː
takkoa	t ɑ k o ɑ̯
talloa	t ɑ lː o ɑ̯
tallõtõ	t ɑ lː ɑ t ɑ
talo	t ɑ l o
talvi	t ɑ l v i
tammi	t ɑ mː i
tanttsia	t ɑ n t͡sː i ɑ̯
tanttsu	t ɑ n t͡sː u
tapa	t ɑ p ɑ
tapahtua	t ɑ p ɑ h t u ɑ̯
tapahtuussõ	t ɑ p ɑ h t uː sː ɑ
tappa	t ɑ pː ɑː
tappo	t ɑ pː o
tapõllõ	t ɑ p ɤ lː ɑ
tara	t ɑ r ɑ
tarelkkõ	t ɑ r e l kː ɑ
tarkkõ	t ɑ r kː ɑ
tarkõssi	t ɑ r k ɑ sː i
tarttua	t ɑ r tː u ɑ̯
tarviz	t ɑ r v i z
tauti	t ɑ u̯ t i
tedri	t e d r i
tee	t eː
tehä	t e h æ
teko	t e k o
telefona	t e l e f o n ɑ
temppu	t e m pː u
tere	t e r e
terve	t e r v e
tervüz	t e r v yː z
terä	t e r æ
teräve	t e r æ v æ
teräz	t e r æ z
tetšeje	t e t͡ʃ e ʝ æ
tihi	t i h i
tiini	t iː n i
tikkõ	t i kː ɑ
tila	t i l ɑ
tilkkua	t i l kː u ɑ̯
tilkkõ	t i l kː ɑ
tina	t i n ɑ
titti	t i tː i
toho	t o h o
tokkua	t o kː u ɑ̯
tolkku	t o l kː u
tomakkõ	t o m ɑ kː ɑ
toomi	t oː m i
toorõ	t oː r ɤ
toovvõ	t oː vː ɤ
toož	t oː ʒ
tormi	t o r m i
torrua	t o r u ɑ̯
totku	t o t k u
toukõtõ	t o u̯ k ɑ t ɑ
traatti	t r ɑː tː i
treskõ	t r e s k ɑ
truba	t r u b ɑ
tsentšisse	t͡s e n t͡ʃ iː sː æ
tuhattõ	t u h ɑ tː ɑ
tuhkõ	t u h k ɑ
tuhmõ	t u h m ɑ
tuimõ	t u i̯ m ɑ
tuisku	t u i̯ s k u
tuli	t u l i
tullõ	t u lː ɑ
tunni	t u nː i
tunnid	t u nː i d
tuntõa	t u n t ɤ ɑ̯
tupa	t u p ɑ
tuppi	t u pː i
turpa	t u r p ɑː
turpõkkõ	t u r p ɑ kː ɑ
turvõz	t u r v ɑ z
tuttõvõ	t u tː ɑ v ɑ
tuuli	t uː l i
tuulikõz	t uː l i k ɑ z
tuurõ	t uː r ɑ
tuuvvõ	t uː vː ɤ
tähti	t æ h t i
täi	t æ i̯
tämä	t æ m æ
tänne	t æ nː e
tänäve	t æ n æ v æ
täti	t æ t i
tääl	t æː l
täälte	t æː l t æ
tääteje	t æː t æ ʝ æ
täätä	t æː t æː
täünne	t æ y̯ nː æ
täüsi	t æ y̯ s i
täüttä	t æ y̯ tː æː
täüz	t æ y̯ z
tõgõ	t ɤ ɡ ɤ
tõhtia	t ɤ h t i ɑ̯
tõin	t ɤ i̯ n
tõinpäive	t o i̯ n p æ i̯ v æ
tõintõizõ	t ɤ i̯ n t ɤ i̯ z ɤː
tõmmõtõ	t ɤ mː ɑ t ɑ
tõrvõ	t ɤ r v ɑ
tõsi	t ɤ s i
töö	t øː
tühje	t y h ʝ æ
tükki	t y kː i
tülppe	t y l pː æ
tünke	t y ŋ k æ
türme	t y r m æ
tütterikko	t y tː æ r i kː o
tüttö	t y tː ø
tütär	t y t æ r
tüven	t y v e n
tüvi	t y v i
tüvve	t y v eː
tüvveä	t y v e æ̯
tüü	t yː
tüüni	t yː n i
tšaaju	t͡ʃ ɑː ʝ u
tšako	t͡ʃ ɑ k o
tšaskõ	t͡ʃ ɑ s k ɑ
tšedreluu	t͡ʃ e d r æ l uː
tšedrete	t͡ʃ e d r æ t æ
tšeeli	t͡ʃ eː l i
tšeeltä	t͡ʃ eː l t æː
tšeertä	t͡ʃ eː r t æː
tšehsi	t͡ʃ e h s i
tšehsimein	t͡ʃ e h s i m e i̯ n
tšehspaikkõ	t͡ʃ e h s p ɑ i̯ kː ɑ
tšelle	t͡ʃ e lː æ
tšello	t͡ʃ e lː o
tšen	t͡ʃ e n
tšenle	t͡ʃ e n l eː
tšenni	t͡ʃ e nː i
tšentše	t͡ʃ e n t͡ʃ æ
tšerikko	t͡ʃ e r i kː o
tšerriä	t͡ʃ e r i æ̯
tšerä	t͡ʃ e r æ
tšesä	t͡ʃ e s æ
tševäd	t͡ʃ e v æ d
tšihhua	t͡ʃ i h u ɑ̯
tšihutta	t͡ʃ i h u tː ɑː
tšiin	t͡ʃ iː n
tšiire	t͡ʃ iː r e
tšiitoz	t͡ʃ iː t o z
tšiittä	t͡ʃ iː tː æː
tšimo	t͡ʃ i m o
tšimolain	t͡ʃ i m o l ɑ i̯ n
tšinnõz	t͡ʃ i nː ɑ z
tšippa	t͡ʃ i p ɑː
tširjotta	t͡ʃ i r ʝ o tː ɑː
tširjõ	t͡ʃ i r ʝ ɑ
tširotõ	t͡ʃ i r o t ɑ
tširppu	t͡ʃ i r pː u
tširvez	t͡ʃ i r v e z
tšiskoa	t͡ʃ i s k o ɑ̯
tšitkõa	t͡ʃ i t k ɤ ɑ̯
tšiutto	t͡ʃ i u̯ tː o
tšiuzõtõ	t͡ʃ i u̯ z ɑ t ɑ
tšivi	t͡ʃ i v i
tšähsiä	t͡ʃ æ h s i æ̯
tšähsü	t͡ʃ æ h s y
tšälü	t͡ʃ æ l y
tšämmel	t͡ʃ æ mː e l
tšäpäle	t͡ʃ æ p æ l æ
tšäpü	t͡ʃ æ p y
tšärpen	t͡ʃ æ r p æ n
tšärppe	t͡ʃ æ r pː æ
tšäsi	t͡ʃ æ s i
tšätšüd	t͡ʃ æ t͡ʃ y d
tšävve	t͡ʃ æ vː e
tšäzne	t͡ʃ æ z n æ
tšääntä	t͡ʃ æː n t æː
tšääntüä	t͡ʃ æː n t y æ̯
tšääriä	t͡ʃ æː r i æ̯
tšöhä	t͡ʃ ø h æ
tšühseä	t͡ʃ y h s e æ̯
tšühzettä	t͡ʃ y h z e tː æː
tšülme	t͡ʃ y l m æ
tšülpesse	t͡ʃ y l p eː sː æ
tšültši	t͡ʃ y l t͡ʃ i
tšültšiluu	t͡ʃ y l t͡ʃ i l uː
tšülvä	t͡ʃ y l v æː
tšülä	t͡ʃ y l æ
tšüläläin	t͡ʃ y l æ l æ i̯ n
tšümme	t͡ʃ y mː eː
tšünnüz	t͡ʃ y nː y z
tšüntä	t͡ʃ y n t æː
tšüssüä	t͡ʃ y s y æ̯
tšütü	t͡ʃ y t y
tšütše	t͡ʃ y t͡ʃ e
tšüünel	t͡ʃ yː n e l
tšüünere	t͡ʃ yː n æ r æ
tšüüsi	t͡ʃ yː s i
ugurittsõ	u ɡ u r i t͡sː ɑ
uhka	u h k ɑː
uhsi	u h s i
ujjua	u ʝ u ɑ̯
ujua	u ʝ u ɑ̯
ukko	u kː o
ulvoa	u l v o ɑ̯
umalõ	u m ɑ l ɑ
umalõz	u m ɑ l ɑ z
uni	u n i
unilintu	u n i l i n t u
unissua	u n i sː u ɑ̯
unohta	u n o h t ɑː
upotõ	u p o t ɑ
uppossõ	u pː oː sː ɑ
urissõ	u r i sː ɑ
urokkõ	u r o kː ɑ
urpõ	u r p ɑ
uskoa	u s k o ɑ̯
utar	u t ɑ r
utu	u t u
uuli	uː l i
uurõ	uː r ɤ
uusi	uː s i
uusõd	uː s ɤ d
uutimo	uː t i m o
vaa	v ɑː
vaahto	v ɑː h t o
vaahtõrõ	v ɑː h t ɤ r ɑ
vaalia	v ɑː l i ɑ̯
vaapsõlain	v ɑː p s ɑ l ɑ i̯ n
vaassõ	v ɑː sː ɑ
vaatta	v ɑː tː ɑː
vadnõz	v ɑ d n ɑ z
vaha	v ɑ h ɑ
vahinko	v ɑ h i ŋ k o
vahtia	v ɑ h t i ɑ̯
vahvõ	v ɑ h v ɑ
vai	v ɑ i̯
vaikko	v ɑ i̯ kː o
vait	v ɑ i̯ t
vaivõ	v ɑ i̯ v ɑ
vaivõtta	v ɑ i̯ v ɑ tː ɑː
vajõlta	v ɑ ʝ ɤ l t ɑː
vajõltua	v ɑ ʝ ɤ l t u ɑ̯
vaka	v ɑ k ɑ
vakkõ	v ɑ kː ɑ
vako	v ɑ k o
valka	v ɑ l k ɑː
valla	v ɑ l ɑː
vallua	v ɑ l u ɑ̯
valmiz	v ɑ l m i z
valo	v ɑ l o
valtõ	v ɑ l t ɑ
valutta	v ɑ l u tː ɑː
valvoa	v ɑ l v o ɑ̯
valõ	v ɑ l ɤ
valõllõ	v ɑ l ɤ lː ɑ
vana	v ɑ n ɑ
vankkuri	v ɑ ŋ kː u r i
vanni	v ɑ nː i
varenjõ	v ɑ r e n ʝ ɑ
vargõssa	v ɑ r ɡ ɑ sː ɑː
vargõz	v ɑ r ɡ ɑ z
vari	v ɑ r i
varjo	v ɑ r ʝ o
varmõ	v ɑ r m ɑ
varnõ	v ɑ r n ɑ
varra	v ɑ r ɑː
varsi	v ɑ r s i
varsõ	v ɑ r s ɑ
vartõ	v ɑ r t ɤː
varvõz	v ɑ r v ɑ z
varõz	v ɑ r ɤ z
vasarõ	v ɑ s ɑ r ɑ
vasatõ	v ɑ s ɑ t ɑ
vassa	v ɑ sː ɑː
vassõ	v ɑ sː ɑ
vattsõ	v ɑ t͡sː ɑ
vazikkõ	v ɑ z i kː ɑ
veel	v eː l
veerettä	v eː r e tː æː
veeri	v eː r i
veero	v eː r o
veittä	v e i̯ tː æː
velli	v e lː i
vene	v e n e
vennä	v e nː æː
vennäi	v e nː æ i̯
vennüä	v e n y æ̯
venäläin	v e n æ l æ i̯ n
veri	v e r i
verin	v e r i n
vesi	v e s i
vetele	v e t e l æ
veto	v e t o
viha	v i h ɑ
vihain	v i h ɑ i̯ n
vihere	v i h e r æ
vihko	v i h k o
vihmõ	v i h m ɑ
vihmõlintu	v i h m ɑ l i n t u
vihtõ	v i h t ɑ
viijje	v iː ʝː æ
viijjezpäive	v iː ʝː e z p æ i̯ v æ
viikko	v iː kː o
viimin	v iː m i n
viinõ	v iː n ɑ
viipõtõ	v iː p ɑ t ɑ
viipüä	v iː p y æ̯
viis	v iː s
viisi	v iː s i
viisi	v iː s iː
viisteiššümed	v iː s t e i̯ ʃː y m e d
viistõiššümed	v iː s t ɤ i̯ ʃː y m e d
viittsiä	v iː t͡sː i æ̯
viizõz	v iː z ɑ z
viiž	v iː ʒ
vika	v i k ɑ
vikahtõ	v i k ɑ h t ɤ
villõ	v i lː ɑ
vilu	v i l u
vimpõ	v i m p ɑ
vinkua	v i ŋ k u ɑ̯
vinkõ	v i ŋ k ɑ
vire	v i r e
viro	v i r oː
virolain	v i r o l ɑ i̯ n
virre	v i rː e
virsi	v i r s i
virtõ	v i r t ɑ
vittoa	v i t o ɑ̯
vittsõ	v i t͡sː ɑ
vizgõtõ	v i z ɡ ɑ t ɑ
vohmõ	v o h m ɑ
voho	v o h o
voi	v o i̯
voitto	v o i̯ tː o
vokki	v o kː i
voosi	v oː s i
vot	v o t
vunukkõ	v u n u kː ɑ
vähepi	v æ h e p i
vähhäize	v æ h æ i̯ z eː
vähä	v æ h æ
väli	v æ l i
välille	v æ l i lː æ
väliz	v æ l i z
vällä	v æ lː æː
värpo	v æ r p o
väräje	v æ r æ ʝ æ
vässüä	v æ s y æ̯
vätševe	v æ t͡ʃ e v æ
vätši	v æ t͡ʃ i
vävü	v æ v y
vääntisse	v æː n t iː sː æ
vääntä	v æː n t æː
vääre	v æː r æ
võdnõ	v ɤ d n ɑ
või	v ɤ i̯
võijjõ	v ɤ i̯ ʝː ɤ
võimõ	v ɤ i̯ m ɑ
võimõkõz	v ɤ i̯ m ɑ k ɑ z
võissõ	v ɤ i̯ sː ɑ
võita	v ɤ i̯ t ɑː
võitta	v ɤ i̯ tː ɑː
võlkõ	v ɤ l k ɑ
võrkko	v ɤ r kː o
võrkkõ	v ɤ r kː ɑ
võtta	v ɤ tː ɑː
võtti	v ɤ t iː
võõrõz	v ɤː r ɑ z
vöö	v øː
zavodõ	z ɑ v o d ɑ
zemľänkõ	z e m ʎ æ ŋ k ɑ
zveeri	z v eː r i
Õtavõ	ɤ t ɑ v ɑ
äez	æ e̯ z
ähtšiä	æ h t͡ʃ i æ̯
äjje	æ ʝː æ
ämme	æ mː æ
änte	æ n t æ
äppiä	æ p i æ̯
äpü	æ p y
ärtše	æ r t͡ʃ æ
ättšissä	æ t͡ʃː iː sː æː
ätä	æ t æ
ävvisse	æ v iː sː æ
ääli	æː l i
ääni	æː n i
ääre	æː r eː
äärez	æː r e z
ääri	æː r i
õgaz	ɤ ɡ ɑ z
õhjõ	ɤ h ʝ ɑ
õhsõ	ɤ h s ɑ
õhsõtõ	ɤ h s ɤ t ɑ
õhtõgo	ɤ h t ɑ ɡ o
õhvõ	ɤ h v ɑ
õika	ɤ i̯ k ɑː
õikõa	ɤ i̯ k ɤ ɑ̯
õja	ɤ ʝ ɑ
õlkõ	ɤ l k ɑ
õllõ	ɤ lː ɑ
õltši	ɤ l t͡ʃ i
õlud	ɤ l u d
õma	ɤ m ɑ
õmmõllõ	ɤ mː ɤ lː ɑ
õmõ	ɤ m ɤ
õnni	ɤ nː i
õnnõkõz	ɤ nː ɤ k ɑ z
õppa	ɤ p ɑː
õppi	ɤ pː i
õppia	ɤ pː i ɑ̯
õppissõ	ɤ pː iː sː ɑ
õppõssõ	ɤ p ɤː sː ɑ
õpõa	ɤ p ɤ ɑ̯
õpõtta	ɤ p ɤ tː ɑː
õpõttaja	ɤ p ɤ tː ɑ ʝ ɑ
õravõ	ɤ r ɑ v ɑ
õraz	ɤ r ɑ z
õrsi	ɤ r s i
õsa	ɤ s ɑ
õssa	ɤ sː ɑː
õttsõ	ɤ t͡sː ɑ
õvvi	ɤ vː i
õzrikko	ɤ z r i kː o
õzrõ	ɤ z r ɑ
õõroa	ɤː r o ɑ̯
öhsüä	ø h s y æ̯
ühesä	y h e s æː
ühesäteiššümed	y h e s æː t e i̯ ʃː y m e d
ühesätõiššümed	y h e s æː t ɤ i̯ ʃː y m e d
ühs	y h s
ühsi	y h s i
ühsinä	y h s i n æː
ühsteiššümed	y h s t e i̯ ʃː y m e d
ühstõiššümed	y h s t ɤ i̯ ʃː y m e d
ühtä	y h t æː
üle	y l e
ülelle	y l e lː æ
üli	y l i
ülioomõn	y l i oː m ɤ n
ülle	y lː e
üllez	y l eː z
ülpiä	y l p i æ̯
ümmerkäin	y mː æ r k æ i̯ n
ümperi	y m p æ r i
üvä	y v æ
üü	yː
širisse	ʃ i r i sː æ
šiškõ	ʃ i ʃ k ɑ
škippõri	ʃ k i pː ɑ r i
škoulu	ʃ k o u̯ l u
šolkkõ	ʃ o l kː ɑ
štanad	ʃ t ɑ n ɑ d
što	ʃ t o
žaali	ʒ ɑː l i
žaaritta	ʒ ɑː r i tː ɑː
ženihõ	ʒ e n i h ɑ
ženihõ	ʒ e n i x ɑ
žiivõttõ	ʒ iː v ɑ tː ɑ
