bebí	p ɛ̀ p í ʔ
bebíah	p ɛ̀ p ɪ́ à h
che	t͡ʃʰ ɛ̀ ʔ
cheekuah	t͡ʃʰ ɛ̀ː kʰ ù à h
chá	t͡ʃʰ á ʔ
chǫ	t͡ʃʰ õ̞̀ ʔ
dechį	t ɛ̀ t͡ʃʰ ĩ̀ ʔ
deh	t ɛ̀ h
dene	t ɛ̀ n ɛ̀ ʔ
deneke	t ɛ̀ n ɛ̀ kʰ ɛ̀ ʔ
denekéhle	t ɛ̀ n ɛ̀ kʰ ɛ́ʰ ɮ ɛ̀ ʔ
deshį	t ɛ̀ ʃ ĩ̀ ʔ
dih	t ì h
dihcho	t ɪ̀ʰ t͡ʃʰ ò̞ ʔ
dzene	t͡s ɛ̀ n ɛ̀ ʔ
dzéh	t͡s ɛ́ h
dánéhtʼé	t á n ɛ́ʰ tʼ ɛ́ ʔ
dúyé	t ú j é ʔ
dųa	t ũ̀ à ʔ
gah	k à h
gha	ɣ à ʔ
golǫ	k ò̞ ɮ õ̞̀ ʔ
gotsʼę́	k ò̞ t͡sʼ ɛ̃́ ʔ
hé	h ɛ́ ʔ
jíye	t͡ʃ ɪ́ j è ʔ
jíyetú	t͡ʃ ɪ́ j è tʰ ú ʔ
kų́	kʰ ṹ ʔ
kǫ́	kʰ ṍ̞ ʔ
kǫ́tu	kʰ ṍ̞ tʰ ù ʔ
kʼoh	kʼ ò̞ h
kʼáy	kʼ á j
kʼų́	kʼ ṹ ʔ
libé	ɮ ɪ̀ p ɛ́ ʔ
lidí	ɮ ɪ̀ t í ʔ
líbarí	ɮ ɪ́ p à ɾ í ʔ
mbeh	ᵐb ɛ̀ h
mbehah	ᵐb ɛ̀ h à h
medzih	m ɛ̀ t͡s ì h
meh	m ɛ̀ h
mehchiné	m ɛ̀ʰ t͡ʃʰ ɪ̀ n ɛ́ ʔ
mį́h	m ĩ́ h
ndu	ⁿt ù ʔ
noohtsi	n ò̞ːʰ t͡sʰ ì ʔ
nu	n ù ʔ
nóda	n ó̞ t à ʔ
nódacho	n ó̞ t à t͡ʃʰ ò̞ ʔ
nódayaa	n ó̞ t à j àː
sa	s à ʔ
sachǫ	s à t͡ʃʰ õ̞̀ ʔ
sadzee	s à t͡s ɛ̀ː
sah	s à h
sahcho	s àʰ t͡ʃʰ ò̞ ʔ
sahdhéh	s àʰ ð ɛ́ h
sahyaa	s àʰ j àː
samba	s àᵐ b à ʔ
shah	ʃ à h
shį	ʃ ĩ̀ ʔ
sámba	s áᵐ b à ʔ
súhga	s úʰ k à ʔ
sį́	s ĩ́ ʔ
tedhe	tʰ ɛ̀ ð ɛ̀ ʔ
teh	tʰ ɛ̀ h
teze	tʰ ɛ̀ z ɛ̀ ʔ
tha	θ à ʔ
the	θ ɛ̀ ʔ
thę́	θ ɛ̃́ ʔ
ti	tʰ ì ʔ
tleh	t͡ɬʰ ɛ̀ h
tlį	t͡ɬʰ ĩ̀ ʔ
tlįah	t͡ɬʰ ĩ̀ à h
tlįcho	t͡ɬʰ ĩ̀ t͡ʃʰ ò̞ ʔ
tlįsho	t͡ɬʰ ĩ̀ ʃ ò̞ ʔ
tlʼuh	t͡ɬʼ ù h
tse	t͡sʰ ɛ̀ ʔ
tsá	t͡sʰ á ʔ
tsáah	t͡sʰ àː h
tsádhéh	t͡sʰ á ð ɛ́ h
tsádhéhkéhle	t͡sʰ á ð ɛ́ʰ kʰ ɛ́ʰ ɮ ɛ̀ ʔ
tsǫ́	t͡sʰ ṍ̞ ʔ
tsʼah	t͡sʼ à h
tsʼahle	t͡sʼ àʰ ɮ ɛ̀ ʔ
tsʼi	t͡sʼ ì ʔ
tsʼu	t͡sʼ ù ʔ
tsʼédé	t͡sʼ ɛ́ t ɛ́ ʔ
tsʼélį	t͡sʼ ɛ́ ɮ ĩ̀ ʔ
tsʼélįah	t͡sʼ ɛ́ ɮ ĩ̀ à h
tsʼéré	t͡sʼ ɛ́ ɾ ɛ́ ʔ
tthah	t͡θʰ à h
tthe	t͡θʰ ɛ̀ ʔ
tthecho	t͡θʰ ɛ̀ t͡ʃʰ ò̞ ʔ
tthʼih	t͡θʼ ì h
tthʼéh	t͡θʼ ɛ́ h
tu	tʰ ù ʔ
téh	tʰ ɛ́ h
tʼáh	tʼ á h
tʼéh	tʼ ɛ́ h
xah	x à h
xay	x à j
xeníh	x ɛ̀ n í h
xóo	x ò̞ː
xóokéhle	x ò̞ː kʰ ɛ́ʰ ɮ ɛ̀ ʔ
ya	j à ʔ
yah	j à h
yati	j à tʰ ì ʔ
yú	j ú ʔ
élį	ɛ́ ɮ ĩ̀ ʔ
łeh	ɬ ɛ̀ h
łie	ɬ ɪ̀ ɛ̀ ʔ
łue	ɬ ù ɛ̀ ʔ
łuh	ɬ ù h
łéh	ɬ ɛ́ h
łéhtʼéh	ɬ ɛ́ʰ tʼ ɛ́ h
łétʼéh	ɬ ɛ́ tʼ ɛ́ h
ɂabá	ʔ à p á ʔ
ɂah	ʔ à h
ɂahcho	ʔ àʰ t͡ʃʰ ò̞ ʔ
ɂamíi	ʔ à m ɪ́ ì ʔ
ɂayíi	ʔ à j ɪ́ ì ʔ
ɂedehtlʼéh	ʔ ɛ̀ t ɛ̀ʰ t͡ɬʼ ɛ́ h
ɂedené	ʔ ɛ̀ t ɛ̀ n ɛ́ ʔ
ɂedhéh	ʔ ɛ̀ ð ɛ́ h
ɂedzeé	ʔ ɛ̀ t͡s ɛ́ː
ɂejide	ʔ ɛ̀ t͡ʃ ɪ̀ t ɛ̀ ʔ
ɂejire	ʔ ɛ̀ t͡ʃ ɪ̀ ɾ ɛ̀ ʔ
ɂekwǫjire	ʔ ɛ̀ kʰ w õ̞̀ t͡ʃ ɪ̀ ɾ ɛ̀ ʔ
ɂekǫ́	ʔ ɛ̀ kʰ ṍ̞ ʔ
ɂekʼélu	ʔ ɛ̀ kʼ ɛ́ ɮ ù ʔ
ɂelá	ʔ ɛ̀ ɮ á ʔ
ɂepǫjire	ʔ ɛ̀ p õ̞̀ t͡ʃ ɪ̀ ɾ ɛ̀ ʔ
ɂetsʼándih	ʔ ɛ̀ t͡sʼ áⁿ t ì h
ɂetsʼánih	ʔ ɛ̀ t͡sʼ á n ì h
ɂetá	ʔ ɛ̀ tʰ á ʔ
ɂetúé	ʔ ɛ̀ tʰ ú ɛ́ ʔ
ɂetʼǫ́	ʔ ɛ̀ tʼ ṍ̞ ʔ
ɂezéh	ʔ ɛ̀ z ɛ́ h
ɂóe	ʔ ó̞ ɛ̀ ʔ
ɂǫki	ʔ õ̞̀ kʰ ì ʔ
