אַ גוט געבענטשט יאָר	ʊ ɡ ʊ t ɡ ə b ɛ n t͡ʃ t j ɔ ʁ
אַ גוט יאָר	a ɡ ʊ t j ɔ ʁ
אַ גוט יאָר	a ɡ ɪ t j ʊ r
אַ גוט קוויטל	a ɡ ʊ t k v ɪ t ɫ̩
אַ זייגער	a z ɛ ɪ̯ ɡ ə ʁ
אַ חוץ פֿון	a χ ʊ t͡s f ʊ n
אַ יישר	a j a ʃ ə ʁ
אַאָרטאַ	a ɔ r t a
אָבֿ	ɔ v
אַבֿדה	a v ɛ ɪ̯ d ə
אַבֿדהות	a v ɛ ɪ̯ d ɜ s
אָבֿל	ɔ v l̩
אַבֿלות	a v ɛ ɪ̯ l ɜ s
אָבֿלטע	ɔ v l̩ t ɜ
אָבֿלים	a v ɛ ɪ̯ ɫ ə m
אַבֿנימ־טובֿות	a v ɔ n ɪ m t ɔ ɪ̯ v ɜ s
אַבאַזשור	a b a ʒ u r
אַבוטילאָן	a b ʊ t ɪ l ɔ n
אַבי	a b i
אָביעקטיוו	ɔ b j ɜ k t ɪ v
אָבלאַווע	ɔ b l a v ɜ
אָבליגאַטאָריש	ɔ b l ɪ ɡ a t ɔ r ɪ ʃ
אָבליגאַציע	ɔ b l ɪ ɡ a t͡s j ɜ
אַבלמאָסק	a b l̩ m ɔ s k
אַבסאָלווענט	a b s ɔ l v ɛ n t
אַבסאָלוט	a b s ɔ l ʊ t
אַבסאָרבירונג	a b s ɔ r b ɪ r ʊ n ɡ
אַבסאָרבירן	a b s ɔ r b ɪ r n̩
אַבסורד	a b s ʊ r d
אָבסטעטריק	ɔ b s t ɛ t r ɪ k
אָבסטעטריקער	ɔ b s t ɛ t r ɪ k ɜ r
אַבסטראַהירן	a b s t r a h ɪ r n̩
אַבסטראַקציע	a b s t r a k t͡s j ɜ
אָבסטרויִרן	ɔ b s t r ʊ ɪ r n̩
אָבסטרוקציע	ɔ b s t r ʊ k t͡s j ɜ
אָבסערוואַטאָר	ɔ b s ɜ r v a t ɔ r
אָבסערוואַטאָריע	ɔ b s ɜ r v a t ɔ r j ɜ
אָבסערוואַציע	ɔ b s ɜ r v a t͡s j ɜ
אָבסערווירן	ɔ b s ɜ r v ɪ r n̩
אָבעזיאַנע	ɔ b ə z j a n ə
אַגאַווע	a ɡ a v ə
אַגאַפּאַנטוס	a ɡ a p a n t u s
אַגאַריק	a ɡ a r ɪ k
אַגבֿ	a ɡ ɜ v
אַגבֿדיק	a ɡ ɛ v d ɪ k
אַגיטאַציע	a ɡ ɪ t a t͡s j ɜ
אַגיטירן	a ɡ ɪ t ɪ r n̩
אַגענט	a ɡ ɛ n t
אַגענטור	a ɡ ɜ n t ʊ r
אָגער	ɔ ɡ ɜ r
אַגראַפֿקע	a ɡ r a f k ɜ
אַגרימאָניע	a ɡ r i m ɔ n j ə
אַגריקולטור	a ɡ r ɪ k ʊ l t ʊ r
אַגריקולטורעל	a ɡ r ɪ k ʊ l t ʊ r ɛ l
אַגרעס	a ɡ r ə s
אַגרעסיוו	a ɡ r ɜ s ɪ v
אַגרעסיע	a ɡ r ɛ s j ɜ
אַדאָפּטירונג	a d ɔ p t ɪ r ʊ n ɡ
אַדאָפּטירן	a d ɔ p t ɪ r n̩
אַדוואָקאַט	a d v ɔ k a t
אַדוואָקאַטנשאַפֿט	a d v o k a t n̩ ʃ a f t
אַדווערב	a d v ɛ r b
אַדורך	a d ʊ ʁ χ
אַדיעקטיוו	a d j ɜ k t ɪ v
אַדיקט	a d ɪ k t
אַדיקציע	a d ɪ k t͡s j ɜ
אַדל	a d l̩
אַדלדיק	a d l̩ d ɪ k
אַדליגע	a d l i ɡ ɜ
אַדלמאַן	a d l̩ m a n
אָדלער	ɔ d ɫ ə ʁ
אַדלפֿרוי	a d l̩ f r ɔ ɪ̯
אָדם	ɔ d ə m
אָדם	uː d ə m
אַדמיניסטראַטיוו	a d m ɪ n ɪ s t r a t ɪ v
אַדמיניסטראַציע	a d m ɪ n ɪ s t ʁ a t͡s j ə
אַדמיניסטרירן	a d m ɪ n ɪ s t r ɪ r n̩
אַדמיראַל	a d m ɪ r a l
אָדעקאָלאָן	ɔ d ɜ k ɔ l ɔ n
אַדעקוואַט	a d ɜ k v a t
אַדרבא	a d ə r a b ə
אַדרבא	a d ə r a b ə
אַדרעס	a d r ɛ s
אַדרעס	a d r ɛ s
אַדרעסאַט	a d r ɜ s a t
אַדרעסן	a d ʁ ɛ s n̩
אַדרעסן־בוך	a d r ɛ s n̩ b u χ
אַהאַ	a h a
אָהאָ	ɔ h ɔ
אַהבֿה	a a v ɜ
אַהיים	a h ɛ ɪ̯ m
אַהיימגיין	a h ɛ ɪ̯ m ɡ ɛ ɪ̯ n
אַהיימגעגאַנגען	a h ɛ ɪ̯ m ɡ ə ɡ a ŋ ɡ ə n
אַהיימלויפֿן	a h ɛ ɪ̯ m ɫ ɔ ɪ̯ f n̩
אַהין	a h ɪ n
אַהערגעקומען	a h ɛ ʁ ɡ ə k ʊ m ə n
אַהערקומען	a h ɛ ʁ k ʊ m ə n
אָוונט	ɔ v n̩ t
אַוועק	ə v ɛ k
אַזאַ	a z a
אַזאַן	a z a n
אַזעלכע	a z ɛ ɫ χ ə
אָזשענע	ɔ ʒ ə n ə
אַטלאַס	a t l a s
אַטמאָספֿער	a t m ɔ s f ɛ ʁ
אַכט	a χ t
אַלט	a ɫ t
אַלטע	a ɫ t ə
אָליוו	ɔ ʎ ɪ v
אַלע	a ɫ ə
אַמבאָס	a m b ɔ s
אַמבאַסאַדע	a m b a s a d ə
אַמט	a m t
אָמן	ɔ m ɛ ɪ̯ n
אָמן	ʊ m a ɪ̯ n
אַמנעזיע	a m n ɛ z j ə
אַמעריקאַניש	a m ɛ ʁ ɪ k a n ɪ ʃ
אַמעריקאַנישן	a m ɛ ʁ ɪ k a n ɪ ʃ n̩
אַמעריקאַנישע	a m ɛ ʁ ɪ k a n ɪ ʃ ə
אַמעריקע	a m ɛ ʁ ɪ k ə
אַמפֿאָראַ	a m f ɔ r a
אַן	a n
אָן	ɔ n
אָן	uː n
אָן	oː n
אָן	aː n
אַנאַנאַס	a n a n a s
אַנדער	a n d ə ʁ
אַנדערש	a n d ə ʁ ʃ
אָנהייב	ɔ n h ɛ ɪ̯ b
אָנהייבן	ɔ n h ɛ ɪ̯ b n̩
אַנומלט	a n ʊ m ɫ̩ t
אַנונג	a n ʊ ŋ ɡ
אָנטאָן	ɔ n t ɔ n
אַנטראָפּאָלאָגיסט	a n t r ɔ p ɔ l ɔ ɡ ɪ s t
אַנטראָפּאָלאָגיע	a n t r ɔ p ɔ l ɔ ɡ j ə
אַנטראָפּאָלאָגיש	a n t r ɔ p ɔ l ɔ ɡ ɪ ʃ
אַנטראָפּאָמאָרפֿיזם	a n t r ɔ p ɔ m ɔ r f i z m
אַנטשולדיק	a n t ʃ ʊ ɫ d ɪ k
אַנטשולדיקט	a n t ʃ ʊ ɫ d ɪ k t
אַנטשולדיקן	a n t ʃ ʊ ɫ d ɪ k n̩
אַנישט	a n ɪ ʃ t
אָנלאָדער	ɔ n ɫ ɔ d ə ʁ
אָנפֿירער	ɔ n f ɪ ʁ ə ʁ
אָנקומען	ɔ ŋ k ʊ m ə n
אָנרופֿן	ɔ n ʁ ʊ f n̩
אָנרירן	ɔ n ʁ ɪ ʁ n̩
אַסאָציִיִרן	a s ɔ t͡s ɪ ɪ ʁ n̩
אָפּ	ɔ p
אַפּאָלאָ	a p ɔ l ɔ
אָפּבײַסן	ɔ p b a ɪ̯ s n̩
אָפּגעביסן	ɔ p ɡ ə b ɪ s n̩
אָפּזאָגן	ɔ p z ɔ ɡ ŋ̩
אָפּלייג	ɔ p l ɛ ɪ̯ ɡ
אָפּלייגן	ɔ p ɫ ɛ ɪ̯ ɡ ŋ̩
אָפּלייגעכץ	ɔ p ɫ ɛ ɪ̯ ɡ ə χ t͡s
אָפּלייקענונג	ɔ p ɫ ɛ ɪ̯ k ə n ʊ ŋ ɡ
אָפּלייקענונג	u p ɫ a ɪ̯ k ə n i ŋ k
אַפּריל	a p ʁ ɪ ʎ
אַפּריקאָס	a p r ɪ k ɔ s
אָפּשטאַמלינג	ɔ p ʃ t a m ɫ ɪ ŋ ɡ
אָפּשיקער	ɔ p ʃ ɪ k ə ʁ
אָפּשיקערס	ɔ p ʃ ɪ k ə ʁ s
אַפֿילו	a f ɪ ɫ ə
אָפֿיס	ɔ f ɪ s
אָפֿיסן	ɔ f ɪ s n̩
אָפֿן	ɔ f n̩
אַפֿע	a f ə
אָפֿענעם	ɔ f ə n ə m
אַפֿראָדיטע	a f r ɔ d ɪ t ə
אַקאַציע	a k a t͡s j ə
אַקוואַריום	a k v a r j ʊ m
אַקסל	a k s ɫ̩
אַקצידענט	a k t͡s ɪ d ɛ n t
אַקצענט	a k t͡s ɛ n t
אָראַנזש	ɔ ʁ a n ʒ
אַראָפּגענומען	a ʁ ɔ p ɡ ə n ʊ m ə n
אַראָפּנעמען	a ʁ ɔ p n ɛ m ə n
אַראָפּפֿאַלן	a ʁ ɔ p f a ɫ n̩
אַרבעטסלאָז	a ʁ b ɛ t s l ɔ z
אַרבעס	a ʁ b ə s
אַרגענטינע	a ʁ ɡ ɛ n t ɪ n ə
אַרויסגאַנג	a ʁ ɔ ɪ̯ s ɡ a ŋ ɡ
אַרויסגיין	a ʁ ɔ ɪ̯ s ɡ ɛ ɪ̯ n
אַרויסגיין	a ʁ o ʊ̯ s ɡ a ɪ̯ n
אַרויסגעבן	a ʁ ɔ ɪ̯ s ɡ ɛ b n̩
אַרום	a ʁ ɔ m
אַרומגיין	a ʁ ʊ m ɡ ɛ ɪ̯ n
אַרט	a ʁ t
אָרט	ɔ ʁ t
אַריבערפֿאָרן	a ʁ i b ə ʁ f ɔ ʁ n̩
אַריטמעטיק	a r ɪ t m ɛ t ɪ k
אַריטמעטיש	a r ɪ t m ɛ t ɪ ʃ
אַריסטאָקראַטיע	a r ɪ s t ɔ k r a t j ə
אַרכעאָלאָגיע	a r χ ɛ ɔ l ɔ ɡ j ə
אַרמיי	a ʁ m ɛ ɪ̯
אַרמיי	a ʁ m e ɪ̯
אַרמיי	a ʁ m a ɪ̯
אָרעם	ɔ ʁ ə m
אָרעמקייט	ɔ ʁ ə m k a ɪ̯ t
אַרײַנגאַנג	a ʁ a ɪ̯ n ɡ a ŋ ɡ
אַרײַנגיין	a ʁ a ɪ̯ ŋ ɡ ɛ ɪ̯ n
אַרײַנזעצן	a ʁ a ɪ̯ n z ɛ t͡s n̩
אַשכּנזי	a ʃ k ə n a z i
אבֿיון	ɛ v j ɜ n
אבֿן־בוחן	ɜ v n̩ b ɔ ɪ̯ χ n̩
אבֿן־טובֿ	ɛ v n̩ t ɔ v
אבֿן־נגף	ɜ v n̩ n ɛ ɡ ɜ f
אדוני	a d ɔ ɪ̯ n a ɪ̯
אדמה	a d ɔ m ɜ
אוגערקע	ʊ ɡ ɛ ʁ k ə
אויג	ɔ ɪ̯ ɡ
אויג	oː ɡ
אויג	o ʊ̯ ɡ
אויוון	ɔ ɪ̯ v n̩
אויוונס	ɔ ɪ̯ v n̩ s
אויטאָמאַט	ɔ ɪ̯ t ɔ m a t
אויטאָנאָם	ɔ ɪ̯ t ɔ n ɔ m
אויטאָנאָמיע	ɔ ɪ̯ t ɔ n ɔ m j ɜ
אויטאָנאָמיש	ɔ ɪ̯ t ɔ n ɔ m ɪ ʃ
אויך	ɔ ɪ̯ χ
אויס־	ɔ ɪ̯ s
אויסברייטערן	ɔ ɪ̯ s b r ɛ ɪ̯ t ɜ r n̩
אויסגעלאָשן	ɔ ɪ̯ s ɡ ə ɫ ɔ ʃ n̩
אויסזען	ɔ ɪ s z ɛ n
אויסטראַליע	ɔ ɪ̯ s t ʁ a ʎ j ə
אויסלאַנד	ɔ ɪ̯ s ɫ a n d
אויסלענדיש	ɔ ɪ̯ s ɫ ɛ n d ɪ ʃ
אויסלענדער	ɔ ɪ̯ s ɫ ɛ n d ə ʁ
אויסלעשן	ɔ ɪ̯ s ɫ ɛ ʃ n̩
אויסניצן	ɔ ɪ̯ s n ɪ t͡s n̩
אויספֿאַלן	ɔ ɪ̯ s f a ɫ n̩
אויסשרײַבן	ɔ ɪ̯ s ʃ ʁ a ɪ̯ b n̩
אויער	ɔ ɪ ə ʁ
אויער	e ɪ ə ʁ
אויף	ɔ j f
אויף	a f
אויף	ɔ f
אויפֿגאַבע	ɔ ɪ̯ f ɡ a b ə
אויפֿגאַבע	a f ɡ a b ə
אויפֿגאַבע	ɔ f ɡ a b ə
אויפֿהערן	ɔ ɪ̯ f h ɛ ʁ n̩
אויפֿוועקן	ɔ ɪ̯ f v ɛ k ŋ̩
אויפֿוועקן	a f v ɛ k n̩
אויפֿוועקן	ɔ f v ɛ k n̩
אויפֿן	ɔ j f n̩
אויפֿן	a f n̩
אויפֿן	ɔ f n̩
אויפֿריכטן	ɔ ɪ̯ f ʁ ɪ χ t n̩
אויפֿשנײַדן	ɔ ɪ̯ f ʃ n a ɪ̯ d n̩
אויקען	ɔ ɪ̯ k ə n
אומבאַקאַנט	ʊ m b a k a n t
אומברענגען	ʊ m b ʁ ɛ ŋ ɡ ə n
אומזיסט	ʊ m z ɪ s t
אומפּינקטלעך	ʊ m p ɪ ŋ k t ɫ ə χ
אומפֿרײַנדלעך	ʊ m f ʁ a ɪ̯ n d ɫ ə χ
אומפֿרײַנדלעכע	ʊ m f ʁ a ɪ̯ n d ɫ ə χ ə
אונדזער	ʊ n d͡z ə ʁ
אונדזערע	ʊ n d͡z ə ʁ ə
אונטערהאַנדלען	ʊ n t ə ʁ h a n d ɫ ə n
אונטערהינקען	ʊ n t ə ʁ h ɪ ŋ k ə n
אונטערוועש	ʊ n t ə ʁ v ɛ ʃ
אונטערן	u n t ə ʁ n
אונטערצינדן	ʊ n t ə ʁ t͡s ɪ n d n̩
אונטערשטעלן	ʊ n t ə ʁ ʃ t ɛ ɫ n̩
אונץ	ʊ n t͡s
אורין	ʊ ʁ ɪ n
אורינירן	ʊ ʁ ɪ n ɪ ʁ n̩
איבערהאַקן	i b ə ʁ h a k ŋ̩
איבערזעצן	i b ə ʁ z ɛ t͡s n̩
איבערציִען	ɪ b ə ʁ t͡s ɪ ə n
איבערקוקן	i b ə ʁ k ʊ k ŋ̩
איבערקערן	i b ə ʁ k ɛ ʁ n̩
איבערשפּרײַזן	i b ə ʁ ʃ p ʁ a ɪ̯ z n̩
אידיאָט	ɪ d j ɔ t
אידעע	ɪ d ɛ ə
איז	i z
איי	ɛ ɪ̯
אייגנטום	ɛ ɪ ɡ n̩ t ʊ m
איידעם	ɛ ɪ̯ d ə m
אייל	ɛ ɪ̯ ɫ
איילבערט	ɛ ɪ̯ ɫ b ə ʁ t
איילבערט־אייל	ɛ ɪ̯ ɫ b ə ʁ t ɛ ɪ̯ ɫ
איינזאַם	ɛ ɪ n z a m
איינס	ɛ ɪ̯ n s
איינס	e ɪ̯ n s
איינס	a ɪ̯ n s
אייערנעכטן	ɛ ɪ̯ ə ʁ n ɛ x t ə n
איך	ɪ χ
אין גאַנצן	ɪ n ɡ a n t͡s n̩
אין מיטן	ɪ n m ɪ t n̩
אינדיווידואַליזירט	ɪ n d ɪ v ɪ d ʊ a ɫ ɪ z ɪ ʁ t
אינדיווידואַליזירן	ɪ n d ɪ v ɪ d ʊ a ɫ ɪ z ɪ ʁ n̩
אינדיק	i n d i k
אינטערנאַציאָנאַל	ɪ n t ə ʁ n a t͡s j ɔ n a ɫ
אינטערעסאַנט	ɪ n t ɛ ʁ ɛ s a n t
אינסעקט	ɪ n s ɛ k t
אינעווייניק	ɪ n ə v ɛ ɪ̯ n ɪ k
אינפֿאָרמאַציע	ɪ n f ɔ ʁ m a t͡s j ə
איצט	ɪ t͡s t
אם־ירצה־השם	ɪ m j ɪ ʁ t s ə a ʃ ɛ m
אם־ירצה־השם	m ɪ ʁ t s ə ʃ ɛ m
אם־ירצה־השם	m ɛ ʁ t ʃ ɛ m
אמת	ɛ m ə s
אפֿשר	ɛ f ʃ ə ʁ
אתרוג	ɛ s ʁ ə ɡ
אײַז	a ɪ̯ z
אײַז	aː z
אײַזקרעם	a ɪ̯ z k ʁ ɛ m
אײַך	a ɪ̯ χ
אײַן	a ɪ̯ n
אײַנגעמאַכטס	a ɪ̯ n ɡ ə m a χ t͡s
אײַנמאַכן	a ɪ̯ n m a χ n̩
אײַנקויפֿן	a ɪ̯ n k ɔ ɪ̯ f n̩
אײַנשרײַבן	a ɪ̯ n ʃ ʁ a ɪ̯ b n̩
אײַער	a ɪ̯ ə ʁ
באַאײַנפֿלוסונג	b a a ɪ̯ n f ɫ ʊ s ʊ ŋ ɡ
באַאײַנפֿלוסן	b a a ɪ̯ n f ɫ ʊ s n̩
באָבע־מעשׂה	b ɔ b ə m a ɪ s ə
באָבע־מעשׂה	b ʊ b ə m a n s ə
באָד	b ɔ d
באָד	b uː d
באָד	b u d
באָדן	b ɔ d n̩
באָדקאָסטום	b ɔ d k ɔ s t ʊ m
באָזשע מוי	b ɔ ʒ ə m ɔ ɪ̯
באַחנט	b a χ ɛ ɪ̯ n t
באַטעמט	b a t a m t
באַלאַגאַן	b a ɫ a ɡ a n
באַלד	b a ɫ d
באַלזאַם־יאָדלע	b a l z a m j ɔ d l ə
באַלקאָן	b a ɫ k ɔ n
באַן	b a n
באַנאַנע	b a n a n ə
באַנק	b a ŋ k
באַצאָל	b a t͡s a ɫ
באַקאַנט	b a k a n t
באַקום	b a k ʊ m
באַקומט	b a k ʊ m t
באַקומען	b a k ʊ m ə n
באַקומער	b a k ʊ m ə ʁ
באַקומערס	b a k ʊ m ə ʁ s
באַקן	b a k n̩
באַריכט	b a r ɪ χ t
באַרן	b a ʁ n̩
באַשטעלונג	b a ʃ t ɛ ɫ ʊ ŋ ɡ
באַשטעלט	b a ʃ t ɛ ɫ t
באַשטעלן	b a ʃ t ɛ ɫ n̩
באַשיידן	b a ʃ ɛ ɪ̯ d n̩
באַשמוצן	b a ʃ m ʊ t͡s n̩
באַשרײַבונג	b a ʃ r a ɪ̯ b ʊ n ɡ
באַשרײַבונג	b a ʃ r aː b ɪ n ɡ
בדלות	b ə d a ɫ ə s
בהמה	b ə h ɛ ɪ̯ m ə
בוהײַ	b u h a ɪ̯
בוים	b ɔ ɪ̯ m
בחינם	b ə χ i n ə m
בטחון	b ə t ɔ χ n̩
ביאָלאָגיע	b j ɔ ɫ ɔ ɡ j ə
ביאַלי	b j a ɫ ɪ
ביבל	b ɪ b ɫ̩
ביבליאָטעק	b ɪ b ʎ j ɔ t ɛ k
ביוראָ	b j ʊ ʁ ɔ
ביטע	b ɪ t ə
בייגל	b ɛ ɪ̯ ɡ ɫ̩
בייגל	b a ɪ̯ ɡ ɫ̩
ביידע	b ɛ ɪ̯ d ə
בייז	b ɛ ɪ̯ z
ביליק	b ɪ ɫ ɪ k
בילעט	b ɪ ʎ ɛ t
בין	b ɪ n
ביציקל	b ɪ t͡s ɪ k ɫ̩
ביקס	b ɪ k s
ביר	b ɪ ʁ
בית	b ɛ ɪ̯ s
בית	b a ɪ̯ s
בית המקדש	b ɛ ɪ s h a m ɪ k d ɜ ʃ
בית־הכּסא	b ɛ ɪ̯ s h a k ɪ s ə
בית־עולם	b ɛ ɪ̯ s ɔ ɪ̯ ɫ ə m
בכלל	b ɪ χ ɫ a ɫ
בלאָבלאַט־אַקאַציע	b l ɔ b l a t a k a t͡s j ə
בלאַט	b ɫ a t
בלאָע יאָדלע	b l ɔ ə j ɔ d l ə
בלוט	b ɫ ʊ t
בלוט	b ɫ uː t
בלוט	b ɫ iː t
בלוט	b ɫ ɨ t
בלוי	b ɫ ɔ ɪ̯
בלוי	b ɫ ɔ
בלוי	b ɫ oː
בלוי	b ɫ o ʊ̯
בלוי	b ɫ o ʊ̯
בלוי	b ɫ ɔ ɪ̯
בלום	b ɫ ʊ m
בליץ	b ʎ ɪ t͡s
בליצבריוו	b ʎ ɪ t͡s b ʁ ɪ v
בלעטל	b ɫ ɛ t ɫ̩
בלײַב	b ɫ a ɪ̯ b
בלײַבן	b ɫ a ɪ̯ b n̩
בנין	b ɪ n j ə n
בנינים	b ɪ n j ɔ n ɪ m
בעבל	b ɛ b ɫ̩
בעט	b ɛ t
בעט	b ɛ ɪ̯ t
בעט	b i t
בעטן	b ɛ t n̩
בעטן	b ɛ ɪ̯ t n̩
בעטן	b i t n̩
בעטן	b ɛ t n̩
בעכער	b ɛ χ ɛ ɾ
בעל־הבית	b a ɫ ə b ɔ s
בעל־תּשובֿה	b a ɫ t͡ʃ ʊ v ə
בעלי־בתּים	b a ɫ ə b a t ə m
בענק	b ɛ ŋ k
בענקל	b ɛ ŋ k ɫ̩
בענקלעך	b ɛ ŋ k ɫ ə x
בעסער	b ɛ s ə ʁ
בעקן	b ɛ k ŋ̩
בערן	b ɛ ʁ n̩
בר־מיצווה	b a ʁ m ɪ t͡s v ə
ברודער	b ʁ ʊ d ə ʁ
ברודער	b r ʊ d ə r
ברודער	b r ɪ d ə r
ברויט	b r ɔ ɪ̯ t
ברוין	b ʁ ɔ ɪ̯ n
ברוין	b ʁ o ʊ̯ n
ברוך	b ɔ ʁ ə χ
ברוך־הבא	b ɔ r ə χ a b ə
ברוך־הבא	b ɔ r ə χ a b ɔ
ברוך־הבא	b ʊ r ə χ a b ʊ
ברוכים־הבאָים	b ʁ ʊ χ ɪ m h a b ɔ ɪ m
בריוון	b ʁ ɪ v n̩
ברייט	b r ɛ ɪ̯ t
ברייטער	b r ɛ ɪ̯ t ɜ r
ברילן	b ʁ ɪ ɫ n̩
ברענגען	b ʁ ɛ ŋ ɡ ə n
בשעת	b ə ʃ a s
בשעת	b ə ʃ aː s
בת־מיצווה	b a s m ɪ t͡s v ə
בײַטאָג	b a ɪ̯ t ɔ ɡ
בײַנאַכט	b a ɪ̯ n a χ t
בײַסט	b a ɪ̯ s t
בײַסן	b a ɪ̯ s n̩
בײַקומען	b a ɪ̯ k ʊ m ə n
גאָון	ɡ ɔ ə n
גאָון	ɡ u ə n
גאַלאָן	ɡ a ɫ ɔ n
גאָלד	ɡ ɔ ɫ d
גאַנדז	ɡ a n d z
גאַנדז	ɡ a n t s
גאַנדז	ɡ ɔ n d z
גאַנץ	ɡ a n t͡s
גאַס	ɡ a s
גאַסט	ɡ a s t
גאָפּל	ɡ ɔ p ɫ̩
גאַרטל	ɡ a ʁ t ɫ̩
גאָרן	ɡ ɔ ʁ n
גאונים	ɡ ə ɔ ɪ n ə m
גאונים	ɡ ə ɛ ɪ n ə m
גאונים	ɡ ə ɔ ɪ n ə m
גולם	ɡ ɔ ɪ̯ l ə m
גזלעווויע	ɡ a z ɫ ə v ɔ ɪ̯ ə
גיב	ɡ ɪ b
גיטאַר	ɡ ɪ t a ʁ
גיי	ɡ ɛ ɪ̯
גיי נאָך	ɡ ɛ ɪ̯ n ɔ χ
גיין	ɡ ɛ ɪ̯ n
גיליאָטין	ɡ ɪ ʎ j ɔ t ɪ n
גיריק	ɡ ɪ r ɪ k
גלאָז	ɡ ɫ ɔ z
גלח	ɡ a ɫ ə χ
גלײַך	ɡ ɫ a ɪ̯ χ
גלײַך	ɡ ɫ aː χ
גם־אתּם	ɡ a m a t ə m
גנבֿענען	ɡ a n v ɛ n ɛ n
געבורטסטאָג	ɡ ə b ʊ ʁ t s t ɔ ɡ
געבליבן	ɡ ə b ʎ ɪ b n̩
געבן	ɡ ɛ b n̩
געבן	ɡ e ɪ̯ b n̩
געבעטן	ɡ ə b ɛ t n̩
געגאַנגען	ɡ ə ɡ a ŋ ɡ ə n
געגעבן	ɡ ə ɡ ɛ b n̩
געגעסן	ɡ ə ɡ ɛ s n̩
געדויערן	ɡ ə d ɔ ɪ̯ ə ʁ n
געדויערן	ɡ ə d o ʊ̯ ə ʁ n
געהילף	ɡ ə h ɪ ɫ f
געהילפֿן	ɡ ə h ɪ ɫ f n̩
געהערן	ɡ ə h ɛ ʁ n̩
געוואַרט	ɡ ə v a ʁ t
געוויס	ɡ ə v ɪ s
געוויקס	ɡ ə v ɪ k s
געווען	ɡ ə v ɛ n
געווען	ɡ ə v eː n
געווען	ɡ ə v e ɪ̯ n
געווער	ɡ ɜ v ɛ r
געזאָגט	ɡ ə z ɔ k t
געטאָן	ɡ ə t ɔ n
געטראַנק	ɡ ə t ʁ a ŋ k
געטראַנקן	ɡ ə t ʁ a ŋ k n̩
געלאָפֿן	ɡ ə ɫ ɔ f n̩
געלב	ɡ ɛ ɫ b
געלייגט	ɡ ə ɫ ɛ ɪ̯ k t
געלינקט	ɡ ə ʎ ɪ ŋ k t
געלעבט	ɡ ə ɫ ɛ p t
גענדזל	ɡ ɛ n d͡z ɫ̩
גענומען	ɡ ə n ʊ m ə n
געסט	ɡ ɛ s t
געפּלאַנט	ɡ ə p l a n t
געפֿונען	ɡ ə f ʊ n ə n
געפֿילטע פֿיש	ɡ ə f ɪ ɫ t ə f ɪ ʃ
געפֿערלעך	ɡ ə f ɛ ʁ ɫ ə χ
געקענט	ɡ ə k ɛ n t
גערעגנט	ɡ ə ʁ ɛ ɡ n̩ t
געשטאַלט	ɡ ə ʃ t a ɫ t
געשטאָרבן	ɡ ə ʃ t ɔ ʁ b n̩
געשטונקען	ɡ ə ʃ t ʊ ŋ k ə n
געשיכטע	ɡ ə ʃ ɪ χ t ə
געשמאַק	ɡ ə ʃ m a k
געשמאַקע	ɡ ə ʃ m a k ə
געשנייט	ɡ ə ʃ n ɛ ɪ̯ t
געשעפֿט	ɡ ə ʃ ɛ f t
געשײַנט	ɡ ə ʃ a ɪ̯ n t
גראַד	ɡ ʁ a d
גראָד	ɡ ʁ ɔ d
גראַמאַטיק	ɡ ʁ a m a t ɪ k
גרוי	ɡ ʁ ɔ ɪ̯
גרוי	ɡ ʁ ɔ
גרוי	ɡ ʁ o ʊ̯
גרוי	ɡ ʁ oː
גרוי	ɡ ʁ o ʊ̯
גרוי	ɡ ʁ ɔ ɪ̯
גרויס	ɡ r ɔ ɪ̯ s
גרויסע	ɡ ʁ ɔ ɪ̯ s ə
גריכיש	ɡ ʁ ɪ χ ɪ ʃ
גרין	ɡ ʁ ɪ n
גרין	ɡ ʁ iː n
גרינג	ɡ ʁ ɪ ŋ ɡ
גרינגער	ɡ ʁ ɪ ŋ ɡ ə ʁ
גרעסער	ɡ ʁ ɛ s ə ʁ
דאָ	d ɔ
דאָ	d ʊ
דאַוונען	d a v n ə n
דאַוונען	d ɔ v n ə n
דאַוונען	d ɔ ɪ n ə n
דאָיִקייט	d ɔ ɪ k a ɪ̯ t
דאַך	d a χ
דאָלאַר	d ɔ ɫ a ʁ
דאָלוי	d ɔ ɫ ɔ ɪ̯
דאָליע	d ɔ ɫ j ə
דאָרט	d ɔ ʁ t
דאַרף	d a ʁ f
דאַרפֿן	d a ʁ f n̩
דאַרפֿסט	d a ʁ f s t
דאָרשטיק	d ɔ ʁ ʃ t ɪ k
דו	d ʊ
דו	d uː
דו	d iː
דו	d ɨ
דויערן	d ɔ ɪ̯ ə ʁ n
דויערן	d o ʊ̯ ə ʁ n
דורך	d ʊ ʁ χ
דורכרײַסן	d ʊ ʁ χ ʁ a ɪ̯ s n̩
דזשוכע	d͡ʒ ʊ χ ə
דזשינס	d͡ʒ i n s
דיבוק	d ɪ b ə k
דיין	d a ɪ̯ ə n
דיין	d a ɪ̯ n
דין	d ɪ n
דינגען	d ɪ ŋ ɡ ə n
דירה	d ɪ ʁ ə
דירה־געלט	d ɪ ʁ ə ɡ ɛ ɫ t
דירהלע	d ɪ ʁ ə ɫ ə
דלות	d a ɫ ə s
דעסערט	d ɛ s ɛ ʁ t
דעקל	d ɛ k ɫ̩
דערוואַקסענע	d ə ʁ v a k s ə n ə
דערוואַקסענעם	d ə ʁ v a k s ə n ə m
דערוואַקסענער	d ə ʁ v a k s ə n ə ʁ
דערציילער	d ɛ ʁ t͡s ɛ ɪ̯ ɫ ə ʁ
דערקלערן	d ɛ ʁ k l ɛ ʁ n̩
דערשײַנונג	d ɛ ʁ ʃ a ɪ̯ n ʊ ŋ ɡ
דרויסן	d ʁ ɔ ɪ̯ s n̩
דרום	d ɔ ʁ ə m
דרומדיק	d ɔ r ə m d i k
דרומדיק	d uː r ə m d i k
דריט	d ʁ ɪ t
דריי	d ʁ ɛ ɪ̯
דריי	d ʁ a ɪ̯
דריידל	d ʁ ɛ ɪ̯ d ɫ̩
דרך־ארץ	d ɛ r ə χ ɛ r ə t͡s
דרך־ארץ	d ɛ r ə χ ɛ r i t͡s
דרך־ארץ	d a r χ e ɪ r ə t͡s
דרײַ	d ʁ a j
דרײַסיק	d ʁ a ɪ̯ s ɪ k
דרײַסיק	d ʁ aː s ɪ k
דרײַסיקסט	d ʁ a ɪ̯ s ɪ k s t
דרײַצן	d ʁ a ɪ̯ t͡s n̩
דרײַצן	d ʁ aː t͡s n̩
דײַטשלאַנד	d a ɪ̯ t ʃ ɫ a n d
דײַנע	d a ɪ̯ n ə
האַביכט	h a b ɪ χ t
האַלדז	h a ɫ d͡z
האָן	h ɔ n
האַנטביכל	h a n t b ɪ χ ɫ̩
האַנטעך	h a n t ə χ
האַנטעכער	h a n t ə χ ə ʁ
האַנטשריפֿט	h a n t ʃ r ɪ f t
האָניק	h ɔ n ɪ k
האָף	h ɔ f
האָפֿן	h ɔ f n̩
האָפֿנטלעך	h ɔ f n̩ t l ə χ
האָפֿסט	h ɔ f s t
הויז	h ɔ ɪ̯ z
הויך	h ɔ ɪ̯ χ
הויך	h ɔ ɪ̯ ə χ
הויפּט	h ɛ ɪ̯ p t
הויפּט	h ɔ ɪ̯ p t
הון	h ʊ n
הונדערט	h ʊ n d ə ʁ t
הונדערט	h ɪ n d ə ʁ t
הונדערט	h ɨ n d ə ʁ t
הונט	h ʊ n t
הונט	h ɪ n t
הורג	h ɔ ɪ r ə ɡ
הורג	h e ɪ r ə ɡ
הורג	h ɛ ɪ r ə ɡ
היטן	h ɪ t n̩
הייבט אָן	h ɛ ɪ̯ p t ɔ n
היילער	h ɛ ɪ̯ ɫ ə ʁ
היים	h ɛ ɪ̯ m
הייס	h ɛ ɪ̯ s
הייס	h e ɪ̯ s
הייס	h a ɪ̯ s
הייסט	h ɛ ɪ̯ s t
הייסן	h ɛ ɪ̯ s n̩
הייצונג	h ɛ ɪ̯ t͡s ʊ ŋ ɡ
הימל	h ɪ m ɫ̩
הינדל	h ɪ n d ɫ̩
הינט	h ɪ n t
הינטעלע	h ɪ n t ə ɫ ə
הינטער	h ɪ n t ə ʁ
הלכה	h a ɫ ɔ χ ə
המן־טאַשן	h ɔ m ə n t a ʃ n̩
המן־טאַשן	h ɔ m ə n t a ʃ n̩
המן־טאַשן	h ɔ m ə n t a s n̩
המן־טאַשן	h ɔ m ə n t ə s
העברעיִש	h ɛ b ʁ ɛ ɪ ʃ
העברעיִשע	h ɛ b ʁ ɛ ɪ ʃ ə
העלדישע יאָדלע	h ɛ l d ɪ ʃ ə j ɔ d l ə
העלפֿאַנד	h ɛ l f a n d
העלפֿאַנדן	h ɛ l f a n d n̩
העלפֿט	h ɛ ɫ f t
הענג	h ɛ ŋ ɡ
הענגען	h ɛ ŋ ɡ ə n
העפֿטיק	h ɛ f t ɪ k
הערצאָג	h ɛ ʁ t͡s ɔ ɡ
הצלחה און ברכה	h a t͡s ɫ ɔ χ ə ʊ n b ʁ ɔ χ ə
הצלחה און ברכה	h a t͡s ɫ uː χ ə ɪ n b ʁ uː χ ə
השם	h a ʃ ɛ m
הײַיאָר	h a ɪ̯ j ɔ ʁ
הײַנט	h a ɪ̯ n t
הײַנט	h aː n t
הײַפֿיש	h a ɪ̯ f ɪ ʃ
הײַפֿיש	h aː f ɪ ʃ
וואָגן	v ɔ ɡ ŋ̩
וואָגן	v ʊ ɡ ŋ̩
וואַזע	v a z ə
וואַטשן	v a t͡ʃ n̩
וואָך	v ɔ χ
וואָלט	v ɔ ɫ t
וואַלפֿיש	v a ɫ f ɪ ʃ
וואָלקן	v ɔ l k n̩
וואָלקן־קראַצער	v ɔ ɫ k n̩ k ʁ a t͡s ə ʁ
וואָלקנס	v ɔ l k n̩ s
וואַנע	v a n ə
וואַסער	v a s ə ʁ
וואָקאַבולאַר	v ɔ k a b ʊ ɫ a r
וואַקסן	v a k s n̩
וואַקצין	v a k t͡s ɪ n
וואַרטן	v a ʁ t n̩
וואַרטסט	v a ʁ t s t
וואַש	v a ʃ
וואַשבעקן	v a ʃ b ɛ k ŋ̩
וואַשן	v a ʃ n̩
וואַשצימער	v a ʃ t͡s ɪ m ə ʁ
וווּ	v ʊ
וווּ	v ɪ
וווּהין	v ʊ h ɪ n
וווּנדער	v ʊ n d ə ʁ
וווּנדערלעך	v ʊ n d ə ʁ ɫ ə χ
וווּנדערלעכע	v ʊ n d ə ʁ ɫ ə χ ə
וווּרשטל	v ʊ ʁ ʃ t l̩
וווּרשטל	v ɪ ʁ ʃ t ɫ̩
וווינען	v ɔ j n ə n
ווי	v ɪ
ווי אַזוי	v i a z ɔ ɪ
ווי אַזוי	v j a z ɔ ɪ
וויי	v ɛ ɪ̯
ווייניקער	v ɛ ɪ̯ n ɪ k ə ʁ
וויכטיקייט	v ɪ χ t ɪ k a ɪ̯ t
וויל	v ɪ ɫ
ווילד	v ɪ ɫ d
ווילדע	v ɪ ɫ d ə
ווינט	v ɪ n t
וויִע	v i ə
וויפֿל	v ɪ f ɫ̩
וולד	v ɫ a d
וועג	v ɛ ɡ
וועג	v eː ɡ
וועג	v e ɪ̯ ɡ
וועגווײַזער	v ɛ ɡ v a ɪ̯ z ə ʁ
וועגן	v ɛ ɡ ŋ̩
וועגן	v e ɪ̯ ɡ ŋ̩
וועגן	v eː ɡ ŋ̩
וועטער	v ɛ t ə ʁ
וועטשערע	v ɛ t͡ʃ ə ʁ ə
וועלט	v ɛ ɫ t
וועלן	v ɛ ɫ n̩
וועספּ	v ɛ s p
וועקער	v ɛ k ə ʁ
ווערטער	v ɛ ʁ t ə ʁ
ווײַב	v a ɪ̯ b
ווײַב	v aː b
ווײַבערשול	v a ɪ̯ b ə ʁ ʃ ʊ ɫ
ווײַבערשול	v aː b ə ʁ ʃ ɪ ɫ
ווײַן	v a ɪ̯ n
ווײַס	v a ɪ̯ s
ווײַס	v aː s
ווײַסיאָדלע	v a ɪ̯ s j ɔ d l ə
ווײַסע	v a ɪ̯ s ə
ווײַסער	v a ɪ̯ s ə ʁ
ווײַסצווײַג־אַקאַציע	v a ɪ̯ s t͡s v a ɪ̯ ɡ a k a t͡s j ə
ויטאָבוס	ɔ ɪ̯ t ɔ b ʊ s
זאָגן	z ɔ ɡ ŋ̩
זאָגן	z uː ɡ ŋ̩
זאָגן	z u ɡ ŋ̩
זאַכן	z a χ n̩
זאַלץ	z a ɫ t͡s
זאַלציק	z a ɫ t͡s ɪ k
זאַץ	z a t͡s
זאַק	z a k
זאָקן	z ɔ k n̩
זויבער	z ɔ ɪ̯ b ə ʁ
זוימען	z ɔ ɪ̯ m n̩
זוימען	z ɛ ɪ̯ m n̩
זויער	z ɔ ɪ̯ ə ʁ
זויפֿן	z ɔ ɪ̯ f n̩
זוך	z ʊ χ
זוכט	z ʊ χ t
זוכן	z ʊ χ n̩
זומער	z ʊ m ə ʁ
זומערהויז	z ʊ m ə ʁ h ɔ ɪ̯ z
זוניק	z ʊ n ɪ k
זוניקער	z ʊ n ɪ k ə ʁ
זופּ	z ʊ p
זיבן	z ɪ b n̩
זיבעט	z ɪ b ə t
זיבעטע	z ɪ b ə t ə
זיבעטער	z ɪ b ə t ə ʁ
זיבעציק	z ɪ b ə t͡s ɪ k
זיבעצן	z ɪ b ə t͡s n̩
זיידע	z ɛ ɪ̯ d ə
זיידעס	z ɛ ɪ̯ d ə s
זייער	z ɛ ɪ̯ ə r
זייער	z a ɪ̯ ə r
זילבער־אַקאַציע	z ɪ l b ə r a k a t͡s j ə
זינגען	z ɪ n ɡ n̩
זינד	z ɪ n d
זיס	z ɪ s
זיץ	z ɪ t͡s
זיצן	z ɪ t͡s n̩
זמן	z m a n
זעברע	z ɛ b ʁ ə
זעברעס	z ɛ b ʁ ə s
זעכציק	z ɛ χ t͡s ɪ k
זעכצן	z ɛ χ t͡s n̩
זעלבסטמאָרד	z ɛ l b s t m ɔ r d
זעלבשטענדיק	z ɛ ɫ b ʃ t ɛ n d ɪ k
זעלטן	z ɛ ɫ t n̩
זעמל	z ɛ m ɫ̩
זען	z ɛ n
זען	z eː n
זען	z e ɪ̯ n
זענען	z ɛ n ə n
זעסט אויס	z ɛ s t ɔ ɪ̯ s
זעצט	z ɛ t͡s t
זעצן	z ɛ t͡s n̩
זעקס	z ɛ k s
זעקסט	z ɛ k s t
זעקסטע	z ɛ k s t ə
זקן	z ɔ k n̩
זשאַווער	ʒ a v ə ʁ
זשיראַף	ʒ ɪ ʁ a f
זשיראַפֿן	ʒ ɪ ʁ a f n̩
זשלאָב	ʒ ɫ ɔ b
זײַ	z a ɪ̯
זײַט	z a ɪ̯ t
זײַט	z aː t
זײַן	z a ɪ̯ n
זײַן	z aː n
זײַנע	z a ɪ̯ n ə
חבֿר	χ a v ə r
חבֿרטע	χ a v ə ʁ t ə
חדשים	χ a d ɔ ʃ ɪ m
חודש	χ ɔ ɪ̯ d ə ʃ
חודש	χ ɛ ɪ̯ d ə ʃ
חוצפּה	χ ʊ t͡s p ə
חוצפּה	χ ɪ t͡s p ə
חורבן	χ ʊ r b m̩
חורבן	χ ɪ r b m̩
חושד זײַן	χ ɔ ɪ̯ ʃ ə d z a ɪ̯ n
חזירים	χ a z ɪ ʁ ə m
חיה	χ a ɪ̯ ə
חיות	χ ɪ j ə s
חיות	χ a ɪ̯ ə s
חלה	χ a ɫ ə
חלות	χ a ɫ ə s
חלל	χ ɔ ɫ ə ɫ
חלק	χ ɛ ɪ̯ ɫ ə k
חנוכּה	χ a n ə k ə
חס־ושלום	χ a s v ə ʃ ɔ ɫ ə m
חשבון	χ ɛ ʃ b n̩
חשבונות	χ ɛ ʒ b ɔ ɪ n ə s
חשובֿ	χ ɔ ʃ ə v
חתונה	χ a s ə n ə
חתן	χ ɔ s n̩
טאָג	t ɔ ɡ
טאָג	t uː ɡ
טאָג	t u ɡ
טאָג־טעגלעך	t ɔ ɡ t ɛ ɡ ɫ ə χ
טאַדזשיקיסטאַן	t a d͡ʒ ɪ k ɪ s t a n
טאָוול	t ɔ v l̩
טאַנטע	t a n t ə
טאַנצן	t a n t͡s n̩
טאָפּ	t ɔ p
טאַץ	t a t͡s
טאַקסי	t a k s i
טאַש	t a ʃ
טויב	t ɔ ɪ b
טויב	t e ɪ b
טויב	t ɔ ɪ b
טויב	t o ʊ b
טויזנט	t ɔ ɪ̯ z n̩ t
טויזנט	t o ʊ̯ z n̩ t
טויט	t ɔ ɪ̯ t
טוך	t ʊ χ
טון	t iː n
טונקל	t ʊ ŋ k l̩
טוץ	t u t͡s
טוצן	t u t͡s n̩
טוריסט	t ʊ ʁ ɪ s t
טוריסטן	t ʊ ʁ ɪ s t n̩
טורעם	t ʊ ʁ ə m
טיגער	t ɪ ɡ ə ʁ
טייל	t ɛ ɪ̯ ɫ
טיילן	t ɛ ɪ̯ ɫ n̩
טיף	t ɪ f
טיפּ	t ɪ p
טיפּאָגראַפֿיע	t ɪ p ɔ ɡ r a f j ə
טיפּאָגראַפֿיש	t ɪ p ɔ ɡ r a f ɪ ʃ
טיפּיש	t ɪ p ɪ ʃ
טיפּישע	t ɪ p ɪ ʃ ə
טיפּש	t ɪ p ə ʃ
טישטעך	t ɪ ʃ t ə χ
טעג	t ɛ ɡ
טעגלעך	t ɛ ɡ ɫ ə χ
טעות	t ɔ ə s
טעלעוויזאָר	t ɛ ʎ ɛ v ɪ z ɔ ʁ
טעלעפֿאָניר	t ɛ l ɛ f ɔ n ɪ ʁ
טעלעפֿאָנירן	t ɛ l ɛ f ɔ n ɪ ʁ n̩
טעלעפּאָרטירן	t ə l ə p ɔ ʁ t i ʁ n̩
טענענבוים	t ɛ n ə n b ɔ ɪ̯ m
טעפּ	t ɛ p
טעפּל	t ɛ p ɫ̩
טעפּעך	t ɛ p ə χ
טערק	t ɛ ʁ k
טראָן	t ʁ ɔ n
טרויבנזאַפֿט	t ʁ ɔ ɪ̯ b n̩ z a f t
טרויעריק	t ʁ ɔ ɪ̯ ə ʁ ɪ k
טרוקן	t ʁ ʊ k n̩
טריומף	t ʁ j ʊ m f
טריומף	t ʁ ɪ ʊ m f
טרייף	t ʁ ɛ ɪ̯ f
טרינק	t ʁ ɪ ŋ k
טרינקט	t ʁ ɪ ŋ k t
טרינקען	t ʁ ɪ ŋ k ə n
טרעפּ	t ʁ ɛ p
טשאָלנט	t͡ʃ ɔ ɫ ə n t
טשאָלנט	t͡ʃ uː ɫ ə n t
טשאָלנט	t͡ʃ u ɫ ə n t
טשיק טשאַק	t͡ʃ i k t͡ʃ a k
טשערעפּאַכע	t͡ʃ ɛ ʁ ə p a χ ə
טשײַניק	t ʃ a ɪ̯ n ɪ k
יאָדלע	j ɔ d l ə
יאַנואַר	j a n ʊ a ʁ
יום	j ɔ m
יום־כּיפּור	j ɔ ŋ k ɪ p ə r
יונג	j ʊ ŋ ɡ
יונג	j ɪ ŋ ɡ
יונגערמאַן	j ʊ ŋ ɡ ə ʁ m a n
יוסי	j ɔ s i
יוסף	j ɔ s ə f
יוסף	j ɔ ɪ̯ s ə f
ייִאוש	j ɪ ə ʃ
ייִד	j ɪ d
ייִד	j i d
ייִד	j iː t
ייִדיש	j ɪ d ɪ ʃ
ייִדישע	j ɪ d ɪ ʃ ə
ייִדישע גאַס	j ɪ d ɪ ʃ ə ɡ a s
ייִדישער	j ɪ d ɪ ʃ ə ʁ
ייִדישקייט	j ɪ d ɪ ʃ k a j t
ייִחוס	j ɪ χ ə s
ייִנגל	j ɪ ŋ ɡ ɫ̩
ייִנגער	j ɪ ŋ ɡ ə ʁ
ימח־שמוניק	j ɪ m a χ ʃ m ɔ ɪ n ɪ k
ימח־שמוניק	j ɪ m a χ ʃ m e ɪ n ɪ k
יעדן טאָג	j ɛ d n̩ t ɔ ɡ
יעדעס	j ɛ d ə s
יעדער	j ɛ d ə ʁ
יענס	j ɛ n s
יענע	j ɛ n ə
יענער	j ɛ n ə ʁ
יעצט	j ɛ t͡s t
יעקבֿ	j a ŋ k ə v
ירושלים	j ə r ʊ ʃ ɔ ɫ a j ə m
ירושלים	j ə r ɪ ʃ ʊ ɫ a j ə m
ישׂראל	j ɪ s ʀ ɔ ə l
ישׂראל	j ɪ s r uː l
ישׂראלדיק	j i s ʁ ɔ ə l d ɪ k
ישׂראלדיקע	j i s ʁ ɔ ə l d ɪ k
ישו	j ɛ ɪ̯ ʃ ʊ
ישו	j ɪ ʃ ʊ
כאָטש	χ ɔ t͡ʃ
כאַפּן	χ a p n̩
כּבֿוד	k ɔ v ə d
כּבֿוד	k ʊ v ə d
כּדי	k ə d ɛ ɪ̯
כּהונה	k ə h ʊ n ə
כּהונה	k ə h ɪ n ə
כּהונה	k ə h ɨ n ə
כּהן	k ɔ ɪ̯ ə n
כּוס	k ɔ s
כּישוף	k ɪ ʃ ə f
כּיתּה	k ɪ t ə
כּיתּות	k ɪ t ə s
כּלבֿ	k ɛ ɫ ə v
כּלבֿ	k e ɪ̯ ɫ ə v
כּלבֿטע	k ɫ a f t ə
כּמעט	k ɪ m a t
כּסדר	k ə s ɛ ɪ̯ d ə ʁ
כּסדרדיק	k ə s ɛ ɪ̯ d ə ʁ d ɪ k
כּשר	k ɔ ʃ ə ʁ
כּתובה	k s ʊ b ə
כינע	χ ɪ n ə
כינעזיש	x ɪ n ɛ z ɪ ʃ
כינעזישער	x ɪ n ɛ z ɪ ʃ ə ʁ
כעמיע	χ ɛ m j ə
לאַדינאָ	ɫ a d ɪ n ɔ
לאָזט	ɫ ɔ s t
לאָזן	ɫ ɔ z n̩
לאָזסט	ɫ ɔ s t
לאַטקע	ɫ a t k ə
לאַטקעס	ɫ a t k ə s
לאַכט	ɫ a χ t
לאַכן	ɫ a χ n̩
לאָמיך	ɫ ɔ m ɪ χ
לאָמיר	ɫ ɔ m ɪ ʁ
לאַנג	ɫ a ŋ ɡ
לאַנג	ɫ a ɪ̯ ŋ ɡ
לאַנדן	ɫ a n d n̩
לאָנטש	ɫ ɔ n t͡ʃ
לאָקש	ɫ ɔ k ʃ
לבֿנה	l ɛ v ɔ n ə
לויף	ɫ ɔ ɪ̯ f
לויפֿן	ɫ ɔ ɪ̯ f n̩
לויפֿן	ɫ e ɪ̯ f n̩
לופֿטמענטש	ɫ ʊ f t m ɛ n t͡ʃ
ליב	ʎ ɪ b
ליבן	ʎ i b n̩
ליבער	l ɪ b ə r
ליבערשט	ʎ ɪ b ə ʁ ʃ t
ליגט	ʎ ɪ k t
ליד	l ɪ d
ליד	l iː t
ליטווינער	ʎ ɪ t v ɪ n ə ʁ
ליטוויש	ɫ ɪ t v ɪ ʃ
לייב	ɫ ɛ ɪ̯ b
לייב	ɫ a ɪ̯ b
לייבן	ɫ ɛ ɪ̯ b n̩
לייג	ɫ ɛ ɪ̯ ɡ
לייגט	ɫ ɛ ɪ̯ k t
לייגן	ɫ ɛ ɪ̯ ɡ n̩
לייוואָרט	ɫ ɛ ɪ̯ v ɔ ʁ t
לייען	ɫ ɛ ɪ̯ ə n
לייענען	ɫ ɛ ɪ̯ ə n ə n
ליכט	ʎ ɪ χ t
לינק	ɫ ɪ ŋ k
לינקס	ɫ ɪ ŋ k s
ליפֿט	ʎ ɪ f t
ליפֿטן	ʎ ɪ f t n̩
לכּבֿוד	ɫ ə k ɔ v ə d
למען־השם	ɫ ə m a n h a ʃ ɛ m
לעבן	ɫ ɛ b n̩
לעבן־געבליבענער	ɫ ɛ b n̩ ɡ ɛ b ʎ ɪ b ə n ə ʁ
לעבעדיק	l ɛ b ə d ɪ k
לעבעדיקע אַקאַציע	l ɛ b ə d ɪ k ə a k a t͡s j ə
לעדל	ɫ ɛ d ɫ̩
־לעך	ɫ ə χ
לעסטערן	ɫ ɛ s t ə ʁ n̩
לעפּטאָפּ	ɫ ɛ p t ɔ p
לעפֿל	ɫ ɛ f ɫ̩
לערן	ɫ ɛ ʁ n̩
לערנט	ɫ ɛ ʁ n t
לערנסט	ɫ ɛ ʁ n̩ s t
לערנען	ɫ ɛ ʁ n ə n
לערערין	ɫ ɛ ʁ ə ʁ ɪ n
לעש	ɫ ɛ ʃ
לעש אויס	ɫ ɛ ʃ ɔ ɪ̯ s
לעשן	ɫ ɛ ʃ n̩
לשון	ɫ ɔ ʃ n̩
לשון	ɫ uː ʃ n̩
לשון	ɫ u ʃ n̩
לשם־שמים	ɫ ə ʃ ɛ ɪ̯ m ʃ ɔ m a j ə m
לײַכט	ɫ a ɪ̯ χ t
לײַכטער	ɫ a ɪ̯ χ t ə ʁ
לײַכטערס	ɫ a ɪ̯ χ t ə ʁ s
לײַלעך	ɫ a ɪ̯ ɫ ə χ
מאָדנע	m ɔ d n ə
מאָדנע	m u d n ə
מאָטעל	m ɔ t ɛ ʎ
מאַטעמאַטיק	m a t ɛ m a t ɪ k
מאַטראַץ	m a t ʁ a t͡s
מאָל	m ɔ ɫ
מאָל	m ɔ ʎ
מאַלפּע	m a l p ə
מאַלפּעס	m a ɫ p ə s
מאַמינקע	m a m ɪ nʲ k ə
מאַמינקע	m a m ɪ ŋ k ə
מאַמע־לשון	m a m ə ɫ ɔ ʃ n̩
מאַנדזשורער קאַנאַטניק	m a n d͡ʒ ʊ r ə r k a n a t n ɪ k
מאַנהעטן	m a n h ɛ t n̩
מאָנטיק	m ɔ n t ɪ k
מאַנטל	m a n t ɫ̩
מאָניטאָר	m ɔ n ɪ t ɔ ʁ
מאָניטאָרן	m ɔ n ɪ t ɔ ʁ n̩
מאַסלינע	m a s ʎ ɪ n ə
מאָסקווע	m ɔ s k v ə
מאָסקיט	m ɔ s k ɪ t
מאַפּע	m a p ə
מאַרץ	m a ʁ t͡s
מאַרק	m a ʁ k
מאַרקע	m a ʁ k ə
מאַשינביקס	m a ʃ ɪ n b ɪ k s
מגפֿה	m a ɡ ɛ ɪ̯ f ə
מדבר	m ɪ d b ə r
מדינה	m ə d ɪ n ə
מה־דאָך	m a d ə x
מודה זײַן	m ɔ ɪ d ə z a ɪ n
מודה זײַן	m e ɪ d ə z a ɪ n
מודה זײַן	m ɔ ɪ d ə z aː n
מוז	m ʊ z
מוזיי	m u z ɛ ɪ̯
מוזיקאַנט	m ʊ z ɪ k a n t
מוזיקער	m ʊ z ɪ k ə ʁ
מוזן	m ʊ z n̩
מוחל זײַן	m ɔ ɪ̯ χ ɫ̩ z a ɪ̯ n
מויער	m ɔ j ə r
מויער	m oː ə r
מויער	m o ʊ̯ ə r
מזל	m a z ɫ̩
מזל־טובֿ	m a z ɫ̩ t ɔ v
מחויבֿ	m ɛ χ ʊ j ə v
מחותּן	m ə χ ʊ t n̩
מחותּנים	m a χ ə t ɔ n ə m
מחותּנתטע	m ə χ ʊ t ɛ n ə s t ə
מחותּנתטע	m ə χ ɪ t e ɪ̯ n ə s t ə
מחיה	m ə χ a ɪ̯ ə
מחליט זײַן	m a χ ɫ ə t z a ɪ̯ n
מיאוס	m i ə s
מיד	m ɪ d
מיטאָג	m ɪ t ɔ ɡ
מיטל	m ɪ t l̩
מיטן	m ɪ t n̩
מיטנעמען	m ɪ t n ɛ m ə n
מיידל	m ɛ ɪ̯ d ɫ̩
מיינונג	m ɛ ɪ̯ n ʊ ŋ ɡ
מיינונג	m a ɪ̯ n ɪ ŋ ɡ
מייער	m ɛ ɪ̯ ə ʁ
מייערן	m ɛ ɪ̯ ə ʁ n
מיך	m ɪ χ
מיכאל	m ɪ χ ɔ ə l
מיכאל	m ɪ χ uː ɫ
מילא	m ɛ ɪ̯ ɫ ə
מיליאָן	m ɪ ʎ j ɔ n
מילך	m ɪ l χ
מילך	m ɪ l ə χ
מינהג	m ɪ n ə ɡ
מינהגים	m ɪ n h ɔ ɡ ə m
מינוט	m ɪ n ʊ t
מינוט	m ɪ n ɪ t
מינוס	m ɪ n ʊ s
מיסטעריע	m ɪ s t ɛ ʁ j ə
מיצרית	m ɪ t͡s ʁ ɪ s
מיר	m ɪ ʁ
מירל	m ɪ ʁ ɫ̩
מישן	m ɪ ʃ n̩
מכשיר	m a χ ʃ ə r
מכשפֿה	m a χ ʃ ɛ ɪ̯ f ə
מלאך	m a ɫ ə χ
ממש	m a m ə ʃ
מנורה	m n ɔ ɪ̯ r ə
מסביר זײַן	m a z b ə ʁ z a ɪ̯ n
מעדיצין	m ɛ d ɪ t͡s i n
מעכטיק	m ɛ χ t ɪ k
מעלדונג	m ɛ ɫ d ʊ ŋ
מענדל	m ɛ n d l̩
מעניו	m ɛ ɲ u
מעניוען	m ɛ ɲ u ə n
מענער	m ɛ n ə ʁ
מעסער־אַקאַציע	m ɛ s ə r a k a t͡s j ə
מעקסיקע	m ɛ k s ɪ k ə
מעקער	m ɛ k ə ʁ
מעקערס	m ɛ k ə ʁ s
מערק	m ɛ ʁ k
מעשׂה	m a ɪ̯ s ə
מעשׂה	m aː s ə
מעשׂה	m a n s ə
מפּיל־קינד	m a p ɫ̩ k ɪ n d
מפּלה	m a p ɔ ɫ ə
מפּלען	m a p ɫ ə n
מציאה	m ə t͡s i j ə
מציאות	m ə t͡s i j ə s
מצליח זײַן	m a t͡s ʎ i j ə χ z a ɪ̯ n
מצרים	m ɪ t͡s ʁ a j ə m
משוגע	m ə ʃ ʊ ɡ ə
משוגע	m ə ʃ iː ɡ ə
משוגעים	m ə ʃ ʊ ɡ ɔ ɪ m
משוגענער	m ə ʃ ʊ ɡ ə n ə ʁ
משוגעת	m ə ʃ ʊ ɡ a s
משוגעת	m ə ʃ ɪ ɡ aː s
משיח	m ɔ ʃ i ə χ
משפּחה	m ɪ ʃ p ɔ χ ə
משרת	m ə ʃ ɔ ʁ ə s
מת	m ɛ ɪ̯ s
מתּנה	m a t ɔ n ə
מײַ	m a ɪ̯
מײַל	m a ɪ̯ ɫ
מײַן	m a ɪ̯ n
מײַן	m aː n
מײַנע	m a ɪ̯ n ə
מײַנעם	m a ɪ̯ n ə m
מײַנער	m a ɪ̯ n ə ʁ
נאַהיט	n a h i t
נאָך	n ɔ χ
נאָך אַלץ	n ɔ χ a ɫ t͡s
נאָכאַמאָל	n ɔ χ a m ɔ ɫ
נאָכגיין	n ɔ χ ɡ ɛ ɪ̯ n
נאַכט	n a χ t
נאָכמיטאָג	n ɔ χ m ɪ t ɔ ɡ
נאָכמיטאָג	n ɔ χ m ɪ t ɔ ɡ
נאָמען	n ɔ m ə n
נאָמען	n uː m ə n
נאָמען	n u m ə n
נאַס	n a s
נאָר	n ɔ ʁ
נאָרדמאַן־יאָדלע	n ɔ r d m a n j ɔ d l ə
נאָרוועגיע	n ɔ ʁ v ɛ ɡ j ə
נאַריש	n a ʁ ɪ ʃ
נאַרישער	n a ʁ ɪ ʃ ə ʁ
נאָרמאַל	n ɔ ʁ m a ɫ
נבֿלה	n ə v ɛ ɪ̯ ɫ ə
נודנע	n ʊ d n ə
נויטפֿאַל	n ɔ j t f a l
נול	n ʊ ɫ
נומער	n ʊ m ə ʁ
נותן	n ɔ ɪ s n̩
נותן	n ɛ ɪ s n̩
נחת	n a χ ə s
נידעריק	n ɪ d ə ʁ ɪ k
ניי	n ɛ ɪ̯
ניין	n ɛ j n
ניין	n a ɪ̯ n
נייען	n ɛ ɪ̯ ə n
ניצן	n ɪ t͡s n̩
נישטאָ	n ɪ ʃ t ɔ
נס	n ɛ s
נסיעה	n ɛ s i ə
נעבן	n ɛ b n̩
נעבעך	n ɛ b ə χ
נעכטן	n ɛ χ t n̩
נעלם ווערן	n ɛ ɫ ə m v ɛ ʁ n̩
נעם	n ɛ m
נעמען	n ɛ m ə n
נײַ	n a ɪ̯
נײַן	n a ɪ̯ n
נײַן	n aː n
נײַנט	n a ɪ̯ n t
נײַנציק	n a ɪ̯ n t͡s ɪ k
נײַע	n a ɪ̯ ə
סאַדיזם	s a d ɪ z m̩
סאַדיסט	s a d ɪ s t
סאַדיסטיש	s a d ɪ s t ɪ ʃ
סאָווע	s ɔ v ə
סאַלאַט	s a ɫ a t
סאָלדאַט	s ɔ ɫ d a t
סאָלדאַטן	s ɔ ɫ d a t n̩
סאַמאָדערזשאַוויע	s a m ɔ d ɛ r ʒ a v j ɛ
סאָס	s ɔ s
סאָציאָלאָגיע	s ɔ t͡s j ɔ ɫ ɔ ɡ j ə
סאָרט	s ɔ ʁ t
סדר	s ɛ ɪ̯ d ə ʁ
סוכּה	s ʊ k ə
סוכּה	s ɪ k ə
סוכּות	s ʊ k ə s
סוכּות	s ɪ k ə s
סוכּות	s ɨ k ə s
סוף	s ɔ f
סוף־וואָך	s ɔ f v ɔ χ
סטאַנציע	s t a n t͡s j ə
סטואַרד	s t ʊ a ʁ d
סטואַרדקע	s t ʊ a ʁ d k ə
סטעליע	s t ɛ ʎ j ə
סידור	s ɪ d ə ʀ
סכּנה	s a k ɔ n ə
סכּנה	s ə k ɔ n ə
סכּנהדיק	s a k ɔ n ə d ɪ k
סכּנהדיק	s ə k ɔ n ə d ɪ k
סכּנות	s a k ɔ n ə s
סכּנות	s ə k ɔ n ə s
סכך	s χ a χ
סלוי	s ɫ ɔ ɪ̯
סלויעס	s ɫ ɔ ɪ̯ ə s
סמעטענע	s m ɛ t ə n ə
סעודה	s ʊ d ə
סעמעסטער	s ɛ m ɛ s t ə ʁ
סענדוויטש	s ɛ n d v ɪ t͡ʃ
סעקטע	s ɛ k t ə
סעקרעטאַר	s ə k ʁ ə t a ʁ
סעקרעטאַרשע	s e k ʁ ə t a ʁ ʃ ə
ספּעציאַליסט	s p ɛ t͡s j a ʎ ɪ s t
ספּעציאַליסטן	s p ɛ t͡s j a ʎ ɪ s t n̩
ספּעציאַליסטקע	s p ɛ t͡s j a ʎ ɪ s t k ə
ספֿר	s ɛ ɪ̯ f ə ʁ
ספֿר	s a ɪ̯ f ə ʁ
סתּם	s t a m
סײַדן	s a ɪ̯ d n̩
סײַדן	s aː d n̩
עבֿרה	a v ɛ ɪ r ə
עדות	ɛ ɪ̯ d ə s
עדות	a ɪ̯ d ə s
עומר	ɔ j m ɛ ɾ
עטלעך	ɛ t ɫ ə χ
עטלעכע	ɛ t l ə χ ə
עלטער	ɛ ɫ t ə ʁ
עלטער־זיידע	ɛ ɫ t ə ʁ z ɛ ɪ̯ d ə
עלטערע	ɛ ɫ t ə ʁ ə
עם	ɛ m
עמעצער	ɛ m ə t͡s ə r
ענגליש	ɛ ŋ ɡ ʎ ɪ ʃ
ענדלעך	ɛ n d l ə χ
ענטפֿער	ɛ n t f ə ʁ
ענטפֿערן	ɛ n t f ɛ ʁ n
עס	ɛ s
עס	s
עס	s ə
עס	ɛ s
עסט	ɛ s t
עסטרײַך	ɛ s t ʁ a ɪ̯ χ
עסן	ɛ s n̩
עספּעראַנטיסט	ɛ s p ɛ r a n t ɪ s t
עפּאָכע	ə p ɔ χ ə
עפּעס	ɛ p ə s
עפֿן	ɛ f n̩
עפֿנט	ɛ f n̩ t
עפֿנטלעך	ɛ f n̩ t ɫ ə χ
עפֿענען	ɛ f ə n ə n
עקספּערט	ɛ k s p ɛ ʁ t
ער	ɛ ʁ
ערד	ɛ ʁ d
ערלעך	ɛ ʁ ɫ ə χ
ערלעכקייט	ɛ ʁ ɫ ə χ k a ɪ̯ t
ערשט	ɛ ʁ ʃ t
פֿאָדעם	f ɔ d ə m
פֿאַך	f a χ
פֿאָך	f ɔ χ
פֿאַל	f a ɫ
פֿאָלגן	f ɔ ɫ ɡ n̩
פֿאַן	f a n
פֿאַנאַטיקער	f a n a t ɪ k ə ʁ
פֿאַנטאַזיע	f a n t a z j ə
פֿאַס	f a s
פֿאַקטאַזיע	f a k t a z j ə
פֿאַר	f a ʁ
פֿאַראייניקט	f a r ɛ ɪ̯ n ɪ k t
פֿאַראייניקט	f a r a ɪ̯ n ɪ k t
פֿאַראייניקטע שטאַטן	f a r ɛ ɪ̯ n ɪ k t ə ʃ t a t n̩
פֿאַראייניקטע שטאַטן	f a r a ɪ̯ n ɪ k t ə ʃ t a t n̩
פֿאַראייניקטע שטאַטן פֿון אַמעריקע	f a r ɛ ɪ̯ n ɪ k t ə ʃ t a t n̩ f ʊ n a m ɛ r ɪ k ə
פֿאַראייניקטע שטאַטן פֿון אַמעריקע	f a r a ɪ̯ n ɪ k t ə ʃ t a t n̩ f ɪ n a m ɛ r ɪ k ə
פֿאַרב	f a ʁ b
פֿאַרבינדונג	f a ʁ b ɪ n d ʊ ŋ ɡ
פֿאַרבינדן	f a ʁ b ɪ n d n̩
פֿאַרבלאָנדזשען	f a ʁ b ɫ ɔ n d͡ʒ ə n
פֿאַרגאַנגען	f a ʁ ɡ a ŋ ɡ ə n
פֿאַרגאַנגענהייט	f a ʁ ɡ a ŋ ɡ ə n h ɛ ɪ̯ t
פֿאַרגייט	f a ʁ ɡ ɛ ɪ̯ t
פֿאַרגיין	f a ʁ ɡ ɛ ɪ̯ n
פֿאַרגלײַך	f a ʁ ɡ ɫ a ɪ̯ χ
פֿאַרגלײַכט	f a ʁ ɡ ɫ a ɪ̯ χ t
פֿאַרגלײַכן	f a ʁ ɡ ɫ a ɪ̯ χ n̩
פֿאַרגעוואַלדיקונג	f a ʁ ɡ ə v a ɫ d ɪ k ʊ ŋ ɡ
פֿאַרגעוואַלדיקן	f a ʁ ɡ ə v a ɫ d ɪ k ŋ̩
פֿאַרגעסן	f a ʁ ɡ ɛ s n̩
פֿאַרדאַמען	f a ʁ d a m ə n
פֿאַרדינגען	f a ʁ d ɪ ŋ ɡ ə n
פֿאַרדינסט	f a ʁ d ɪ n s t
פֿאַרדינען	f a ʁ d ɪ n ə n
פֿאַרדריסן	f a ʁ d ʁ ɪ s n̩
פֿאַרוואָס	f a ʁ v ɔ s
פֿאַרזיכערונג	f a ʁ z ɪ χ ə ʁ ʊ ŋ ɡ
פֿאַרזיכערן	f a ʁ z ɪ χ ə ʁ n̩
פֿאַרטיליקונג	f a ʁ t ɪ ɫ ɪ k ʊ ŋ ɡ
פֿאַרטיליקן	f a ʁ t ɪ ɫ ɪ k ŋ̩
פֿאַרטיק	f a ʁ t ɪ k
פֿאַרייִאושט	f a ʁ j ɪ ə ʃ t
פֿאַרלוירן	f a ʁ ɫ ɔ ɪ̯ ʁ n̩
פֿאַרלירן	f a ʁ ʎ ɪ ʁ n̩
פֿאַרם	f a ʁ ə m
פֿאַרמאַכט	f a ʁ m a χ t
פֿאַרמאַכן	f a ʁ m a χ n̩
פֿאַרמער	f a ʁ m ə ʁ
פֿאַרמערין	f a ʁ m ə ʁ ɪ n
פֿאַרמערס	f a ʁ m ə ʁ s
פֿאַרנומען	f a ʁ n ʊ m ə n
פֿאַרנעזישע אַקאַציע	f a r n ɛ z ɪ ʃ ə a k a t͡s j ə
פֿאַרצייכענען	f a ʁ t͡s ɛ ɪ̯ χ ə n ə n
פֿאַרקויף	f a ʁ k ɔ ɪ̯ f
פֿאַרקויפֿער	f a ʁ k ɔ ɪ̯ f ə ʁ
פֿאַרקויפֿערין	f a ʁ k ɔ ɪ̯ f ə ʁ ɪ n
פֿאַרקילונג	f a ʁ k ɪ ɫ ʊ ŋ ɡ
פֿאַרראָט	f a ʁ ʁ ɔ t
פֿאַרראָטן	f a ʁ ʁ ɔ t n̩
פֿאַרריכט	f a ʁ ʁ ɪ χ t
פֿאַרריכטן	f a ʁ ʁ ɪ χ t n̩
פֿאַררעטער	f a ʁ ʁ ɛ t ə ʁ
פֿאַררעטער	f a ʁ ʁ eː t ə ʁ
פֿאַררעטער	f a ʁ ʁ e ɪ̯ t ə ʁ
פּאַווע־פֿאַזאַן	p a v ə p a z a n
פּאַלאַץ	p a ɫ a t͡s
פּאַלאַצן	p a ɫ a t͡s n̩
פּאָליצע	p ɔ ʎ ɪ t͡s ə
פּאָליצעס	p ɔ ʎ ɪ t͡s ə s
פּאָמידאָר	p ɔ m ɪ d ɔ ʁ
פּאָמידאָרן־זאַפֿט	p ɔ m i d ɔ r n̩ z a f t
פּאַמעלעך	p a m ɛ ɫ ə χ
פּאַמעלעכער	p a m ɛ ɫ ə χ ə ʁ
פּאַנדע	p a n d ə
פּאַנדעס	p a n d ə s
פּאָנטשיק	p ɔ n t͡ʃ ɪ k
פּאַס	p a s
פּאַסט	p a s t
פּאַסיק	p a s ɪ k
פּאַסן	p a s n̩
פּאַספּאָרט	p a s p ɔ ʁ t
פּאָעט	p ɔ ɛ t
פּאָפּ	p ɔ p
פּאָפּוגײַ	p ɔ p ʊ ɡ a ɪ̯
פּאָפּוגײַען	p ɔ p ʊ ɡ a ɪ̯ ə n
פּאַפּיר	p a p i r
פּאָץ	p ɔ t s
פּאַציענט	p a t͡s j ɛ n t
פּאָרצעלײַ	p ɔ ʁ t͡s ə ɫ a ɪ̯
פּוטער	p ʊ t ə ʁ
פּויליש	p ɔ ɪ̯ ʎ ɪ ʃ
פּוכשישקע־יאָדלע	p u χ ʃ ɪ ʃ k ə j ɔ d l ə
פּולס	p ʊ l s
פּולסאָדער	p ʊ l s ɔ d ə r
פּושקע	p ʊ ʃ k ə
פּטור ווערן	p ɔ t ə ʁ v ɛ ʁ n̩
פֿוטער	f ʊ t ə ʁ
פֿוטער־פּלאַץ	f ʊ t ə ʁ p ɫ a t͡s
פֿויגל	f ɔ ɪ̯ ɡ l̩
פֿויגל	f a ɪ̯ ɡ l̩
פֿויגל	f e ɪ̯ ɡ l̩
פֿויל	f ɔ ɪ̯ ɫ
פֿויל	f oː ɫ
פֿויל	f o ʊ̯ ɫ
פּינגווין	p ɪ ŋ ɡ v ɪ n
פּינקטלעך	p ɪ ŋ k t ɫ ə x
פּישן	p ɪ ʃ n̩
פּישעכץ	p ɪ ʃ ə χ t͡s
פּלאַן	p ɫ a n
פּלאַנט	p ɫ a n t
פּלאַנען	p ɫ a n ə n
פּלאַץ	p ɫ a t͡s
פּלוס	p ɫ ʊ s
פּלוצלינג	p ɫ ʊ t͡s ʎ ɪ ŋ ɡ
פֿונט	f ʊ n t
פֿונעם	f ʊ n ə m
פֿוספֿינגער	f ʊ s f ɪ ŋ ɡ ə r
פּעקל	p ɛ k ɫ̩
פֿופֿציק	f ʊ f t͡s ɪ k
פֿופֿצן	f ʊ f t͡s n̩
פּראָפֿעסאָר	p ʁ ɔ f ɛ s ɔ ʁ
פּראָפֿעסאָרין	p ʁ ɔ f ɛ s ɔ ʁ ɪ n
פּריוואַט	p ʁ ɪ v a t
פּריסטער	p ʁ ɪ s t ə ʁ
פּרנסה	p a ʁ n ɔ s ə
פּרעגל	p ʁ ɛ ɡ ɫ̩
פּרעגלט	p ʁ ɛ ɡ ɫ̩ t
פּרעגלסט	p ʁ ɛ ɡ ɫ̩ s t
פּרעגלען	p ʁ ɛ ɡ ɫ̩ ə n
פּרעזידענט	p ʁ ɛ z ɪ d ɛ n t
פּרעכטיק	p ʁ ɛ χ t ɪ k
פּרעפֿערירט	p ʁ ɛ f ɛ ʁ ɪ ʁ t
פּרעפֿערירן	p ʁ ɛ f ɛ ʁ ɪ ʁ n̩
פֿיזיק	f ɪ z ɪ k
פֿייגל	f ɛ ɪ̯ ɡ ɫ̩
פֿייגעלע	f ɛ ɪ̯ ɡ ə ɫ ə
פֿילם	f ɪ ɫ m̩
פֿילפֿאַרביק	f ɪ ɫ f a ʁ b ɪ k
פֿינף	f ɪ n f
פֿינף	f ɪ n ə f
פֿינפֿט	f ɪ n f t
פֿינפֿטע	f ɪ n f t ə
פֿינפֿטער	f ɪ n f t ə ʁ
פֿינצטערניש	f ɪ n t͡s t ə ʁ n ɪ ʃ
פֿיר	f i ʀ
פֿירהאַנג	f ɪ ʁ h a ŋ ɡ
פֿירמע	f ɪ ʁ m ə
פֿירער	f ɪ r ə r
פֿיש	f ɪ ʃ
פֿלאָט	f l ɔ t
פֿלאַטערל	f ɫ a t ə ʁ ɫ̩
פֿלאַש	f ɫ a ʃ
פֿליג	f l ɪ ɡ
פֿליט	f ɫ ɪ t
פֿלייש	f ɫ ɛ ɪ̯ ʃ
פֿלייש	f ɫ a ɪ̯ ʃ
פֿליישיק	f ɫ ɛ ɪ̯ ʃ ɪ k
פֿליפֿעלד	f ʎ ɪ f ɛ ɫ d
פֿלעשל	f ɫ ɛ ʃ ɫ̩
פֿעטער	f ɛ t ə ʁ
פֿעיִק	f ɛ ɪ k
פֿעיִק	f e ɪ̯ ɪ k
פֿעיִק	f eː ɪ k
פֿענדל	f ɛ n d ɫ̩
פֿענדלעך	f ɛ n d ɫ ə χ
פֿענצטער	f ɛ n t͡s t ə ʁ
פֿעסטונג	f ɛ s t ʊ ŋ ɡ
פֿעע	f ɛ ə
פֿעפֿער	f ɛ f ə ʁ
פֿערד	f ɛ r d
פֿערט	f ɛ ʁ t
פֿערציק	f ɛ ʁ t͡s ɪ k
פֿראַגע	f ʁ a ɡ ə
פֿראַנקרײַך	f ʁ a ŋ k ʁ a ɪ̯ χ
פֿראָש	f ʁ ɔ ʃ
פֿרוי	f r ɔ j
פֿרוי	f r ɔ ʊ̯
פֿרוי	f r oː
פֿרוי	f r o ʊ̯
פֿרום	f r ʊ m
פֿרומקייט	f ʁ ʊ m k a ɪ̯ t
פֿרומקייט	f ʁ ɪ m k a ɪ̯ t
פֿרומקייט	f ʁ ɨ m k e ɪ̯ t
פֿרידזשידער	f ʁ ɪ d͡ʒ ɪ d ɛ ʁ
פֿרידזשידערס	f ʁ ɪ d͡ʒ ɪ d ɛ ʁ s
פֿרייד	f ʁ ɛ ɪ̯ d
פֿרייד	f ʁ aː d
פֿרייד	f ʁ e ɪ̯ d
פֿרייד	f ʁ a ɪ̯ d
פֿרייזער־יאָדלע	f r ɛ ɪ̯ z ə r j ɔ d l ə
פֿרילינג	f ʁ ɪ ʎ ɪ ŋ ɡ
פֿריש	f ʁ ɪ ʃ
פֿרישטיק	f ʁ ɪ ʃ t ɪ k
פֿרעג	f ʁ ɛ ɡ
פֿרעגט	f ʁ ɛ k t
פֿרעגן	f ʁ ɛ ɡ n̩
פֿרעמדלעך	f ʁ ɛ m d ɫ ə χ
פֿרעסן	f ʁ ɛ s n̩
פֿרײַ	f ʁ a ɪ̯
פֿרײַנדלעך	f ʁ a ɪ̯ n d ɫ ə χ
פֿרײַע	f ʁ a ɪ̯ ə
פֿױל	f ɔ ɪ̯ l
פֿױל	f oː l
פֿױל	f o ʊ̯ l
פֿײַן	f a ɪ̯ n
פֿײַער	f a ɪ̯ ə r
פֿײַער־לעשער	f a ɪ̯ e ʁ ɫ ɛ ʃ ə ʁ
פֿײַערן	f a ɪ̯ ə ʁ n
צאָל	t͡s ɔ l
צאַצקע	t͡s a t͡s k ə
צדיק אין פּעלץ	t͡s a d ə k ɪ n p ɛ l t͡s
צובינדן	t͡s ʊ b ɪ n d n̩
צוואַנציק	t͡s v a n t͡s ɪ k
צוואַנציקסט	t͡s v a n t͡s ɪ k s t
צוויי	t͡s v ɛ ɪ̯
צוויי	t͡s v e ɪ̯
צוויי	t͡s v a ɪ̯
צווייט	t͡s v ɛ ɪ̯ t
צווינטער	t͡s v ɪ n t ə r
צווישן	t͡s v ɪ ʃ n̩
צוועלף	t͡s v ɛ ɫ f
צוזאַמענאַרבעטן	t͡s ʊ z a m ə n a ʁ b ə t n̩
צום	t͡s ʊ m
צום בײַשפּיל	t͡s ʊ m b a ɪ̯ ʃ p i ɫ
צום גליק	t͡s ʊ m ɡ ʎ ɪ k
צום גליק	t͡s ɪ m ɡ ʎ ɪ k
צופֿאַל	t͡s ʊ f a ɫ
צופֿרידן	t͡s ʊ f ʁ ɪ d n̩
צי	t͡s i
ציבעלע	t͡s ɪ b ə ɫ ə
ציין	t͡s ɛ ɪ̯ n
ציין	t͡s a ɪ̯ n
ציינבערשטל	t͡s ɛ ɪ̯ n b ɛ ʁ ʃ t ɫ̩
ציל	t͡s ɪ l
צינד	t͡s ɪ n d
צינדט	t͡s ɪ n t
צינדן	t s ɪ n d n̩
צעבראָכן	t͡s ə b ʁ ɔ χ n̩
צעברעכן	t͡s ə b ʁ ɛ χ n̩
צעלקע	t͡s ɛ ɫ k ə
צעמישונג	t͡ʃ ə m ɪ ʃ ʊ ŋ ɡ
צעמישן	t͡s ə m ɪ ʃ n̩
צען	t͡s ɛ n
צען	t͡s eː n
צען	t͡s e ɪ̯ n
צענט	t͡s ɛ n t
צענטראַל	t͡s ɛ n t ʁ a ɫ
צעשנײַדן	t͡s ə ʃ n a ɪ̯ d n̩
צײַט	t͡s a ɪ̯ t
צײַטונג	t͡s a ɪ̯ t ʊ ŋ ɡ
צײַטונג	t͡s aː t ɪ ŋ ɡ
צײַטיק	t͡s a ɪ̯ t ɪ k
קאָוואַדלע	k ɔ v a d l ə
קאַטשער	k a t͡ʃ ə ʁ
קאַטשקע	k a t͡ʃ k ə
קאָלדרע	k ɔ ɫ d ʁ ə
קאַלט	k a ɫ t
קאָלעגע	k ɔ ʎ ɛ ɡ ə
קאָלעגעס	k ɔ ʎ ɛ ɡ ə s
קאַלענדאַר	k a ʎ ɛ n d a ʁ
קאָמאַר	k o m a ʁ
קאָמפּיוטער	k ɔ m p j ʊ t ə ʁ
קאָמפּיוטערס	k ɔ m p j ʊ t ə ʁ s
קאַנאַדע	k a n a d ə
קאַנאַטניק	k a n a t n ɪ k
קאָנווערט	k ɔ n v ɛ ʁ t
קאָנווערטן	k ɔ n v ɛ ʁ t n̩
קאַנטאָנעזיש	k a n t ɔ n ɛ z ɪ ʃ
קאָנטאַקטירן	k ɔ n t a k t i ʁ n̩
קאָנטינענט	k ɔ n t i n ɛ n t
קאָנטע	k ɔ n t ə
קאָנצעפּט	k ɔ n t͡s ɛ p t
קאָסט	k ɔ s t
קאָסטיום	k ɔ s t j ʊ m
קאָסטן	k ɔ s t n̩
קאָפּ	k ɔ p
קאַפּיטאַן	k a p ɪ t a n
קאַפּיטאַנען	k a p i t a n ə n
קאַרטאָפֿל	k a ʁ t ɔ f ɫ̩
קאָשמאַר	k o ʃ m a ʁ
קדוש	k ɔ d ə ʃ
קהלת	k o ɪ̯ h ɛ l ə s
קהלת	k e ɪ̯ h ɛ l ɛ s
קהלת	k o ɪ̯ h e ɪ̯ l e ɪ̯ s
קוגל	k ʊ ɡ ɫ̩
קווייט	k v ɛ j t
קוים	k ɔ ɪ̯ m
קויף	k ɔ ɪ̯ f
קויפֿן	k ɔ ɪ̯ f n̩
קויפֿן	k e ɪ̯ f n̩
קויפֿן	k aː f n̩
קום אָן	k ʊ m ɔ n
קומט	k ʊ m t
קומסט	k ʊ m s t
קוסט	k ʊ s t
קוקן	k u k n̩
קוראָפּאַטע	k ʊ ʁ ɔ p a t ə
קורץ	k ʊ ʁ t͡s
קוש	k ʊ ʃ
קיווי	k ɪ v ɪ
קיין	k ɛ n
קייסעך	k ɛ ɪ s ə χ
קיך	k ɪ χ
קיכל	k ɪ χ ɫ̩
קיכלעך	k ɪ χ ɫ ə χ
קיל	k ɪ l
קימפּעטאָרין	k ɪ m p ɛ t ɔ ʁ n̩
קין	k a ɪ̯ n
קינד	k ɪ n d
קינדער	k ɪ n d ə ʁ
קינדעריאָרן	k ɪ n d ə ʁ j ɔ ʁ n̩
קינזשאַל־אַקאַציע	k ɪ n ʒ a l a k a t͡s j ə
קיצור	k ɪ t͡s ə r
קירבעס	k ɪ ʁ b ə s
קירצער	k ɪ ʁ t͡s ə ʁ
קלאַוויאַטור	k ɫ a v j a t ʊ ʁ
קלאָר	k ɫ ɔ ʁ
קלוג	k ɫ ʊ ɡ
קליגער	k ɫ ɪ ɡ ə ʁ
קלייד	k ɫ ɛ ɪ̯ d
קליידל	k ɫ ɛ ɪ̯ d ɫ̩
קליידער	k ɫ ɛ ɪ̯ d ə ʁ
קלייט	k ɫ ɛ ɪ̯ t
קליין	k ɫ ɛ ɪ̯ n
קליינע	k ɫ ɛ ɪ̯ n ə
קליניק	k ʎ ɪ n ɪ k
קליענט	k ʎ i ɛ n t
קליענטן	k ʎ i ɛ n t n̩
קנאָבל	k n ɔ b ɫ̩
קנויט	k n ɔ ɪ̯ t
קנויטן	k n ɔ ɪ̯ t n̩
קנוניא	k n ʊ n j ə
קנוניא	k n i n j ə
קעז	k ɛ z
קעלטער	k ɛ ɫ t ə ʁ
קעלטערס	k ɛ ɫ t ə ʁ s
קעלער	k ɛ ɫ ə ʁ
קעמל	k ɛ m ɫ̩
קען	k ɛ n
קעניג	k ɛ n ɪ ɡ
קעניג	k e ɪ̯ n ɪ ɡ
קעניגרײַך	k ɛ n ɪ ɡ ʁ a ɪ̯ χ
קענסט	k ɛ n s t
קעץ	k ɛ t͡s
קצבֿ	k a t͡s ə v
קראָם	k ʁ ɔ m
קראַנקייט	k r a ŋ k a ɪ̯ t
קרײַד	k ʁ a ɪ̯ d
קײַקל	k ɑ j k ə l
ראָד	ʁ ɔ d
ראָש־השנה	ʁ ɔ ʃ ə ʃ ɔ n ə
ראָש־השנה	ʁ e ɪ̯ ʃ ə ʃ ʊ n ə
ראָש־השנה	ʁ ɔ ʃ ə ʃ u n ə
רבֿקה	r ɪ v k ə
רגע	ʁ ɛ ɡ ə
רו	ʁ ʊ
רובֿ	ʁ ɔ v
רוח	ʁ ʊ ə χ
רוח	ʁ iː ə χ
רוח	ʁ i ə χ
רוי	ʁ ɔ ɪ̯
רויזן	ʁ ɔ ɪ̯ z n̩
רויטן	ʁ ɔ ɪ̯ t n̩
רויע	ʁ ɔ ɪ̯ ə
רויען	ʁ ɔ ɪ̯ ə n
רויִק	ʁ ʊ ɪ k
רוס	ʁ ʊ s
רוסיש	ʁ ʊ s ɪ ʃ
רוסישן	ʁ ʊ s ɪ ʃ n̩
רוסלאַנד	ʁ ʊ s ɫ a n d
רוסקע	ʁ ʊ s k ə
רות	r u s
רות	r i s
רחל	ɾ ɔ χ l̩
רחל	ɾ u χ l̩
רחמנות	ʁ a χ m ɔ n ə s
רחמנות	ʁ a χ m uː n ə s
ריזן־יאָדלע	r i z n̩ j ɔ d l ə
ריי	ʁ ɛ ɪ̯
רייען	ʁ ɛ ɪ̯ ə n
ריכטן	ʁ ɪ χ t n̩
רעגן	r ɛ ɡ n̩
רעגן־וואַסער	ʁ ɛ ɡ n̩ v a s ə ʁ
רעגן־מאַנטל	ʁ ɛ ɡ ŋ̩ m a n t ɫ̩
רעגן־מאַנטל	ɾ e ɪ̯ ɡ ŋ̩ m a n t ɫ̩
רעגנט	ʁ ɛ ɡ n̩ t
רעגענען	ʁ ɛ ɡ ə n ə n
רעדט	ʁ ɛ t
רעדל	ʁ ɛ d ɫ̩
רעדער	ʁ ɛ d ə ʁ
רעזערוואַציע	ʁ ɛ z ɛ ʁ v a t͡s j ə
רעכטס	ʁ ɛ χ t s
רעכענקונסט	r ɛ χ ə n k u n s t
רענצל	ʁ ɛ n t͡s ɫ̩
רעסטאָראַן	ʁ ɛ s t ɔ ʁ a n
רעפּאַראַטור	ʁ ɛ p a ʁ a t ʊ ʁ
רעצעפּט	ʁ ə t͡s ɛ p t
רפֿואה	ʁ ə f ʊ ə
רשימה	r ə ʃ ɪ m ə
רשע	ʁ ɔ ʃ ə
רײַז	ʁ a ɪ̯ z
ר׳	ʁ ɛ b
ר׳	ʁ ɛ b ə
שׂונא־ישׂראל	s ɔ ɪ n ə j i s r ɔ ə l
שׂונא־ישׂראל	s ɛ ɪ n ə i s r ɔ ə l
שׂונא־ישׂראל	s ɔ ɪ n ə j i s r uː ə l
שׂמחה	s ɪ m χ ə
שׂמחות	s ɪ m χ ə s
שׂרה	s o ɾ ɜ
שׂרה	s u ɾ ɜ
שאָד	ʃ ɔ d
שאַל	ʃ a l
שאַנד	ʃ a n d
שאַנדע	ʃ a n d ə
שאַנק	ʃ a ŋ k
שאָסיי	ʃ ɔ s ɛ ɪ̯
שאַפֿע	ʃ a f ə
שאָפֿער	ʃ ɔ f ɛ ʁ
שאָקאָלאַד	ʃ ɔ k ɔ ɫ a d
שאַרף	ʃ a ʁ f
שבֿועות	ʃ v u ə s
שבֿועות	ʃ v i ə s
שבֿע־ברכות	ʃ ɛ v ə b ʁ ɔ χ ə s
שבֿע־ברכות	ʃ e ɪ̯ v ə b ʁ uː χ ə s
שדכן	ʃ a d χ n
שוואַך	ʃ v a χ
שוואַכער	ʃ v a χ ə ʁ
שוואַן	ʃ v a n
שווייץ	ʃ v ɛ ɪ̯ t͡s
שווימבאַסיין	ʃ v ɪ m b a s ɛ ɪ̯ n
שווימבאַסיינען	ʃ v ɪ m b a s ɛ ɪ̯ n ə n
שווימען	ʃ v ɪ m ə n
שוועד	ʃ v ɛ d
שוועדן	ʃ v ɛ d n̩
שוועמל	ʃ v ɛ m ɫ̩
שוועמלעך	ʃ v ɛ m ɫ ə x
שוועסטער	ʃ v ɛ s t ə ʁ
שוועסטערל	ʃ v ɛ s t ə ʁ ɫ̩
שווער	ʃ v ɛ ʁ
שווערד	ʃ v ɛ ʁ d
שוין	ʃ ɔ ɪ̯ n
שוך	ʃ ʊ χ
שוך	s ʊ χ
שוך	ʃ i χ
שול	ʃ ʊ l
שול	ʃ i l
שולע	ʃ u ɫ ə
שופֿר	ʃ ɔ ɪ̯ f e r
שחור	ʃ ɔ χ ə ʁ
שטאַמט	ʃ t a m t
שטאַמען	ʃ t a m ə n
שטאָק	ʃ t ɔ k
שטאַרב	ʃ t a ʁ b
שטאַרבט	ʃ t a ʁ p t
שטאַרבן	ʃ t a ʁ b n̩
שטאַרק	ʃ t a ʁ k
שטאַרקן	ʃ t a ʁ k n̩
שטודירן	ʃ t ʊ d ɪ ʁ n̩
שטודירסט	ʃ t ʊ d ɪ ʁ s t
שטח	ʃ ɛ t ə χ
שטיין	ʃ t ɛ ɪ̯ n
שטיל	ʃ t ɪ ɫ
שטינקט	ʃ t ɪ ŋ k t
שטינקען	ʃ t ɪ ŋ k ə n
שטיקל	ʃ t ɪ k ɫ̩
שטעכט	ʃ t ɛ χ t
שטעכן	ʃ t ɛ χ n̩
שטעל	ʃ t ɛ ɫ
שטעלן	ʃ t ɛ l n̩
שטעלע	ʃ t ɛ ɫ ə
שטענדיק	ʃ t ɛ n d ɪ k
שטער	ʃ t ɛ ʁ
שטרוי	ʃ t ʁ ɔ ɪ̯
שילד	ʃ ɪ ɫ d
שילוּיע	ʃ ɪ ɫ ʊ j ə
שינקע	ʃ ɪ ŋ k ə
שיפֿל	ʃ ɪ f ɫ̩
שיק	ʃ ɪ k
שיקאַגאָ	ʃ i k a ɡ ɔ
שיקן	ʃ ɪ k n̩
שירעם	ʃ ɪ ʁ ə m
שכּ׳ח	ʃ k ɔ ɪ̯ ə χ
שכן	ʃ ɔ χ n̩
שכנים	ʃ x ɛ ɪ̯ n ə m
שלאָג	ʃ ɫ ɔ ɡ
שלאָגן	ʃ ɫ ɔ ɡ ŋ̩
שלאַנגען	ʃ l a ŋ ɡ ə n
שלאָף	ʃ l ɔ f
שלאָפֿזאַק	ʃ ɫ ɔ f z a k
שלאָפֿזעק	ʃ ɫ ɔ f z ɛ k
שלאָפֿן	ʃ ɫ ɔ f n̩
שלאָפֿראָק	ʃ ɫ ɔ f ʁ ɔ k
שלום	ʃ ɔ ɫ ə m
שלום	ʃ uː ɫ ə m
שלום	ʃ u ɫ ə m
שלום עליכם	ʃ ɔ ɫ ə m ‿ a ɫ ɛ ɪ̯ χ ə m
שלום עליכם	ʃ ʊ ɫ ə m ‿ a ɫ a ɪ̯ χ ə m
שלוש־סעודות	ʃ a l ə ʃ ʊ d ə s
שלימזל	ʃ ʎ ɪ m a z ɫ̩
שליסל	ʃ ʎ ɪ s ɫ̩
שלעכט	ʃ ɫ ɛ χ t
שמאָל	ʃ m ɔ ɫ
שמאָק	ʃ m ɔ k
שמועס	ʃ m u ə s
שמוץ	ʃ m ʊ t͡s
שמוציק	ʃ m u t͡s ɪ k
שמעק	ʃ m ɛ k
שמעקן	ʃ m ɛ k n̩
שנויץ	ʃ n ɔ ɪ̯ t͡s
שנויץ	ʃ n o ʊ̯ t͡s
שנויץ	ʃ n oː t͡s
שניי	ʃ n ɛ ɪ̯
שנייט	ʃ n ɛ ɪ̯ t
שנייען	ʃ n ɛ ɪ̯ ə n
שנעל	ʃ n ɛ ɫ
שנעק	ʃ n ɛ k
שנײַד	ʃ n a ɪ̯ d
שנײַדן	ʃ n a ɪ̯ d n̩
שנײַדער	ʃ n a ɪ̯ d ə ʁ
שנײַדער	ʃ n aː d ə ʁ
שנײַדער	ʃ n a d ə ʁ
שעה	ʃ ɔ
שעה	ʃ ʊ
שעפּס	ʃ ɛ p s
שערל	ʃ ɛ ʁ l̩
שערלעך	ʃ ɛ ʁ l ə χ
שפּאַניש	ʃ p a n ɪ ʃ
שפּאַנישער	ʃ p a n ɪ ʃ ə ʁ
שפּיגל	ʃ p i ɡ l
שפּיטאָל	ʃ p ɪ t ɔ l
שפּיטאָל	ʃ p iː t uː l
שפּיטאָל	ʃ p i t u l
שפּיל	ʃ p ɪ ɫ
שפּילט	ʃ p ɪ ɫ t
שפּילן	ʃ p ɪ ɫ n̩
שפּילצײַג	ʃ p ɪ ɫ t͡s a ɪ̯ ɡ
שפּעט	ʃ p ɛ t
שפּעטסט	ʃ p ɛ t s t
שפּעטסטן	ʃ p ɛ t s t n̩
שפּעטער	ʃ p ɛ t ə ɾ
שפּערל	ʃ p ɛ ɾ l̩
שפּערל	s p ɛ ɾ l̩
שפּערל	ʃ p e j ɾ l̩
שפּײַז	ʃ p a j z
שרײַבטיש	ʃ ʁ a ɪ̯ b t ɪ ʃ
שרײַבן	ʃ r a ɪ b n̩
שײַכות	ʃ a ɪ̯ χ ə s
שײַנען	ʃ a ɪ̯ n ə n
תּבֿה	t ɛ ɪ̯ v ə
תּבֿה	t a ɪ̯ v ə
תּלמיד	t a ɫ m ə d
תּלמידה	t a ɫ m ɪ d ə
תּלמידים	t a ɫ m ɪ d ə m
תּפֿילין	t ə f ɪ ɫ ə n
תּפֿילין	t ə f ɨ ɫ ə n
תּקופֿה	t k ʊ f ə
