aa	à á
aa	á á
aadọta	à á d ọ́ t a
aafa	à á f á
aafin	à à f ĩ̄
aago	ā ā ɡ ō
aajin	à à d͡ʒ ĩ̀
aakaragba	à á k à ɾ à ɡ͡b á
aake	à á k é
aanu	à á n ṹ
aapọn	à à k͡p ɔ̃̀
aarọ	à à ɾ ɔ̀
aarọ	à á ɾ ɔ̀
aasiki	ā á s ì k í
aasikiriimu	á á s ì k ī ɾ ī ì m ù
aaya	à á j á
aayan	à á j ã́
aayan	ā á j ã́
aayan	ā á j ã̄
aba	à b á
aba	à b ā
aba	ā b à
aba	ā b á
abakọọsi	ā b á k ɔ́ ɔ̀ s ì
abeti aja	ā b ē t í ā d͡ʒ á
abi	à b í
abidi	á b í d í
abidi	ā b í d í
abikẹ	à b í k ɛ́
abilekọ	ā b ī l é k ɔ̄
abimbọla	ā b í ŋ̄ b ɔ́ l á
abiya	ā b í j á
abiyamọ	ā b ī j ā m ɔ̃̄
abiyẹ	ā b ì j ɛ́
abiọdun	ā b í ɔ́ d ṹ
abo	à b ó
abo	à b ō
abo	ā b ò
abo	ā b ō
aboorunyi	ā b ó ò ɾ ũ̀ j í
aboyun	ā b ō j ṹ
abuda	à b ù d á
abuja	à b ú d͡ʒ á
abuke	ā b ū k é
aburada	ā b ù ɾ ā d à
aburada	ā b ū ɾ ā d à
aburahamu	á b ú ɾ á h á m ù
aburo	à b ú ɾ ò
abuubutan	à b ù ù b ù t ã́
abuubutan abuke	à b ù ù b ù t ã́ ā b ū k é
abẹkẹ	à b ɛ̀ k ɛ́
abẹni	à b ɛ̀ n ĩ́
abẹokuta	ā b ɛ́ ò k ú t ā
abẹtẹlẹ	à b ɛ̀ t ɛ́ l ɛ̀
abọriṣa	ā b ɔ̀ ɾ ì ʃ à
abọsẹde	ā b ɔ́ s ɛ̀ d é
adaba	à d à b à
adabalukofi	à d à b à l ù k ò f ì
adado	à d á d ó
adagba	ā d ā ɡ͡b ā
adagun	ā d á ɡ ṹ
adan	à d ã́
ade	ā d é
adebayọ	ā d é b á j ɔ̀
adedire	ā d é d ī ɾ ē
adedure	ā d é d ū ɾ ē
aderonkẹ	ā d é ɾ ó ŋ̄ k ɛ́
adin	à d ĩ̀
aditi	ā d ī t í
adiẹ	ā d ì ɛ̄
ado	à d ó
ado	ā d ó
ado ekiti	ā d ó è k ì t ì
adogan	à d ò ɡ ã́
adua	à d ú à
adubi	à d ù b í
adunni	ā d ũ̀ n ĩ́
adura	à d ú ɾ à
afara	ā f à ɾ à
afara	ā f á ɾ á
afara oyin	ā f á ɾ á ō j ĩ̄
afayafa	ā f à j à f à
afikun	à f ī k ṹ
afinihan	ā f ī n ĩ̄ h ã̀
afinju	ā f ĩ́ d͡ʒ ú
afirika	ā f í ɾ í k à
afojusun	à f ō d͡ʒ ú s ũ̀
afonifoji	à f ō n ĩ́ f ō d͡ʒ ì
afopina	à f ò k͡p ī n ã́
afẹmọjumọ	à f ɛ̀ m ɔ̃́ d͡ʒ ú m ɔ̃́
afẹẹri	à f ɛ́ ɛ̀ ɾ í
afọmọlọmu	ā f ɔ́ m ɔ̃̄ l ɔ́ m ṹ
agabagebe	à ɡ à b à ɡ ē b è
agabangebe	à ɡ à b à ŋ̀ ɡ ē b è
agada	à ɡ à d à
agada	ā ɡ ā d ā
agadagodo	à ɡ á d á ɡ ō d ō
agan	à ɡ ã̀
aganju	ā ɡ ã̄ d͡ʒ ú
aganjuṣọla	ā ɡ ã̄ d͡ʒ ú ʃ ɔ̄ l á
aganran	ā ɡ ã́ ɾ ã́
aganrandi	à ɡ ã́ ɾ ã́ d ì
agbaakin	à ɡ͡b à ā k ĩ̄
agbabọọlu	ā ɡ͡b á b ɔ́ ɔ̀ l ù
agbada	ā ɡ͡b á d á
agbada	ā ɡ͡b ā d ā
agbado	à ɡ͡b à d ō
agbako	à ɡ͡b á k ò
agbala	à ɡ͡b à l á
agbalẹ	ā ɡ͡b á l ɛ̀
agbamurere	à ɡ͡b á m ũ̀ ɾ é ɾ é
agban	à ɡ͡b ã̀
agban	ā ɡ͡b ã̀
agbanrere	à ɡ͡b á ŋ̀ ɾ é ɾ é
agbara	à ɡ͡b à ɾ à
agbara	à ɡ͡b à ɾ á
agbara	ā ɡ͡b à ɾ à
agbara	ā ɡ͡b à ɾ á
agbara	ā ɡ͡b á ɾ ā
agbari	ā ɡ͡b á ɾ í
agbayun	à ɡ͡b á j ũ̄
agbayunkun	à ɡ͡b á j ũ̄ k ṹ
agbe	ā ɡ͡b ē
agbebọ	à ɡ͡b é b ɔ̀
agbelebuu	à ɡ͡b é l é b ù ú
agbigbo	à ɡ͡b ì ɡ͡b ò
agbinrin	à ɡ͡b ĩ̀ ɾ ĩ̀
agbo	à ɡ͡b ò
agbo	à ɡ͡b ó
agbo	à ɡ͡b ō
agbo	ā ɡ͡b ō
agbẹ	à ɡ͡b ɛ̀
agbẹdẹ	à ɡ͡b ɛ̀ d ɛ̄
agbẹjọro	ā ɡ͡b ɛ̄ d͡ʒ ɔ́ ɾ ò
agbọn	à ɡ͡b ɔ̃̀
agbọn	à ɡ͡b ɔ̃̄
agbọn	ā ɡ͡b ɔ̃̀
agbọn	ā ɡ͡b ɔ̃́
agbọnniregun	à ɡ͡b ɔ̃̄ n ĩ̀ ɾ è ɡ ṹ
agbọnrin	à ɡ͡b ɔ̃̀ ɾ ĩ́
agbọrin	à ɡ͡b ɔ̀ ɾ ĩ́
age	à ɡ é
aghan	à ɣ ã̄
agho	a ɣ ó
aghọ	ā ɣ ɔ̄
aghọfẹn	à ɣ ɔ̀ f ɛ̃̄
agidi	ā ɡ í d í
agilinti	ā ɡ í l í ŋ́ t í
agiliti	ā ɡ í l í t í
agira	ā ɡ í ɾ á
agodongbo	ā ɡ ó d ó ŋ́ ɡ͡b ó
agogo	à ɡ ó ɡ ó
agogo	ā ɡ ō ɡ ō
aguala	à ɡ ù à l à
aguda	à ɡ ù d à
agunfọn	à ɡ ũ̀ f ɔ̃̄
aguntan	à ɡ ũ̀ t ã̀
agutan	à ɡ ù t ã̀
ahaya	à h à j á
ahun	ā h ũ̀
ahun	ā h ũ̄
ahun	ā h ṹ
aigbe	à í ɡ͡b è
aika	à ì k à
aika	à ì k ā
ainọn	à í n ɔ̃́
aio	ā í ō
airo	ā í ɾ ō
aisan	à ì s ã̀
aisaya	ā í s á j à
aisikiriimu	á í s ì k ī ɾ ī ì m ù
aja	à d͡ʒ à
aja	ā d͡ʒ á
aja oṣupa	ā d͡ʒ á ò ʃ ù k͡p á
ajaga	à d͡ʒ à ɡ à
ajaja	à d͡ʒ à d͡ʒ á
ajako	ā d͡ʒ á k ō
ajala	à d͡ʒ à l á
ajalemogun	à d͡ʒ à l é m ò ɡ ṹ
ajalọrun	à d͡ʒ à l ɔ́ ɾ ũ̄
ajanaka	ā d͡ʒ ā n ã̄ k á
ajanaku	à d͡ʒ à n ã̀ k ú
ajao	à d͡ʒ à ò
ajari	à d͡ʒ à ɾ í
ajayi	à d͡ʒ à j í
ajaṣẹ	à d͡ʒ à ʃ ɛ́
aje	ā d͡ʒ é
ajeji	à d͡ʒ è d͡ʒ ì
ajereke	ā d͡ʒ è ɾ è k é
ajero	ā d͡ʒ ē ɾ ò
ajewọle	ā d͡ʒ é w ɔ̄ l é
ajibẹtẹ	ā d͡ʒ í b ɛ̄ t ɛ̄
ajijẹn	à d͡ʒ ì d͡ʒ ɛ̃̀
ajikẹ	à d͡ʒ í k ɛ́
ajilẹ	ā d͡ʒ í l ɛ̀
ajinjin	à d͡ʒ ĩ̀ d͡ʒ ĩ̀
ajogun	ā d͡ʒ ō ɡ ũ̄
ajola	à d͡ʒ ò l à
ajule ọrun	à d͡ʒ ù l é ɔ̀ ɾ ũ̄
ajọ	à d͡ʒ ɔ̄
ajọ	ā d͡ʒ ɔ̀
ajọkẹ	à d͡ʒ ɔ̄ k ɛ́
aka	à k á
aka	ā k á
aka	ā k ā
akaka	à k à k à
akala	à k à l à
akamara	à k á m ā ɾ à
akan	ā k ã̀
akanlo ede	à k ã̀ l ò è d è
akara	à k à ɾ à
akara oyinbo	à k à ɾ à ò j ĩ̀ b ó
akarigbo	à k á ɾ ì ɡ͡b ò
akata	ā k á t á
akata	ā k ā t ā
akatanpo	à k à t à ŋ̀ k͡p ó
akeekee	à k é ē k è ē
akekee	ā k é ē k è ē
akere	à k è ɾ é
akewi	ā k é w ì
akika	ā k ī k ā
akikaragba	à k í k à ɾ á ɡ͡b á
akike	à k í k é
akiniku	ā k í n ĩ́ k ù
akire	ā k ī ɾ è
akirun	ā k ì ɾ ũ̄
akitẹṣọ	á k í t ɛ́ ʃ ɔ̀
akoko	à k ó k ó
akoko	ā k ò k ō
akunwọsilẹ	à k ṹ w ɔ́ s í l ɛ̀
akunyungba	ā k ũ̀ j ũ̀ ɡ͡b à
akurẹ	à k ú ɾ ɛ́
akurọ	à k ù ɾ ɔ̀
akẹ	à k ɛ̀
akẹkọọ	ā k ɛ́ k ɔ̀ ɔ́
akọ	à k ɔ̀
akọ	ā k ɔ̄
akọ efu	ā k ɔ̄ è f ù
akọgirisi	à k ɔ́ ɡ ì ɾ ì s ì
akọsẹjaye	à k ɔ̄ s ɛ̀ d͡ʒ ā j é
ala	à l à
ala	à l á
alaadi	à l à á d ì
alaafia	à l à á f í à
alaafin	ā l á à f ĩ̄
alaalẹ	ā l ā ā l ɛ́
alaamu	à l á à m ũ̀
alaamu	ā l á à m ũ̀
alaaye	ā l à à j è
alaba	à l à b á
alabasita	ā l ā b á s í t à
alabi	à l à b í
alade	à l à d é
alade	ā l á d é
alagabagebe	ā l á ɡ à b à ɡ ē b è
alagabangebe	ā l á ɡ à b à ŋ̀ ɡ ē b è
alagba	ā l á ɡ͡b à
alagidi	ā l á ɡ í d í
alagoogo	ā l á ɡ ò ó ɡ ó
alailowaya	ā l á ì l ō w á j à
alakara	ā l á k à ɾ à
alake	ā l á k é
alaketu	ā l á k é t ū
alalupayida	ā l á l ú k͡p à j í d à
alamisi	à l à m í s ì
alangba	ā l á ŋ̀ ɡ͡b á
alantakun	ā l á ŋ̀ t ā k ũ̀
alapaandẹdẹ	ā l á k͡p à á ŋ̀ d ɛ̀ d ɛ̀
alapinni	ā l á k͡p ĩ̄ n ĩ̄
alara	ā l á ɾ á
alarabara	ā l á ɾ à b ā ɾ à
alaruba	à l à ɾ ù b ā
alatagba	ā l á t ā ɡ͡b à
alaye	à l à j é
alaye	ā l á j é
alaye	ā l ā j é
alaṣẹrẹ	ā l á ʃ ɛ̀ ɾ ɛ́
ale	à l è
aleebu	à l é é b ù
aleebu ara	à l é é b ù ā ɾ ā
alegba	à l é ɡ͡b à
alepa	à l é k͡p ā
alepata	ā l è k͡p ā t ā
alifabẹẹti	á l í f á b ɛ́ ɛ̀ t ì
alikama	à l ì k á m à
aloe	á l ó è
aloju	à l ò d͡ʒ ù
aloku	à l ò k ù
alubarika	à l ù b á ɾ í k à
alubasa	à l ù b á s à
alubọsa	à l ù b ɔ́ s à
alufaa	à l ù f á à
alugbagba	ā l ù ɡ͡b à ɡ͡b à
alujọnnu	à l ù d͡ʒ ɔ̃̀ n ṹ
alukawani	à l ù k á w à n ĩ́
alukenbu	à l ù k é ŋ́ b ù
alukiamọ	à l ù k ì á m ɔ̃̀
aluko	à l ù k ò
alumọgaji	à l ù m ɔ̃́ ɡ à d͡ʒ í
alumọkọrọyi	à l ù m ɔ̃̀ k ɔ́ ɾ ɔ́ j í
alumọni	à l ù m ɔ̃́ n ĩ̀
alupayida	à l ú k͡p à j í d à
alupipi	ā l ū k͡p ì k͡p ì
alupupu	ā l ù k͡p ù k͡p ù
aluwala	à l ù w à l á
alẹ	ā l ɛ̀
alẹ	ā l ɛ́
amala	à m à l à
ami ohun	à m ĩ̀ ō h ũ̀
amodi	à m ó d ī
amuga	à m ṹ ɡ ā
amulu	à m ṹ l ù
amunisin	ā m ṹ n ĩ̄ s ĩ̀
amure	à m ũ̀ ɾ è
amẹrika	ā m ɛ́ ɾ í k à
amọ	à m ɔ̃́
amọ	ā m ɔ̃̀
amọtẹkun	à m ɔ̃̀ t ɛ́ k ũ̀
an	ã́
an	ã̄
ana	à n ã́
ana	à n ã̄
anabi	à n ã́ b ì
anago	à n ã̀ ɡ ó
anfaani	à ŋ̀ f à à n ĩ́
aniani	à n ĩ́ ã̀ n ĩ́
anikẹ	à n ĩ́ k ɛ́
aniyan	à n ĩ́ j ã̀
ankali	á ŋ́ k à l í
ankuri	à ŋ̀ k ú ɾ í
anlugbua	ā ŋ́ l ù ɡ͡b ū à
anti	à ŋ̀ t í
anupe	à n ũ̀ k͡p ē
ao	à ō
ao	ā ó
aoolaye	ā ó ò l á j è
apa	à k͡p à
apa	à k͡p á
apa	ā k͡p á
apaadi	à k͡p á à d ì
apala	ā k͡p á l á
apari	ā k͡p á ɾ í
aparo	à k͡p ā ɾ ò
apatamaja	à k͡p á t á m ā d͡ʒ à
apekẹ	à k͡p è k ɛ́
apetumodu	à k͡p ē t ū m ō d ù
apiiri	à k͡p í ì ɾ ì
apilẹkọ	à k͡p ī l ɛ̀ k ɔ̄
apo	à k͡p ò
apo	ā k͡p ó
apo orooro	à k͡p ò ò ɾ ó ò ɾ ō
apola	à k͡p ó l à
apopona	à k͡p ó k͡p ó n ã̀
apoporo	ā k͡p ō k͡p ō ɾ ō
apotọ	à k͡p ò t ɔ̀
apẹja	ā k͡p ɛ̄ d͡ʒ ā
apẹrẹ	ā k͡p ɛ̀ ɾ ɛ̀
apẹẹrẹ	à k͡p ɛ̄ ɛ̄ ɾ ɛ̄
apọn	à k͡p ɔ̃́
ara	à ɾ à
ara	à ɾ á
ara	ā ɾ á
ara	ā ɾ ā
araarọ	à ɾ à á ɾ ɔ̀
aragbayamuya	ā ɾ á ɡ͡b ā j ā m ṹ j ā
aragberi	à ɾ á ɡ͡b ē ɾ í
aragbiji	ā ɾ á ɡ͡b ì d͡ʒ í
aran	à ɾ ã́
arere	ā ɾ è ɾ ē
arifin	à ɾ í f ĩ́
arikẹ	à k͡p è k ɛ́
ariro	ā ɾ í ɾ ō
ariwa	à ɾ í w á
ariya	à ɾ í j á
aroko	à ɾ ō k ò
arun	à ɾ ũ̀
arun	à ɾ ṹ
arun	ā ɾ ũ̄
arun abẹgẹẹja	à ɾ ũ̀ ā b ɛ́ ɡ ɛ̀ ɛ́ d͡ʒ à
arun amọ	à ɾ ũ̀ à m ɔ̃́
arun awu	à ɾ ũ̀ ā w ú
arun gbajumọ	à ɾ ũ̀ ɡ͡b ā d͡ʒ ú m ɔ̃̀
arun jakutẹ	à ɾ ũ̀ d͡ʒ à k ù t ɛ̀
arun korikori	à ɾ ũ̀ k ò ɾ ì k ò ɾ ì
arun mẹdọwu	à ɾ ũ̀ m ɛ́ d ɔ̀ w ú
arun rọmọlaparọmọlẹsẹ	à ɾ ũ̀ ɾ ɔ̄ m ɔ̃̄ l á k͡p á ɾ ɔ̄ m ɔ̃̄ l ɛ́ s ɛ̀
arundinlaaadọta	à ɾ ṹ d ĩ́ l á à á d ɔ́ t ā
arundinlogoji	à ɾ ṹ d ĩ́ l ó ɡ ó d͡ʒ ì
arundinlogun	à ɾ ṹ d ĩ́ l ó ɡ ṹ
arundinlọgbọn	à ɾ ṹ d ĩ́ l ɔ́ ɡ͡b ɔ̃̀
arundinlọgọta	à ɾ ṹ d ĩ́ l ɔ́ ɡ ɔ́ t ā
arungbo	ā ɾ ũ̄ ɡ͡b ó
arẹmọ	à ɾ ɛ̀ m ɔ̃̄
arọni	à ɾ ɔ̀ n ĩ̀
asabuta	à s à b ù t ā
asia	à s í á
asin	ā s ĩ́
asẹyin	ā s ɛ́ j ĩ̀
asọsọ	ā s ɔ̄ s ɔ̄
ata	ā t ā
ata tataṣe	ā t ā t à t à ʃ é
ataare	ā t ā ā ɾ ē
ataju	ā t ā d͡ʒ ú
atalaata	à t à l á á t à
atalẹ	ā t ā l ɛ̀
atamatase	ā t ā m á t à s é
atampako	à t à ŋ̀ k͡p à k ò
atanda	à t ã̀ d á
atannigbọnnini	ā t ã̄ n ĩ̄ ɡ͡b ɔ̃́ n ĩ̄ n ĩ̄
atanpako	à t à ŋ̀ k͡p à k ò
atari	à t à ɾ í
atawe	ā t à w é
ataọja	à t á ɔ́ d͡ʒ ā
ati	à t ī
atiala	ā t í á l á
atibaba	à t í b à b à
atimọle	à t ì m ɔ̃́ l é
atini	à t ì n ĩ́
atinukẹ	ā t ī n ṹ k ɛ́
atioro	ā t í ò ɾ ō
atipo	à t ì k͡p ó
atorin	à t ō ɾ ĩ̀
atunyẹwo	à t ṹ j ɛ̀ w ò
atupa	à t ù k͡p à
atẹjiṣẹ	à t ɛ̀ d͡ʒ í ʃ ɛ́
atẹlẹwọ	à t ɛ́ l ɛ̄ w ɔ́
atẹlẹọ	à t ɛ́ l ɛ̄ ɔ́
atọgbẹ	à t ɔ̀ ɡ͡b ɛ̄
atọka	ā t ɔ́ k ā
atọsi	à t ɔ̀ s í
atọsin	à t ɔ̀ s ĩ́
atọọka	ā t ɔ́ ɔ̀ k ā
atọọle	ā t ɔ̀ ɔ́ l é
awa	à w ā
awe	à w é
awo	à w ō
awo	ā w ó
awo	ā w ō
awodi	à w ò d ì
awoko	à w ò k ō
awolọwọ	ā w ó l ɔ́ w ɔ̀
aworan	à w ò ɾ ã́
awori	à w ó ɾ ì
awujalẹ	ā w ù d͡ʒ ā l ɛ̀
awujẹ	à w ù d͡ʒ ɛ̀
awurọ	à w ú ɾ ɔ̀
awusa	ā w ú s á
awuyewuye	ā w ū j ē w ū j ē
awọ	à w ɔ̀
awọ	ā w ɔ̄
awọn	à w ɔ̃̀
awọn	à w ɔ̃̄
awọn	ā w ɔ̃́
awọsanma	à w ɔ̄ s ã́ m à
aya	à j à
aya	ā j ā
ayaba	ā j ā b ā
ayafọto	ā j ā f ɔ́ t ò
ayan	à j ã̀
ayanfẹ	à j ã̀ f ɛ́
ayangalu	à j ã̀ ɡ ā l ú
ayangburẹn	à j ã́ ɡ͡b ù ɾ ɛ̃̀
aye	à j è
aye	ā j è
aye	ā j é
ayegbe	à j è ɡ͡b è
ayekootọ	ā j é k ò ó t ɔ́
ayelala	ā j é l á l ā
ayerẹ	ā j è ɾ ɛ́
ayikule	ā j í k ú l è
ayinrin	à j ĩ̀ ɾ ĩ́
ayinrin	ā j ĩ̀ ɾ ĩ̀
ayiyọn	à j í j ɔ̃̀
ayu	ā j ù
ayun	ā j ũ̀
ayọ	ā j ɔ̀
ayọpọrọ	ā j ɔ̀ k͡p ɔ̀ ɾ ɔ́
aza	ā z á
aṣa	à ʃ à
aṣa	à ʃ á
aṣakẹ	à ʃ à k ɛ́
aṣamu	à ʃ à m ṹ
aṣanwewe	à ʃ á ŋ̀ w é w é
aṣanwewe	à ʃ á ŋ́ w ē w é
aṣegbefabo	ā ʃ è ɡ͡b è f á b ō
aṣigba	à ʃ í ɡ͡b à
aṣipa	ā ʃ í k͡p ā
aṣiri	à ʃ í ɾ í
aṣiwaju	ā ʃ í w á d͡ʒ ú
aṣẹ	à ʃ ɛ́
aṣẹ	à ʃ ɛ̄
aṣẹ	ā ʃ ɛ̀
aṣẹwo	ā ʃ ɛ́ w ó
aṣẹṣe	à ʃ ɛ̀ ʃ ē
aṣọ	ā ʃ ɔ̄
aṣọle	ā ʃ ɔ́ l é
aṣọṣọ	ā ʃ ɔ́ ʃ ɔ́
aọfin	à ɔ̀ f ĩ̄
aọn	à ɔ̃̀
b	b
b	b í
baali	b á á l ì
baara	b á á ɾ à
baba	b à b à
baba	b à b á
baba	b á b à
baba	b á b á
baba	b ā b ā
baba baba	b à b á b à b á
baba iya	b à b á ì j á
babaganran	b à b à ɡ ã̄ ɾ ã̄
babalawo	b ā b ā l á w ō
bairo	b á í ɾ ò
balaga	b à l á ɡ à
balogun	b ā l ó ɡ ũ̄
bantẹ	b à ŋ̀ t ɛ́
barawo	b à ɾ á w ò
bareke	b á ɾ é k è
bariba	b à ɾ ì b á
bata	b à t à
bata	b à t á
baṣọrun	b ā ʃ ɔ̀ ɾ ũ̄
baọlọji	b à ɔ́ l ɔ́ d͡ʒ ì
beba	b é b à
beru	b è ɾ ù
bi	b ì
bi	b í
bi	b ī
bibeli	b í b é l ì
bikita	b ì k í t à
bilisi	b ì l í s ì
birikila	b í ɾ í k ì l à
bojuboju	b ō d͡ʒ ú b ō d͡ʒ ú
buburu	b ú b ū ɾ ú
bukata	b ù k á t à
bulausi	b ú l á ù s ì
burẹdi	b ú ɾ ɛ́ d ì
bẹnẹ	b ɛ̀ n ɛ̃̀
bọsẹde	b ɔ́ s ɛ̀ d é
bọta	b ɔ́ t à
bọọlu	b ɔ́ ɔ̀ l ù
d	d
d	d í
daadaa	d á ā d á ā
dada	d à d ā
dafa	d á f á
dagba	d à ɡ͡b à
dagbure	d á ɡ͡b ū ɾ ē
daji	d á d͡ʒ ì
danṣiki	d à ŋ́ ʃ í k í
darandaran	d á ɾ ã̀ d á ɾ ã̀
darandaran	d ā ɾ ã̄ d ā ɾ ã̄
dawa	d á w à
dedere	d è d è ɾ é
deji	d é d͡ʒ ì
di	d ì
di	d í
di	d ī
difa	d í f á
digbolu	d ì ɡ͡b ò l ù
digbolugi	d ì ɡ͡b ò l ū ɡ ī
dilali	d ì l á l ì
dindinrin	d ĩ̀ d ĩ̀ ɾ ĩ̀
disai	d ì s á ì
diutaronomi	d ī ū t ā ɾ ó n ó m ĩ̀
dodo	d ò d ò
dodo	d ò d ō
dodo	d ó d ò
dodo	d ō d ò
dodo	d ō d ō
dokita	d ó k í t à
dokita eyin	d ó k í t à ē j ĩ́
dokita iṣatunto eyin	d ó k í t à ì ʃ à t ṹ t ò ē j ĩ́
dubulẹ	d ù b ú l ɛ̀
dudu	d ú d ú
dukia	d ú k ì á
dumbu	d ú ŋ́ b ú
dunaadura	d ú n ã̀ ã́ d ú ɾ à
dunbu	d ú ŋ́ b ú
dundun	d ũ̀ d ṹ
duniyan	d ú n ĩ́ j ã̀
duo	d ú ó
duro	d ú ɾ ó
duuru	d ù ù ɾ ù
dẹdodẹdo	d ɛ̄ d ò d ɛ̄ d ò
dẹdẹrẹkun	d ɛ̀ d ɛ̀ ɾ ɛ̄ k ʊ̃̀
dẹnmarki	d ɛ̃́ m á ɾ k ì
dọla	d ɔ́ l à
e	e
e	é
e	ē
ebibo	è b í b ó
ebute	è b ú t é
ede	è d è
ede	ē d è
ede	ē d é
edekoyede	è d è k ò j é d è
edidu	è d í d ú
edidun	è d í d ṹ
edio	ē d ī ó
eebo	è è b ó
eedi	è è d ì
eedi	é è d ì
eedu	è é d ú
eegbọn	ē é ɡ͡b ɔ̃̄
eegun paari	ē ē ɡ ũ̄ k͡p á á ɾ ì
eeje	ē é d͡ʒ ē
eeji	ē é d͡ʒ ì
eekan	è é k ã́
eekanna	è é k ã́ n ã́
eeku	è è k ù
eeku	è è k ú
eeku	è ē k ù
eeku	ē ē k ū
eepinni	ē é k͡p ĩ̀ n ĩ̀
eera	è è ɾ à
eetu	è è t ù
eetu	è è t ú
eetu	è é t ú
eewọ	è è w ɔ̀
eeyi	è é j ī
efinrin	ē f ĩ̄ ɾ ĩ̄
egbigbo	è ɡ͡b ì ɡ͡b ò
egbin	ē ɡ͡b ĩ̄
egbogbo	ē ɡ͡b ò ɡ͡b ò
ege	è ɡ é
eghighọ	è ɣ ì ɣ ɔ̀
egho	e ɣ ó
eghoro	e ɣ ō ɾ ō
egigun	ē ɡ í ɡ ṹ
egigun	ē ɡ ī ɡ ũ̄
egun	è ɡ ũ̀
egungun	ē ɡ ũ̄ ɡ ũ̄
egungun	ē ɡ ṹ ɡ ṹ
egunyeye	ē ɡ ũ̄ j ē j ē
egure	ē ɡ ū ɾ è
eguru	ē ɡ ú ɾ ù
ehihẹn	è h í h ɛ̃́
ehikọ	ē h ì k ɔ́
ehoro	ē h ō ɾ ō
eighọ	è ì ɣ ɔ̀
eijẹ	ē í d͡ʒ ɛ̄
eje	è d͡ʒ ē
eji	è d͡ʒ ì
eji	è d͡ʒ í
eji	ē d͡ʒ ī
ejide	è d͡ʒ ì d é
ejidinlaaadọta	è d͡ʒ ì d ĩ́ l á à á d ɔ́ t ā
ejidinlogoji	è d͡ʒ ì d ĩ́ l ó ɡ ó d͡ʒ ì
ejidinlogun	è d͡ʒ ì d ĩ́ l ó ɡ ṹ
ejidinlọgbọn	è d͡ʒ ì d ĩ́ l ɔ́ ɡ͡b ɔ̃̀
ejidinlọgọta	è d͡ʒ ì d ĩ́ l ɔ́ ɡ ɔ́ t ā
ejigbo	è d͡ʒ ì ɡ͡b ò
ejijẹ	ē d͡ʒ í d͡ʒ ɛ̄
ejika	è d͡ʒ ì k á
ejila	è d͡ʒ ì l á
ejilelaaadọta	è d͡ʒ ì l é l á à á d ɔ́ t ā
ejilelogoji	è d͡ʒ ì l é l ó ɡ ó d͡ʒ ì
ejilelogun	è d͡ʒ ì l é l ó ɡ ṹ
ejilelọgbọn	è d͡ʒ ì l é l ɔ́ ɡ͡b ɔ̃̀
ejirẹ	è d͡ʒ ì ɾ ɛ́
ejo	è d͡ʒ ó
ejo	ē d͡ʒ ò
ejo abewerẹ	ē d͡ʒ ò ā b é w é ɾ ɛ́
ejo abiruṣoro	ē d͡ʒ ò ā b ì ɾ ù ʃ ō ɾ ó
ejo mọnamọna	ē d͡ʒ ò m ɔ̃́ n ã́ m ɔ̃́ n ã́
ejo paramọlẹ	ē d͡ʒ ò k͡p ā ɾ ā m ɔ̃́ l ɛ̀
ejo ṣebe	ē d͡ʒ ò ʃ è b é
ejo ọka	ē d͡ʒ ò ɔ̄ k á
ejo ọwun	ē d͡ʒ ò ɔ̄ w ũ̄
ekeji	è k ē d͡ʒ ì
ekikanna	è k í k ã́ n ã́
ekiti	è k ì t ì
eko	è k ó
ekoidẹ	è k ó í d ɛ̄
ekolo	ē k ò l ó
ekulu	è k ù l ù
ekura	ē k ū ɾ á
ekute	è k ú t é
elede meji	ē l é d è m é d͡ʒ ì
elegbede	ē l é ɡ͡b è d è
elegede	ē l é ɡ é d é
elegee ara	ē l é ɡ è é à ɾ à
elegosi	ē l é ɡ ò s ì
elejigbo	ē l é d͡ʒ ì ɡ͡b ò
elemure	ē l é m ũ̀ ɾ é
eleruku	ē l é ɾ ù k ú
eleruuwa	ē l é ɾ ù ú w à
elija	è l í d͡ʒ à
eliju	è l ì d͡ʒ ù
emi	è m ĩ̄
emimi	è m ĩ́ m ĩ́
emurẹn	ē m ṹ ɾ ɛ̃̄
eni	è n ĩ̀
eni	è n ĩ́
eni	ē n ĩ́
eniyan	è n ĩ̀ j ã̀
epipa	è k͡p í k͡p á
epiya	è k͡p ì j à
epo	è k͡p ò
epo	è k͡p ō
epo	ē k͡p ō
epo rọbi	ē k͡p ō ɾ ɔ̀ b ì
ere	è ɾ è
ere	è ɾ é
ere	è ɾ ē
ere	ē ɾ è
ere	ē ɾ é
ere oṣupa	ē ɾ é ò ʃ ù k͡p á
erekuṣu	ē ɾ é k ù ʃ ù
ereṣupa	ē ɾ é ʃ ù k͡p á
erigi	è ɾ ì ɡ ì
erigi	ē ɾ ì ɡ ì
erikọ	ē ɾ í k ɔ̄
erin	ē ɾ ĩ́
erin	ē ɾ ĩ̄
erinlẹ	ē ɾ ĩ̄ l ɛ̀
erinmi	ē ɾ ĩ̄ m ĩ̄
erinmilokun	ē ɾ ĩ̄ m ĩ̄ l ó k ũ̄
eriru	ē ɾ í ɾ ú
erirun	è ɾ í ɾ ṹ
erongba	è ɾ ò ŋ̀ ɡ͡b à
erun	è ɾ ṹ
ese	è s è
ese	ē s è
ese	ē s é
eso	è s ō
eso ajara	è s ō à d͡ʒ à ɾ à
esuro	è s ú ɾ ó
esuru	è s ú ɾ ú
esuu	è s ú ú
eti	ē t í
etitan	è t ì t ã̀
etitu	è t í t ú
eu	ē ú
ewe	è w ē
ewe	ē w è
ewe	ē w é
ewebẹ	ē w é b ɛ̀
ewedo	ē w é d ò
eweko	ē w é k ō
ewi	è w í
ewi	ē w ì
ewu	ē w ú
ewurẹ	ē w ú ɾ ɛ́
eye	è j é
eyin	ē j ĩ́
eyin erin	ē j ĩ́ ē ɾ ĩ̄
eṣi	è ʃ í
eṣia	é ʃ í à
eṣinṣin	ē ʃ ĩ̄ ʃ ĩ̄
eṣu	è ʃ ù
f	f
f	f í
faara	f á á ɾ à
faari	f á à ɾ í
fadaka	f à d á k à
fadọrọlemi	f á d ɔ́ ɾ ɔ̀ l é m ĩ̄
fagunwa	f á ɡ ṹ w à
famu	f à m ũ̄
fanadiọmu	f à n ã́ d í ɔ́ m ũ̀
fanimọra	f ā n ī m ɔ́ ɾ ā
faranse	f ā ɾ ā ŋ̄ s é
farao	f á ɾ á ò
fawẹli	f á w ɛ̀ l ì
fere	f è ɾ è
ferese	f è ɾ è s é
fi	f i
fi	f í
fidio	f í d í ò
fiku	f í k ù
fila	f ì l à
fisiisi	f í s í ì s ì
fitila	f ì t í l à
fitina	f ì t í n ã̀
fonọlọji	f ō n ɔ́ l ɔ́ d͡ʒ ì
foonu	f ó ò n ũ̀
fu	f ū
fulani	f ú l à n ĩ́
funfun	f ũ̄ f ũ̄
funsaari	f ṹ s á á ɾ í
fura	f ú ɾ á
fura	f ū ɾ ā
fẹ	f ɛ̀
fẹ	f ɛ́
fọ	f ɔ̀
fọ	f ɔ́
fọrọ wa lẹnu wo	f ɔ̀ ɾ ɔ̀ w á l ɛ́ n ũ̄ w ò
fọrọ wa ọrọ wo lẹnu	f ɔ̀ ɾ ɔ̀ w á ɔ̀ ɾ ɔ̀ w ò l ɛ́ n ũ̄
fọto	f ɔ́ t ò
g	ɡ
g	ɡ í
gaari	ɡ à á ɾ ì
gabasi	ɡ à b ā s ì
gadagbagadagba	ɡ à d à ɡ͡b à ɡ ā d ā ɡ͡b ā
gafara	ɡ á f á ɾ à
gambia	ɡ á ŋ́ b í à
gana	ɡ á n à
ganbia	ɡ á ŋ́ b í à
gangan	ɡ ã́ ɡ ã̄
garawa	ɡ ā ɾ ā w ā
gari	ɡ à ɾ í
gb	ɡ͡b
gb	ɡ͡b ì
gba	ɡ͡b à
gba	ɡ͡b á
gbagbe	ɡ͡b à ɡ͡b é
gbagbọ	ɡ͡b à ɡ͡b ɔ́
gbaguuda	ɡ͡b á ɡ ù ú d á
gbalaja	ɡ͡b ā l ā d͡ʒ ā
gbalẹ	ɡ͡b á l ɛ̀
gbanjo	ɡ͡b à ŋ̀ d͡ʒ ō
gbe	ɡ͡b è
gbe	ɡ͡b é
gbede	ɡ͡b é d è
gbedegbeyọ	ɡ͡b é d è ɡ͡b é j ɔ̀
gbi	ɡ͡b ì
gbigba	ɡ͡b í ɡ͡b à
gbigba	ɡ͡b í ɡ͡b á
gbo	ɡ͡b ò
gbo	ɡ͡b ó
gbo	ɡ͡b ō
gbogbo	ɡ͡b ō ɡ͡b ō
gbolohun	ɡ͡b ó l ó h ũ̀
gbẹdu	ɡ͡b ɛ̀ d ū
gbẹdẹ	ɡ͡b ɛ̄ d ɛ̄
gbẹn	ɡ͡b ɛ̃̀
gbẹnagbẹna	ɡ͡b ɛ́ n ã̀ ɡ͡b ɛ́ n ã̀
gbẹrẹfuutu	ɡ͡b ɛ̄ ɾ ɛ̄ f ú ù t ù
gbẹsẹ le	ɡ͡b ɛ́ s ɛ̀ l é
gbọfungbọfun	ɡ͡b ɔ̀ f ũ̄ ɡ͡b ɔ̀ f ũ̄
gbọkan le	ɡ͡b ɔ́ k ã̀ l é
gbọmọgbọmọ	ɡ͡b ɔ́ m ɔ̃̄ ɡ͡b ɔ́ m ɔ̃̄
gbọrọ	ɡ͡b ɔ̀ ɾ ɔ̀
gege	ɡ è ɡ é
gele	ɡ è l è
ghan	ɣ ã́
ghan	ɣ ã̄
ghun	ɣ ũ̀
ghọn	ɣ ɔ̃́
gi	ɡ í
girimọkai	ɡ í ɾ í m ɔ̃́ k á ì
girimọkayi	ɡ í ɾ í m ɔ̃́ k á j ì
goje	ɡ ò d͡ʒ é
goli	ɡ ō l í
gomina	ɡ ó m ĩ̀ n ã̀
gulukoosi	ɡ ú l ú k ó ò s ì
gunugun	ɡ ú n ũ̄ ɡ ṹ
guusu	ɡ ú ú s ù
gwẹ	ɡʷ ɛ̀
gẹẹsi	ɡ ɛ̀ ɛ́ s ì
gọgọ	ɡ ɔ̀ ɡ ɔ̀
gọlọmiṣọ	ɡ ɔ̀ l ɔ̀ m ĩ̀ ʃ ɔ̀
gọmbọ	ɡ ɔ̀ ŋ̀ b ɔ́
h	h
h	h í
habakuku	h á b á k ú k ù
hanturu	h ã̀ t ú ɾ ú
he	h è
he	h ē
hi	h í
hilahilo	h í l à h í l ò
horo	h ó ɾ ó
hunwa	h ũ̄ w à
hẹngwa	h ɛ̃̄ ɡʷ à
i	i
i	í
i	ī
iarẹfa	ì à ɾ ɛ̀ f à
iba	ì b à
iba	ì b á
iba	ì b ā
iba	ī b à
iba	ī b á
iba	ī b ā
iba	ɪ̄ b à
ibaaka	ì b à á k à
ibaaka	ì b á á k à
ibaaka	ì b ā ā k ā
ibadan	ì b à d ã̀
ibakasiẹ	ì b á k ā s í ɛ̄
ibakasiẹ	ì b ā k ā s í ɛ̄
ibantẹ	ì b à ŋ̀ t ɛ́
ibarapa	ì b à ɾ à k͡p á
ibeji	ì b ē d͡ʒ ì
ibi	ì b ì
ibi	ì b í
ibi	ì b ī
ibi	ī b í
ibi	ī b ī
ibidunmoye	ì b í d ũ̀ m ó j è
ibikibi	ī b ī k í b ī
ibo	ì b ò
ibo	ì b ó
iboji	ī b ò d͡ʒ ī
iboji	ī b ó d͡ʒ ì
iboji	ī b ō d͡ʒ ì
ibunu	ì b ù n ṹ
ibusun	ī b ù s ũ̀
ibọn	ì b ɔ̃̄
ibọn	ī b ɔ̃́
ibọn agba	ì b ɔ̃̄ à ɡ͡b á
ibọn agbelejika	ì b ɔ̃̄ à ɡ͡b é l é d͡ʒ ì k á
ibọn jagamu	ì b ɔ̃̄ d͡ʒ ā ɡ ā m ũ̀
ida	ì d á
ida	ì d ā
ida	ī d à
idaaṣa	ī d à á ʃ à
idae	ì d à é
idaji	ì d á d͡ʒ í
idaji	ì d ā d͡ʒ ì
idameje	ì d á m é d͡ʒ ē
idamẹfa	ì d á m ɛ́ f à
idamẹjọ	ì d á m ɛ́ d͡ʒ ɔ̄
idamẹwaa	ì d á m ɛ́ w à á
idanre	ì d ã̀ ɾ è
idarin	ì d ā ɾ ĩ̄
idata	ì d ā t ā
ideegbe	ì d é è ɡ͡b è
ideregbe	ì d è ɾ è ɡ͡b è
idi	ì d ì
idi	ì d í
idi	ī d ì
idi	ī d í
idigbo	ī d í ɡ͡b ó
idije	ì d í d͡ʒ ē
idile	ì d í l é
idogbe	ì d ò ɡ͡b é
idoha	ì d ò h á
idowu	ì d ò w ú
idunaadura	ì d ú n ã̀ ã́ d ú ɾ à
idẹ	ī d ɛ̄
ifa	ì f à
ifa	ī f á
ifa	ɪ̄ f á
ifaara	ì f á á ɾ à
ifabunmi	ī f á b ũ̀ m ĩ̄
ifadọrọlemi	ɪ̄ f á d ɔ́ ɾ ɔ̀ l é m ĩ̄
ifalaye	ī f á l á j è
ifalọọrọ	ī f á l ɔ̀ ɔ́ ɾ ɔ̀
ifalọọọrọ	ī f á l ɔ́ ɔ̀ ɔ́ ɾ ɔ̀
ifamugbaẹ	ī f á m ũ̀ ɡ͡b à ɛ́
ifayẹmi	ī f á j ɛ̄ m ĩ̄
ife	ī f ē
ifirosinroojẹ	ì f ì ɾ ó s ĩ́ ɾ ò ó d͡ʒ ɛ̄
ifo	ì f ò
ifo	ī f ō
ifohunpeniyan	ì f ō h ũ̄ k͡p è n ĩ̀ j ã̀
iforiti	ì f ō ɾ í t ì
ifura	ì f ū ɾ ā
ifẹ	ī f ɛ̀
ifẹhonuhan	ì f ɛ̀ h ó n ṹ h ã̀
ifẹyinti	ì f ɛ̀ j ĩ̀ t ì
ifọ	ī f ɔ̀
ifọn	ī f ɔ̃́
ifọrọdara	ì f ɔ̀ ɾ ɔ̀ d á ɾ à
ifọrọwanilẹnuwo	ì f ɔ̀ ɾ ɔ̀ w á n ĩ̄ l ɛ́ n ũ̄ w ò
ifọrọwero	ì f ɔ̀ ɾ ɔ̀ w é ɾ ò
igala	ì ɡ á l à
igala	ì ɡ ā l à
igala	ī ɡ á l à
igara	ì ɡ á ɾ á
igba	ì ɡ͡b à
igba	ì ɡ͡b á
igba	ī ɡ͡b à
igba	ī ɡ͡b á
igba	ī ɡ͡b ā
igbabọọlu	ì ɡ͡b á b ɔ́ ɔ̀ l ù
igbagbọ	ì ɡ͡b à ɡ͡b ɔ́
igbalẹ	ì ɡ͡b á l ɛ̀
igbayẹkẹtẹ	ì ɡ͡b á j ɛ̀ k ɛ̀ t ɛ̀
igbi	ì ɡ͡b ì
igbin	ì ɡ͡b ĩ̀
igbin	ì ɡ͡b ĩ́
igbio	ī ɡ͡b ī ó
igbiwo	ī ɡ͡b ī w ó
igbo kijikiji	ī ɡ͡b ó k ì d͡ʒ ī k ì d͡ʒ ī
igbomina	ì ɡ͡b ó m ĩ̀ n ã̀
igbọnwọ	ì ɡ͡b ɔ̃̀ w ɔ́
igbọnwọ	ì ɡ͡b ɔ̃̄ w ɔ́
ige	ì ɡ è
igi	ī ɡ ī
igun	ī ɡ ṹ
ihinrere	ì h ĩ̀ ɾ ē ɾ ē
ihoho	ì h ò h ò
ijakadi	ì d͡ʒ à k ā d ì
ijakariwọ	ì d͡ʒ à k á ɾ ì w ɔ̀
ijakariọ	ì d͡ʒ à k á ɾ ì ɔ̀
ijala	ì d͡ʒ á l á
ijalọ	ì d͡ʒ à l ɔ̄
ijapa	ì d͡ʒ à k͡p á
ijapa okun	ì d͡ʒ à k͡p á ò k ũ̄
ijimere	ì d͡ʒ í m è ɾ è
ijokoo	ì d͡ʒ ó k ò ó
ijumu	ì d͡ʒ ù m ṹ
ijẹbu	ì d͡ʒ ɛ̀ b ú
ijẹrẹ	ì d͡ʒ ɛ́ ɾ ɛ́
ijẹṣa	ì d͡ʒ ɛ̀ ʃ à
ijọ	ì d͡ʒ ɔ̄
ijọ	ī d͡ʒ ɔ́
ijọba	ì d͡ʒ ɔ̄ b ā
ijọba amunisin	ì d͡ʒ ɔ̄ b ā ā m ṹ n ĩ̄ s ĩ̀
ika	ì k á
ika ifabẹla	ì k ā ì f á b ɛ̀ l á
ikalẹ	ì k á l ɛ̀
ikan	ī k ã́
ikaniyan	ì k à n ĩ̀ j ã̀
ikara	ì k à ɾ à
ike	ì k é
ike	ī k é
ike	ī k ē
ikede	ì k é d ē
ikin	ī k ĩ́
ikin	ī k ĩ̄
ikoidẹ	ì k ó í d ɛ̄
ikoko	ì k ò k ò
ikooko	ì k ō ō k ò
ikoriko	ì k ò ɾ ī k ò
iku	ī k ú
ikun	ì k ũ̀
ikun	ì k ṹ
ikun	ī k ũ̀
ikun	ī k ũ̄
ikun	ī k ṹ
ikuukuu	ì k ù ū k ù ū
ikẹnnẹ	ì k ɛ̃́ n ɛ́
ilaburu	ì l á b ù ɾ ù
ilajẹ	ì l à d͡ʒ ɛ̄
ilakaka	ì l à k à k à
ile	ī l é
ile awoṣifila	ī l é à w ò ʃ í f ì l à
ile aye	ī l é ā j é
ile ifowopamọ	ī l é ì f ō w ó k͡p ā m ɔ̃́
ile ikawe	ī l é ì k à w é
ile iwosan	ī l é ì w ò s ã̀
ile kikọ	ī l é k í k ɔ́
ile oyin	ī l é ō j ĩ̄
ile ẹjọ	ī l é ɛ̄ d͡ʒ ɔ́
ile ẹjọ kotẹmilọrun	ī l é ɛ̄ d͡ʒ ɔ́ k ò t ɛ́ m ĩ̄ l ɔ́ ɾ ũ̀
ile ẹkọ	ī l é ɛ̀ k ɔ́
ile ẹyẹ	ī l é ɛ̄ j ɛ̄
ile ọba	ī l é ɔ̄ b ā
ile ọmọ	ī l é ɔ̄ m ɔ̃̄
ileelẹ	ī l é ē l ɛ̀
ileeṣẹ	ī l é ē ʃ ɛ́
ilekile	ī l é k í l é
ilera	ì l ē ɾ ā
ileya	ī l é j á
ileṣa	ī l é ʃ à
ilu	ì l ù
ilu	ì l ú
ilumọọka	ì l ú m ɔ̃̀ ɔ̃́ k á
ilẹ	ī l ɛ̀
ilẹ adulawọ	ī l ɛ̀ ā d ú l á w ɔ̀
ilẹ aye	ī l ɛ̀ ā j é
ilẹkun	ī l ɛ̀ k ũ̀
ilẹkẹ	ì l ɛ̀ k ɛ̀
ilọrin	ì l ɔ́ ɾ ĩ̄
ilọrin	ì l ɔ̄ ɾ ĩ̄
ilọwọọrọ	ì l ɔ́ w ɔ́ ɔ́ ɾ ɔ́
imado	ì m à d ò
imale	ì m à l ē
imeeli	í m ē è l ì
imisi	ì m ĩ́ s í
imu	ī m ṹ
imọ	ì m ɔ̃̀
imọ	ī m ɔ̃̀
imọ ajakalẹ arun	ì m ɔ̃̀ à d͡ʒ à k á l ɛ̀ à ɾ ũ̀
imọ arun eweko	ì m ɔ̃̀ à ɾ ũ̀ ē w é k ō
imọ ijinlẹ	ì m ɔ̃̀ ì d͡ʒ ĩ̀ l ɛ̀
imọ iṣegun	ì m ɔ̃̀ ì ʃ è ɡ ũ̀
imọ iṣiro	ì m ɔ̃̀ ì ʃ ī ɾ ò
imọ iṣẹ ẹrọ	ì m ɔ̃̀ ī ʃ ɛ́ ɛ̀ ɾ ɔ̄
imọ nipa ẹda eniyan	ì m ɔ̃̀ n ĩ́ k͡p ā ɛ̀ d á è n ĩ̀ j ã̀
imọ sayẹnsi	ì m ɔ̃̀ s á j ɛ́ ŋ̀ s ì
imọ ẹrọ	ì m ɔ̃̀ ɛ̀ ɾ ɔ̄
imọlara	ì m ɔ̃̀ l á ɾ ā
imọlẹ	ì m ɔ̃́ l ɛ̀
imọlẹ	ī m ɔ̃̄ l ɛ̀
in	ĩ̀
in	ĩ́
in	ĩ̄
ina	ì n ã̀
ina	ì n ã́
ina	ì n ã̄
ina	ī n ã́
inagijẹ	ì n ã̄ ɡ ī d͡ʒ ɛ̄
inaki	ì n ã̀ k í
india	í ŋ́ d í à
indomi	í ŋ́ d ó m ì
innsi	ĩ́ ŋ̀ s ì
innsi	ĩ́ ŋ́ s ì
intanẹẹti	í ŋ́ t á n ɛ́ ɛ̀ t ì
intanẹẹti	ĩ́ t á n ɛ́ ɛ̀ t ì
inọki	ì n ɔ̀ k í
io	i ɣ ó
io	ī ó
ipata	ì k͡p á t á
ipenija	ì k͡p è n ĩ́ d͡ʒ à
ipilẹṣẹ	ì k͡p ī l ɛ̀ ʃ ɛ̀
ipin	ì k͡p ĩ́
ipinlẹ	ì k͡p ĩ́ l ɛ̀
ipinnu	ì k͡p ĩ̄ n ũ̄
ipolongo	ì k͡p ō l ō ŋ̄ ɡ ō
ipolowo	ì k͡p ō l ó w ó
ipẹjalapaju	ì k͡p ɛ̄ d͡ʒ ā l á k͡p ā d͡ʒ ù
ipẹta	ì k͡p ɛ̀ t ā
ipẹta	ì k͡p ɛ̄ t à
ipẹyarun	ì k͡p ɛ̀ j à ɾ ũ̄
ira	ì ɾ à
ira	ì ɾ á
ira	ì ɾ ā
ira	ī ɾ à
ira	ī ɾ á
ira	ɪ̄ ɾ á
ira kunnugba	ì ɾ á k ũ̀ n ũ̀ ɡ͡b á
irawọ	ì ɾ à w ɔ̀
ireke	ì ɾ è k é
irekọja	ì ɾ é k ɔ̄ d͡ʒ á
iremọje	ì ɾ è m ɔ̃̀ d͡ʒ é
irinkerindo	ì ɾ ĩ̀ k è ɾ ĩ̄ d ò
irinwo	ī ɾ ĩ̄ w ó
iroko	ì ɾ ó k ò
ironupiwada	ì ɾ ò n ṹ k͡p ì w à d à
irosun	ì ɾ ò s ũ̀
irosun	ì ɾ ō s ũ̀
iroyin	ì ɾ ò j ĩ̀
iru	ì ɾ ù
iru	ì ɾ ú
iru	ī ɾ ù
iru	ī ɾ ú
irukẹrẹ	ì ɾ ù k ɛ̀ ɾ ɛ̀
irun	ī ɾ ũ̄
irungbọn	ī ɾ ũ̀ ɡ͡b ɔ̃̀
irunmarugbo	ì ɾ ũ̀ m à ɾ ú ɡ͡b ó
irunmọlẹ	ī ɾ ṹ m ɔ̃̄ l ɛ̀
irẹ	ì ɾ ɛ̀
irẹlẹ	ì ɾ ɛ̀ l ɛ̀
irẹpọ	ì ɾ ɛ́ k͡p ɔ̀
irẹsi	ì ɾ ɛ̄ s ì
irẹtẹ	ì ɾ ɛ̀ t ɛ̀
irẹtẹ	ì ɾ ɛ̄ t ɛ̀
irọkẹ	ì ɾ ɔ́ k ɛ́
irọlẹ	ì ɾ ɔ̀ l ɛ́
irọri	ì ɾ ɔ̀ ɾ í
isaaro	ì s à à ɾ ó
isansa	ì s á ŋ̀ s á
isiaka	ī s í á k à
isikiẹli	ì s í k í ɛ́ l ì
isinku	ì s ĩ̀ k ú
isinmi	ì s ĩ̄ m ĩ̄
isobo	ì s ò b ò
isu	ī s ū
ita	ì t ā
ita	ī t ā
itadogun	ì t à d ó ɡ ṹ
itan	ì t ã̀
itan	ì t ã̄
itan	ī t ã̄
itawe	ì t à w é
itọ ṣuga	ì t ɔ̀ ʃ ú ɡ à
iwa	ì w à
iwaju	ī w á d͡ʒ ú
iwarẹfa	ì w à ɾ ɛ̀ f à
iwe	ì w é
iwe	ī w ē
iwe agberoyinjade	ì w é ā ɡ͡b é ɾ ò j ĩ̀ d͡ʒ á d ē
iwi	ī w ì
iwin	ī w ĩ̄
iwo	ì w ō
iwori	ì w ò ɾ ì
iwure	ì w ú ɾ ē
iwuri	ì w ú ɾ í
iwuye	ì w ú j è
iwẹ	ì w ɛ̀
iwẹfa	ì w ɛ̀ f à
iwọ	ì w ɔ̄
iwọ	ī w ɔ̄
iya	ì j à
iya	ì j á
iyaalu	ì j á à l ù
iyagba	ì j à ɡ͡b à
iyaloriṣa	ì j á l ó ɾ ì ʃ à
iyalẹta	ì j á l ɛ̀ t ā
iyan	ì j ã̀
iyan	ī j ã̀
iyan	ī j ã́
iyanga	ì j ã̀ ɡ ā
iyanrin	ī j ã̄ ɾ ĩ̀
iyawo	ì j à w ó
iye	ì j è
iye	ī j è
iye	ī j ē
iyemeji	ī j è m é d͡ʒ ì
iyẹ	ì j ɛ́
iyẹfun	ì j ɛ̀ f ũ̄
iyẹrosun	ì j ɛ̀ ɾ ò s ũ̀
iyẹrẹ	ì j ɛ̀ ɾ ɛ̀
iyẹwu	ì j ɛ̀ w ù
iyọ	ì j ɔ̄
iyọ	ī j ɔ̀
iyọ oyinbo	ī j ɔ̀ ò j ĩ̀ b ó
iyọba	ī j ɔ̄ b ā
iyọnda	ì j ɔ̀ ŋ̀ d ā
iṣakọlẹ	ì ʃ á k ɔ́ l ɛ̀
iṣatunto	ì ʃ à t ṹ t ò
iṣe	ì ʃ ē
iṣikanrin	ì ʃ í k ã̄ ɾ ĩ́
iṣikinrin	ì ʃ í k ĩ̄ ɾ ĩ́
iṣile	ì ʃ í l é
iṣu	ī ʃ ū
iṣura	ì ʃ ú ɾ ā
iṣẹ	ì ʃ ɛ̀
iṣẹ	ì ʃ ɛ́
iṣẹ	ī ʃ ɛ́
iṣẹ amurele	ī ʃ ɛ́ à m ṹ ɾ ē l é
iṣẹju	ì ʃ ɛ́ d͡ʒ ú
iṣẹtọfabo	ì ʃ ɛ̀ t ɔ́ f á b ō
iṣẹṣe	ì ʃ ɛ̀ ʃ ē
iṣọla	ì ʃ ɔ̀ l á
iẹsi	ì ɛ̄ s ì
j	d͡ʒ
j	d͡ʒ í
jagunjagun	d͡ʒ ā ɡ ũ̄ d͡ʒ ā ɡ ũ̄
jamani	d͡ʒ á m á n ĩ̀
jameika	d͡ʒ à m é í k à
jangiroba	d͡ʒ ā ŋ̄ ɡ ī ɾ ó b à
jepaani	d͡ʒ è k͡p á à n ĩ̀
jero	d͡ʒ é ɾ ó
ji	d͡ʒ ì
ji	d͡ʒ í
ji	d͡ʒ ī
jiga	d͡ʒ ì ɡ á
jiga	d͡ʒ í ɡ à
jijẹ	d͡ʒ í d͡ʒ ɛ̄
jimọ	d͡ʒ í m ɔ̃̀
jimọh	d͡ʒ í m ɔ̃̀
jokoo	d͡ʒ ó k ò ó
jomijoke	d͡ʒ ō m ĩ̄ d͡ʒ ò k è
joṣua	d͡ʒ ó ʃ ú à
jẹ	d͡ʒ ɛ́
jẹ	d͡ʒ ɛ̄
jẹbutu	d͡ʒ ɛ̀ b ù t ù
jẹgun	d͡ʒ ɛ̄ ɡ ũ̄
jẹjẹrẹ	d͡ʒ ɛ̄ d͡ʒ ɛ̄ ɾ ɛ̄
jẹleosinmi	d͡ʒ ɛ́ l é ó s ĩ̄ m ĩ̄
jẹlesinmi	d͡ʒ ɛ́ l é s ĩ̄ m ĩ̄
jẹnẹretọ	d͡ʒ ɛ̄ n ɛ̄ ɾ é t ɔ̀
jẹnẹsisi	d͡ʒ ɛ́ n ɛ́ s í s ì
k	k
k	k í
ka ri bi kuọ ti a	k á ɾ í b ī k ú ɔ̄ t ī ā
kaaarọ	k á à á ɾ ɔ̀
kaadi pupa	k á à d ì k͡p ū k͡p ā
kaalẹ	k á ā l ɛ́
kaasan	k á à s ã́
kabeeji	k á b é è d͡ʒ ì
kabiyesi	k á b í j è s í
kabukabu	k ā b ú k ā b ú
kadara	k á d à ɾ á
kaju	k ā d͡ʒ ú
kakaki	k à k à k í
kakanda	k à k à ŋ̀ d á
kakulọọsi	k á k ú l ɔ́ ɔ̀ s ì
kalamu	k á l à m ũ̀
kamẹra	k á m ɛ́ ɾ à
kamẹruunu	k ā m ɛ̄ ɾ ú ù n ũ̀
kan	k ã̀
kan	k ã́
kan	k ã̄
kanada	k á n á d à
kanafuru	k à n ã́ f ù ɾ ù
kanga	k ã̀ ɡ ā
kankere	k ã̄ k é ɾ é
kannafuru	k ã̀ n ã́ f ù ɾ ù
kannago	k ã̀ n ã̀ ɡ ó
kannakanna	k ã̄ n ã̄ k ã́ n ã́
kannango	k ã̀ n ã̀ ŋ̀ ɡ ó
kanwun	k ã́ w ṹ
karuwa	k á ɾ ù w à
karọọti	k á ɾ ɔ́ ɔ̀ t ì
katakata	k ā t ā k ā t ā
kayeefi	k à j é é f ì
keeki	k é è k ì
keferi	k è f è ɾ í
keje	k ē d͡ʒ ē
keji	k ē d͡ʒ ì
keresimesi	k é ɾ é s ì m ē s ì
kereyọọnu	k ē ɾ ē j ɔ́ ɔ̀ n ũ̀
kete	k ē t ē
ketu	k é t ū
kewu	k é w ú
ki	k ì
ki	k í
ki	k ī
kii	k í ì
kiini	k ì í n ĩ́
kiini	k ĩ̀ ĩ́ n ĩ́
kijipa	k í d͡ʒ ì k͡p á
kilaasi	k í l á à s ì
kilomita	k ì l ó m í t à
kilọ	k ì l ɔ̀
kindinrin	k ĩ́ d ĩ̀ ɾ ĩ́
kiniun	k ì n ĩ̀ ṹ
kinkinrinmiyin	k ĩ̀ k ĩ̀ ɾ ĩ́ m ĩ̄ j ĩ́
kinniun	k ĩ̀ n ĩ̀ ṹ
kirisẹndọmu	k ī ɾ ī s ɛ́ ŋ́ d ɔ̀ m ũ̀
kita	k í t à
kitipa	k í t í k͡p ā
ko	k ò
ko	k ō
ko tọpẹ	k ò t ɔ́ k͡p ɛ́
koko	k ò k ò
koko	k ò k ó
koko	k ó k ò
koko	k ó k ó
kokoro	k ò k ò ɾ ò
kokoro	k ó k ó ɾ ó
kokoro arun	k ò k ò ɾ ò à ɾ ũ̀
kokoye	k ō k ō j é
kolekole	k ó l é k ó l é
kolekole	k ó l ē k ó l ē
kolo	k ó l ó
kololo	k ó l ò l ò
komookun	k ò m ó ò k ũ̄
kondo	k ó ŋ́ d ó
konkoto	k ó ŋ̀ k ó t ō
kori	k ó ɾ ì
korikoto	k ó ɾ ì k ó t ō
koro	k ò ɾ ó
koro	k ō ɾ ò
koroba	k ō ɾ ō b á
korona	k ò ɾ ó n à
ku ẹrubọ	k ú ɛ̀ ɾ ù b ɔ̀
ku ọdun keresimesi	k ú ɔ̄ d ṹ k é ɾ é s ì m ē s ì
ku ọdun tuntun	k ú ɔ̄ d ṹ t ũ̄ t ũ̄
kukunduku	k ú k ú ŋ̀ d ù k ú
kulikuli	k ú l í k ú l í
kumọ	k ù m ɔ̃̀
kura	k ù ɾ à
kura	k ú ɾ à
kura	k ú ɾ á
kura	k ú ɾ ā
kurekure	k ú ɾ é k ù ɾ é
kuromiọmu	k ú ɾ ó m ĩ́ ɔ̃̀ m ũ̀
kurukuru	k ù ɾ ū k ù ɾ ū
kuti	k ú t ì
kutukutu	k ù t ù k ù t ù
kutọnu	k ú t ɔ̄ n ũ̄
kuurọlẹ	k ú ù ɾ ɔ̀ l ɛ́
kuuṣẹ	k ú ū ʃ ɛ́
kẹfa	k ɛ̄ f à
kẹhinde	k ɛ́ j ĩ̀ d é
kẹhinde	k ɛ́ ĩ̀ d é
kẹjọ	k ɛ̄ d͡ʒ ɔ̄
kẹmisiri	k ɛ́ m ĩ́ s í ɾ ì
kẹnya	k ɛ́ ŋ́ j à
kẹrin	k ɛ̄ ɾ ĩ̄
kẹsẹ	k ɛ́ s ɛ́
kẹta	k ɛ̄ t ā
kẹturu	k ɛ́ t ù ɾ ù
kẹtẹkẹtẹ	k ɛ́ t ɛ́ k ɛ́ t ɛ́
kẹwaa	k ɛ̄ w à á
kẹyinde	k ɛ́ j ĩ̀ d é
kẹyinde	k ɛ́ ĩ̀ d é
kọ	k ɔ̀
kọbọ	k ɔ́ b ɔ̀
kọfi	k ɔ̄ f í
kọjọda	k ɔ́ d͡ʒ ɔ́ d ā
kọkọrọ	k ɔ́ k ɔ́ ɾ ɔ́
kọlekọle	k ɔ́ l é k ɔ́ l é
kọlikọli	k ɔ́ l í k ɔ́ l í
kọlọkọlọ	k ɔ̀ l ɔ̀ k ɔ̀ l ɔ̀
kọma	k ɔ́ m ã̄
kọmputa	k ɔ̀ ŋ̀ k͡p ú t à
kọnkere	k ɔ̃̄ k é ɾ é
kọnkọ	k ɔ̀ ŋ̀ k ɔ̀
kọnputa	k ɔ̀ ŋ̀ k͡p ú t à
kọnsonanti	k ɔ́ ŋ́ s ó n á ŋ̀ t ì
l	l
l	l í
la	l à
la	l á
laaarin	l á à á ɾ ĩ́
laakaye	l à á k à j è
laba	l à b à
labalaba	l ā b ā l á b á
labankada	l á b à ŋ̀ k á d à
labari	l à b á ɾ ì
labirikanna	l á b í ɾ í k ã́ n ã́
labule	l á b ú l é
laefi	l á è f í
lagbedemeji	l á ɡ͡b ē d ē m é d͡ʒ ì
lagunna	l á ɡ ũ̀ n ã̀
laiberia	l à ì b é ɾ í à
laibiri	l á í b ì ɾ ì
lakuregbe	l à k ú ɾ è ɡ͡b é
lalaalẹ	l á l ā ā l ɛ́
laluuri	l à l ú ú ɾ í
lambo	l á ŋ́ b ó
lameyitọ	l á m è j í t ɔ́
lamilami	l á m ĩ̄ l á m ĩ̄
lanaa	l áꜜ n ã́
lapalapa	l à k͡p á l à k͡p á
laraarọ	l á ɾ à á ɾ ɔ̀
larubawa	l á ɾ ú b á w á
lawani	l á w à n ĩ́
le	l è
le	l é
le	l ē
lefitiku	l é f í t í k ù
lekeleke	l é k ē l é k ē
lenii	l éꜜ n ĩ́
leṣii	l é ʃ ì í
li	l í
ligbẹ	l í ɡ͡b ɛ̀
liigi	l í ì ɡ ì
liigi	l í í ɡ ì
linguisiiki	l ì ŋ̀ ɡ ú í s í ì k ì
litireṣọ	l í t í ɾ é ʃ ɔ̀
logbo	l ó ɡ͡b ò
lojoojumọ	l ó d͡ʒ ō ō d͡ʒ ú m ɔ̃́
lojukoju	l ó d͡ʒ ú k ō d͡ʒ ú
lokili	l ó k í l ì
lonii	l óꜜ n ĩ́
loorekoore	l ó ò ɾ è k ó ò ɾ è
loṣoo	l ó ʃ ò ó
lukaluka	l ú k à l ú k à
luko	l ū k ō
lukudi	l ù k ú d ì
lukuluku	l ù k ú l ù k ú
lẹta	l ɛ́ t à
lọ	l ɔ̀
lọ	l ɔ̄
lọdọọdun	l ɔ́ d ɔ̄ ɔ̄ d ṹ
lọfinnda	l ɔ́ f ĩ́ ŋ́ d à
lọla	l ɔ́ l ā
lọsọọsan	l ɔ́ s ɔ̀ ɔ̀ s ã́
lọwọọwọ	l ɔ́ w ɔ́ ɔ́ w ɔ́
lọya	l ɔ́ j à
lọọle	l ɔ̄ ɔ̄ l é
m	m
m	m ĩ́
m	ŋ
m	ŋ́
m	ŋ̄
maa	m à á
maa	m á ā
maa	m ā ā
maapu	m á à k͡p ù
maasi	m á à s ì
madagasika	m ā d ā ɡ á s í k à
magi	m ā ɡ í
maigho	m à ì ɣ ò
majala	m à d͡ʒ à l à
majele	m á d͡ʒ è l é
majẹmu	m á d͡ʒ ɛ̀ m ũ̄
majẹmu	m á d͡ʒ ɛ̀ m ṹ
makaruku	m à k à ɾ ú k ù
makaruru	m à k à ɾ ú ɾ ù
makirofoonu	m ā k ī ɾ ō f ó ò n ũ̀
maleka	m à l é k à
malughu	m à l ú ɣ ù
maluu	m à l ú ù
mama	m à m á
mangoro	m á ŋ́ ɡ ò ɾ ò
maraarun	m á ɾ à à ɾ ṹ
maria	m à ɾ í à
mariwo	m à ɾ ì w ò
matiu	m á t í ù
meje	m é d͡ʒ ē
meje meje	m é d͡ʒ ē m é d͡ʒ ē
mejeeje	m é d͡ʒ è è d͡ʒ ē
mejeeji	m é d͡ʒ è è d͡ʒ ì
meji	m é d͡ʒ ì
meji meji	m é d͡ʒ ì m é d͡ʒ ì
meloo	m é l ò ó
mi	m ĩ̀
mi	m ĩ́
mi	m ĩ̄
midinmiidin	m ĩ̄ d ĩ̄ m ĩ́ ĩ̀ d ĩ̀
miliiki	m í l í ì k ì
miliiki gbẹrẹfu	m ĩ́ l í ì k ì ɡ͡b ɛ̄ ɾ ɛ̄ f ū
mita	m í t à
moji	m ó d͡ʒ í
mooluẹ	m ó ò l ū ɛ̀
moroko	m ò ɾ ó k ò
mu	m ũ̀
mu	m ũ̄
mu	m ṹ
mudunmudun	m ũ̀ d ũ̀ m ṹ d ũ̀
musiiba	m ũ̀ s í í b à
musiọmu	m ũ̀ s í ɔ̀ m ũ̀
muso	m ṹ s ò
musu	m ṹ s ù
musulumi	m ũ̀ s ù l ù m ĩ́
mẹfa	m ɛ́ f à
mẹfa mẹfa	m ɛ́ f à m ɛ́ f à
mẹfẹẹfa	m ɛ́ f ɛ̀ ɛ̀ f à
mẹjẹẹjọ	m ɛ́ d͡ʒ ɛ̀ ɛ̀ d͡ʒ ɔ̄
mẹjọ	m ɛ́ d͡ʒ ɔ̄
mẹjọ mẹjọ	m ɛ́ d͡ʒ ɔ̄ m ɛ́ d͡ʒ ɔ̄
mẹkunu	m ɛ̀ k ú n ũ̀
mẹrin	m ɛ́ ɾ ĩ̄
mẹrin mẹrin	m ɛ́ ɾ ĩ̄ m ɛ́ ɾ ĩ̄
mẹrẹẹrin	m ɛ́ ɾ ɛ̀ ɛ̀ ɾ ĩ̄
mẹta	m ɛ́ t ā
mẹta mẹta	m ɛ́ t ā m ɛ́ t ā
mẹtẹẹta	m ɛ́ t ɛ̀ ɛ̀ t ā
mẹwaa	m ɛ́ w à á
mẹwaa mẹwaa	m ɛ́ w à á m ɛ́ w à á
mẹwẹẹwaa	m ɛ́ w ɛ̀ ɛ̀ w à á
mọ	m ɔ̃̀
mọ	m ɔ̃́
mọ	m ɔ̃̄
mọdakẹkẹ	m ɔ̃̄ d á k ɛ́ k ɛ́
mọgba	m ɔ̃̄ ɡ͡b à
mọinmọin	m ɔ̃́ ĩ́ m ɔ̃́ ĩ́
mọmọdu	m ɔ̃́ m ɔ̃́ d ù
mọnafiki	m ɔ̃̀ n ã́ f ì k í
mọriwo	m ɔ̃̀ ɾ ì w ò
mọriọ	m ɔ̃̀ ɾ ɪ̀ ɔ̀
mọsalasi	m ɔ̃́ s á l á s í
mọṣalaṣi	m ɔ̃́ ʃ á l á ʃ í
mọṣi	m ɔ̃́ ʃ ì
n	n
n	n ĩ́
n	ŋ
n	ŋ́
n	ŋ̄
n	̃
naija	n à ì d͡ʒ á
naija	n á í d͡ʒ à
naijiria	n à ì d͡ʒ í ɾ í à
naira	n á í ɾ à
nama	n ã́ m à
nasia	n ã̀ s í à
ni	n ĩ́
ni	n ĩ̄
ni asẹyinwa asẹyinbọ	n ĩ́ à s ɛ̀ j ĩ̀ w á à s ɛ̀ j ĩ̀ b ɔ̀
niturojini	n ĩ́ t ú ɾ ó d͡ʒ í n ĩ̀
njẹ	ŋ̀ d͡ʒ ɛ́
nkọ	ŋ́ k ɔ́
nunu	n ṹ n ũ̀
nọmba	n ɔ́ ŋ́ b à
nọmba agbabọọlu	n ɔ́ ŋ́ b à ā ɡ͡b á b ɔ́ ɔ̀ l ù
o dabọ	ó d à b ɔ̀
o ṣe	ō ʃ é
o ṣeun	ō ʃ ē ũ̄
obeje	ò b è d͡ʒ é
obeje	ò b é d͡ʒ é
oberemoye	ò b è ɾ è m ó j è
obi	ò b í
obi	ō b ì
obirikiti	ò b ì ɾ ì k ì t ì
obiṣuari	ò b í ʃ ú á ɾ ì
odereekoko	ò d è ɾ é ē k ó k ò
odi	ò d í
odidẹrẹ	ō d í d ɛ̄ ɾ ɛ́
odo	ò d ō
odo	ō d ò
odo	ō d ó
odo	ō d ō
odo ilu	ō d ó ì l ù
ododo	ò d ò d ó
ododo	ò d ō d ō
ododo	ō d ó d ō
odu	ō d ù
oduduwa	ō d ù d ū w à
oduwa	ō d ū w ā
ofefee	ò f é f è é
ofofo	ò f ó f ó
ofu	ò f ú
ofun	ò f ṹ
ogbe	ō ɡ͡b è
ogbebara	ō ɡ͡b è b à ɾ à
ogbedi	ō ɡ͡b è d í
ogbere	ò ɡ͡b é ɾ è
ogberosun	ō ɡ͡b è ɾ ō s ũ̀
ogbewori	ō ɡ͡b è w ò ɾ ì
ogbewọnrin	ō ɡ͡b è w ɔ̃́ ɾ ĩ́
ogbeyẹku	ō ɡ͡b è j ɛ̀ k ú
ogbomọṣọ	ò ɡ͡b ó m ɔ̃̀ ʃ ɔ́
ogboni	ò ɡ͡b ó n ĩ̄
ogbugbu	ò ɡ͡b ù ɡ͡b ú
ogede	ò ɡ è d è
ogede	ò ɡ è d ē
ogede	ò ɡ é d é
ogho	o ɣ ó
oghun	o ɣ ũ̄
oghun	ò ɣ ũ̄
ogiri	ò ɡ ì ɾ ì
ogiri	ò ɡ ī ɾ ī
ogo	ò ɡ ò
ogo	ò ɡ ó
ogo	ò ɡ ō
ogoga	ò ɡ ò ɡ à
ogoji	o ɡ ó ɟ ì
ogongo	ò ɡ ò ŋ̀ ɡ ò
ogun	ò ɡ ũ̀
ogun	ò ɡ ṹ
ogun	ō ɡ ũ̄
ogun	ō ɡ ṹ
ogun abẹle	ō ɡ ũ̄ ā b ɛ́ l é
ogunbiyi	ò ɡ ṹ b í j ì í
ogunbiyii	ò ɡ ṹ b í j ì í
ogunda	ò ɡ ṹ d á
ogundabẹdẹ	ò ɡ ṹ d á b ɛ̀ d ɛ́
ogungun	ō ɡ ũ̄ ɡ ũ̄
ogunyọlade	ò ɡ ṹ j ɔ̀ l á d é
ogẹsinlẹṣin	ò ɡ ɛ̄ ʃ ĩ̄ l ɛ́ ʃ ĩ̄
ohihun	ō h ì h ũ̀
oi	ō ī
oigho	ō í ɣ ō
oiie	ō í ī ē
oje	ò d͡ʒ é
oje	ō d͡ʒ ē
ojia	ò d͡ʒ í á
ojibata	ò d͡ʒ í b à t à
ojigan	ò d͡ʒ ì ɡ ã̄
ojiji	ò d͡ʒ ì d͡ʒ ī
ojiji	ò d͡ʒ í d͡ʒ í
ojiji	ò d͡ʒ ī d͡ʒ ì
ojiya	ò d͡ʒ í j á
ojo	ò d͡ʒ ò
ojo	ō d͡ʒ ō
ojola	ò d͡ʒ ò l á
ojoojumọ	ō d͡ʒ ō ō d͡ʒ ú m ɔ̃́
oju	ō d͡ʒ ú
oju odu	ō d͡ʒ ú ō d ù
oju ologbo	ō d͡ʒ ú ō l ó ɡ͡b ò
oju sanma	ō d͡ʒ ú s ɔ̃́ m ɔ̃̀
oju ọjọ	ō d͡ʒ ú ɔ̄ d͡ʒ ɔ́
oju ọrun	ō d͡ʒ ú ɔ̀ ɾ ũ
ojubọ	ō d͡ʒ úꜜ b ɔ̄
ojude	ō d͡ʒ ú d ē
ojugun	ō d͡ʒ ú ɡ ũ̄
ojukoju	ō d͡ʒ ú k ō d͡ʒ ú
ojukokoro	ō d͡ʒ ú k ò k ò ɾ ò
ojulowo	ō d͡ʒ ú l ó w ó
ojulumọ	ò d͡ʒ ú l ù m ɔ̃̀
ojumọ	ō d͡ʒ ú m ɔ̃́
oke okun	ò k è ò k ũ̄
okiki	ò k ì k í
okiti	ò k ì t ì
oko	ò k ò
oko	ō k ó
oko	ō k ō
okobo	ò k ó b ó
okoto	ò k ò t ó
oku	ò k ù
oku	ō k ù
okun	ò k ũ̄
okun	ō k ũ̀
okun	ō k ũ̄
okunfa	ō k ũ̀ f à
okuta	ò k ú t a
olele	ō l ē l ē
olilu	ò l ì l ù
olio	ō l í ó
olodo	ō l ó d ó
olodo	ō l óꜜ d ō
olodumare	ō l ó d ù m ā ɾ è
olofoofo	ō l ó f ò ó f ó
ologbo	ō l ó ɡ͡b ò
ologho	ō l ó ɣ ó
ologiiriṣẹṣẹ	ō l ó ɡ ì í ɾ ì ʃ ɛ̀ ʃ ɛ̀
ologinni	ō l ó ɡ ĩ̀ n ĩ́
ologoṣẹ	ō l ó ɡ ō ʃ ɛ́
olokili	ō l ó k í l ì
olokoṣẹ	ō l ó k ō ʃ ɛ́
olokun	ō l ó k ũ̄
olomele	ō l ó m ē l ē
olongbo	k͡p l ó ŋ́ ɡ͡b ò
olongo	ō l ō ŋ̄ ɡ ō
oloo	ō l ó ó
oloofeere	ō l ó ò f é è ɾ é
olooorun	ō l ó ò ó ɾ ũ̀
olorogbo	ō l ó ɾ ó ɡ͡b ó
oloyin	ō l ó j ĩ̄
oloṣelu	ō l ó ʃ è l ú
olu	ò l ú
olu	ō l ú
olubadan	ō l ú b à d ã̀
olubọde	ō l ú b ɔ̀ d é
olugbongbo	ò l ù ɡ͡b ó ŋ́ ɡ͡b ó
olukarẹ	ō l ú k à ɾ ɛ́
olukondo	ō l ú k ò ŋ̀ d ó
olukọ	ō l ù k ɔ́
olulu	ò l ú l ú
oluwafunkẹ	ō l ú w ā f ṹ k ɛ́
omele	ō m ē l ē
omi	ō m ĩ̄
ominira	ò m ĩ̀ n ĩ̄ ɾ ā
omugwẹ	ò m ũ̀ ɡʷ ɛ̀
omuwẹ	ò m ũ̀ w ɛ̀
ondo	ò ŋ̀ d ó
ondo	ō ŋ̀ d ó
ondo ajaja	ō ŋ̀ d ó ā d͡ʒ ā d͡ʒ á
oni	ò n ĩ́
onidiri	ō n ĩ́ d ì ɾ í
onigbagbọ	ō n ĩ́ ɡ͡b à ɡ͡b ɔ́
onigbameji	ō n ĩ́ ɡ͡b á m é d͡ʒ ì
onikondo	ō n ĩ́ k ò ŋ̀ d ó
onimọ	ō n ĩ́ m ɔ̃̀
onire	ō n ĩ́ ɾ è
onisuuru	ō n ĩ́ s ù ú ɾ ù
oniṣegun	ō n ĩ́ ʃ è ɡ ũ̀
oniṣẹṣe	ō n ĩ́ ʃ ɛ̀ ʃ ē
onka	ò ŋ̀ k à
onko	ò ŋ̀ k ò
oogun	ò ó ɡ ũ̀
oogun	ō ò ɡ ũ̀
ookan	ō ó k ã̄
oola	ò ó l á
oolu	ò ò l ù
oore	ò ò ɾ è
oore	ō ò ɾ è
oorun	ò ó ɾ ũ̀
oorun	ō ò ɾ ũ̀
oorun	ō ō ɾ ũ̄
oorẹ	ò ò ɾ ɛ̀
oorọ	ò ó ɾ ɔ̀
ooya	ò ò j à
ooṣa	ò ò ʃ à
ooṣaala	ò ò ʃ à á l á
ooṣanla	ò ò ʃ à ŋ́ l á
opin	ò k͡p ĩ̄
opitan	ò k͡p ì t ã̀
oponu	ò k͡p ò n ṹ
ori	ò ɾ ì
ori	ò ɾ í
ori	ō ɾ í
ori	ō ɾ ī
origho	ō ɾ í ɣ ō
oriki	ō ɾ í k ì
orimolusi	ō ɾ í m ō l ú s ì
oriri	ō ɾ ī ɾ ī
orirun	ò ɾ í ɾ ũ̀
orirun	ō ɾ í ɾ ũ̄
orita	ō ɾ í t ā
orita	ō ɾ ī t ā
oriṣa	ò ɾ ì ʃ à
oriṣaala	ò ɾ ì ʃ à á l á
oriṣanla	ò ɾ ì ʃ à ŋ́ l á
oriṣaoko	ò ɾ ì ʃ à ō k ō
oro	ò ɾ ò
oro	ō ɾ ò
oro	ō ɾ ō
orogbo	ō ɾ ó ɡ͡b ó
orogun	ō ɾ ó ɡ ũ̀
orogun	ō ɾ ō ɡ ṹ
orombo	ò ɾ ō ŋ̀ b ó
oromọdiyẹ	ò ɾ ò m ɔ̃̄ d ì j ɛ̄
orooro	ò ɾ ó ò ɾ ō
ororo	ò ɾ ó ɾ ó
ororo	ò ɾ ō ɾ ò
oru	ò ɾ ū
oruka	ò ɾ ù k ā
orukọ	ò ɾ ú k ɔ̄
orukọ	ō ɾ ú k ɔ̄
orukọkorukọ	ō ɾ ú k ɔ̄
orupo	ō ɾ ú k͡p ò
otente	ò t é ŋ́ t é
oti	ō t ī
otitọ	ò t í t ɔ́
otolo	ò t ò l ò
otua	ò t ú á
otupa	ò t ù k͡p à
otuurupọn	ò t ú ú ɾ ú k͡p ɔ̃̀
oukọ	ō ú k ɔ̄
oun	ò ũ̄
ounjẹ	ō ṹ d͡ʒ ɛ̄
owe	ò w ē
owe	ō w é
owiwi	ò w ì w í
owo	ò w ò
owo	ō w ó
owo omi	ō w ó ō m ĩ̄
owo ori	ō w ó ō ɾ í
owo oṣu	ō w ó ō ʃ ù
owu	ò w ú
owu	ō w ú
owurọ	ò w ú ɾ ɔ̀
owusuwusu	ò w ú s ú w ū s ù
owuọ	ò w ú ɔ̀
oye	ò j ē
oye	ō j è
oye	ō j ē
oyi	ò j ì
oyin	ō j ĩ̄
oyin ado	ō j ĩ̄ à d ò
oyin igan	ō j ĩ̄ ì ɡ ã̀
oyinbo	ò j ĩ̀ b ó
oyiya	ò j ì j à
ozu	ō z ú
oṣe	ò ʃ é
oṣe	ō ʃ è
oṣe	ō ʃ é
oṣelu	ò ʃ è l ú
oṣemawe	ò ʃ ē m à w é
oṣibata	ò ʃ í b à t à
oṣogbo	ò ʃ ō ɡ͡b ō
oṣu	ō ʃ ù
oṣu agẹmọ	ō ʃ ù ā ɡ ɛ̄ m ɔ̃̄
oṣu belu	ō ʃ ù b é l ú
oṣu erele	ō ʃ ù è ɾ è l é
oṣu igbe	ō ʃ ù ī ɡ͡b ē
oṣu ogun	ō ʃ ù ò ɡ ṹ
oṣu okudu	ō ʃ ù ò k ú d ū
oṣu owewe	ō ʃ ù ò w é w ē
oṣu ṣẹrẹ	ō ʃ ù ʃ ɛ̀ ɾ ɛ́
oṣu ẹbibi	ō ʃ ù ɛ̀ b ì b ì
oṣu ẹrẹna	ō ʃ ù ɛ̀ ɾ ɛ̀ n ã̀
oṣu ọpẹ	ō ʃ ù ɔ̀ k͡p ɛ̄
oṣu ọwara	ō ʃ ù ɔ̀ w à ɾ à
oṣumare	ò ʃ ù m à ɾ è
oṣupa	ò ʃ ù k͡p á
oṣupa aranmọju	ò ʃ ù k͡p á à ɾ ã̀ m ɔ̃́ d͡ʒ ú
oṣupadẹjẹ	ò ʃ ù k͡p á d ɛ̀ d͡ʒ ɛ̀
p	k͡p
p	k͡p í
pa	k͡p á
pa	k͡p ā
paari	k͡p á á ɾ ì
paayan	k͡p à à j ã̀
pagidende	k͡p ā ɡ ī d è ŋ̀ d é
pagọ	k͡p à ɡ ɔ́
pai	k͡p ā í
pajawiri	k͡p à d͡ʒ á w ì ɾ ì
paka	k͡p ā k à
paki	k͡p á k í
palọ	k͡p à l ɔ́
pana	k͡p ā n ã́
panakata	k͡p ā n ã̄ k à t á
panapana	k͡p ā n ã́ k͡p ā n ã́
papa	k͡p á k͡p á
papakọ ofuurufu	k͡p á k͡p á k ɔ̀ ò f ū ū ɾ ū f ú
papoda	k͡p ā k͡p ò d à
parada	k͡p ā ɾ ā d à
paradise	k͡p á ɾ á d í s è
parapandu	k͡p ā ɾ ā k͡p ã̄ d ù
pari	k͡p á ɾ í
pari	k͡p ā ɾ í
parin	k͡p ā ɾ ĩ̄
pariwo	k͡p ā ɾ ī w ō
paroko	k͡p à ɾ ō k ò
parọ	k͡p ā ɾ ɔ́
pataki	k͡p à t à k ì
paṣẹ	k͡p à ʃ ɛ̄
pete	k͡p è t ē
pi	k͡p í
pidan	k͡p ī d ã́
pidanpidan	k͡p ī d ã́ k͡p ī d ã́
pin	k͡p ĩ́
pin	k͡p ĩ̄
pinnu	k͡p ĩ̄ n ũ̄
pitan	k͡p ì t ã̀
pogede	k͡p ò ɡ è d è
polowo	k͡p ō l ó w ó
polukurumuṣu	k͡p ō l ú k ú ɾ ú m ũ̄ ʃ ū
pomegiraneti	k͡p ó m é ɡ í ɾ á n é t ì
poo	k͡p ó ò
popondo	k͡p ò k͡p ò ŋ̀ d ó
poporo	k͡p ò k͡p ó ɾ ò
posi	k͡p ó s í
potogi	k͡p ō t ō ɡ í
powe	k͡p ò w ē
poṣe	k͡p ò ʃ é
puromo	k͡p ú ɾ ó m ò
purotosua	k͡p ù ɾ ó t ó s ú à
pẹja	k͡p ɛ̄ d͡ʒ ā
pẹjapẹja	k͡p ɛ̄ d͡ʒ ā k͡p ɛ̄ d͡ʒ ā
pẹlẹ	k͡p ɛ̀ l ɛ́
pẹna	k͡p ɛ̄ n á
pẹnaiti	k͡p ɛ̄ n ã́ ĩ́ t ì
pẹnariti	k͡p ɛ̄ n ã́ ɾ í t ì
pẹnsu	k͡p ɛ́ ŋ́ s ù
pẹpẹ	k͡p ɛ̄ k͡p ɛ̄
pẹpẹyẹ	k͡p ɛ́ k͡p ɛ́ j ɛ̄
pẹtẹẹsi	k͡p ɛ̀ t ɛ́ ɛ̀ s ì
pẹẹni	k͡p ɛ́ ɛ̀ n ì
pọfọ	k͡p ɔ̄ f ɔ̀
pọn	k͡p ɔ̃̀
pọn	k͡p ɔ̃́
pọn	k͡p ɔ̃̄
pọnun	k͡p ɔ́ n ũ̀
r	ɾ
r	ɾ í
ra	ɾ à
ra	ɾ á
ra	ɾ ā
ragoliisi	ɾ á ɡ ó l í ì s ì
raisi	ɾ á ì s ì
rakunmi	ɾ à k ũ̄ m ĩ́
rakunmi	ɾ à k ṹ m ĩ́
ranlọọ	ɾ ã̀ l ɔ́ ɔ́
rara	ɾ á ɾ à
rara	ɾ á ɾ á
re	ɾ è
re	ɾ é
re kọja	ɾ é k ɔ̄ d͡ʒ á
ri	ɾ ì
ri	ɾ í
ri	ɾ ī
ria	ɾ í ā
riba	ɾ ì b á
rikiṣi	ɾ ì k í ʃ í
risiiti	ɾ ì s í ì t ì
risinkin	ɾ í s ĩ̄ k ĩ̄
ro	ɾ ò
ro	ɾ ó
ro	ɾ ō
rogbodiyan	ɾ ò ɡ͡b ò d ì j ã̀
ronupiwada	ɾ ō n ṹ k͡p ì w à d à
ruuru	ɾ ú ù ɾ ù
rẹ	ɾ ɛ̀
rẹ	ɾ ɛ̄
rẹfiri	ɾ ɛ̄ f ī ɾ í
rẹkorẹko	ɾ ɛ́ k ó ɾ ɛ́ k ó
rọ	ɾ ɔ̀
rọ	ɾ ɔ̄
rọn	ɾ ɔ̃̄
rọparọsẹ	ɾ ɔ̄ k͡p á ɾ ɔ̄ s ɛ̀
rọra	ɾ ɔ̄ ɾ ā
rọṣia	ɾ ɔ́ ʃ í à
s	s
s	s í
saa	s á à
saafula	s á à f ú l à
saari	s à à ɾ ì
saba	s á b à
sababi	s á b à b í
sabiganna	s ā b ī ɡ ã̀ n ã́
safuroni	s á f ú ɾ ó n ĩ̀
sakaani	s à k á á n ĩ́
sakara	s á k á ɾ à
salubata	s á l ú b à t à
samaani	s à m á á n ĩ̀
samu	s à m ũ̀
sango	s ã̀ ɡ ó
sanma	s ã́ m à
sanmọni	s ã̀ m ɔ̃́ n ĩ̀
saraa	s à ɾ á à
saraki	s à ɾ à k í
saree	s à ɾ é è
saro	s à ɾ ó
sarootu	s à ɾ ō ō t ù
satani	b ì l í s ì
sayẹnsi	s á j ɛ́ ŋ̀ s ì
se	s è
se	s é
sefanaya	s ē f ā n ã́ j à
sekaraya	s ē k ā ɾ á j à
si	s í
silebu	s í l é b ù
sinamoni	s í n ã́ m ó n ĩ̀
sinki	s í ŋ́ k ì
siria	s í ɾ í à
sisi	s í s ì
sisi	s ī s í
sitefanu	s í t é f á n ù
sobiya	s ò b ì j à
somalia	s ò m á l í à
sose	s ò s é
suna	s ú n ã̀
suna	s ú n ã́
suuru	s ù ú ɾ ù
suya	s ú j à
sẹngwa	s ɛ̃̄ ɡʷ à
sẹntimita	s ɛ̀ ŋ̀ t í m í t à
sọ	s ɔ̄
sọrọ	s ɔ̀ ɾ ɔ̀
sọrọsọrọ	s ɔ̀ ɾ ɔ̀ s ɔ̀ ɾ ɔ̀
sọwedowo	s ɔ̀ w é d ō w ó
t	t
t	t í
ta	t à
ta	t ā
taara	t à à ɾ à
taara	t ā à ɾ á
taba	t á b à
tabili	t á b ì l ì
tadawa	t à d á w à
tafatafa	t ā f à t ā f à
taiwo	t á í w ò
taka	t à k ā
takada	t á k à d á
takasufee	t à k ā s ú f è é
takete	t ā k é t é
takisi	t ā k ī s í
talaka	t á l á k à
talika	t á l í k à
tanganran	t ã́ ɡ ã̄ ɾ ã̄
tanmọọ	t ã̀ m ɔ̃́ ɔ̃̀
tannatanna	t ã̄ n ã́ t ã̄ n ã́
tapa	t á k͡p à
tatapupu	t ā t ā k͡p ù k͡p ù
tawe	t à w é
taye	t á j é
ti	t ì
ti	t í
ti	t ī
tii	t í ì
timi	t ì m ĩ̀
timitimi	t ì m ĩ̀ t ì m ĩ̀
timutimu	t ì m ũ̀ t ì m ũ̀
tin	t ĩ̄
tiroo	t ì ɾ ó ò
titi	t í t ì
titi	t í t í
titun	t ī t ũ̄
togo	t ó ɡ ò
tolotolo	t ò l ó t ò l ó
tomati	t ò m á t ì
tomati elejo	t ò m á t ì ē l é d͡ʒ ò
tulasi	t ú l à s ì
tumba	t ú ŋ́ b á
tunba	t ú ŋ́ b á
turari	t ù ɾ à ɾ í
tuuba	t ú ú b á
tẹlifiṣọn	t ɛ̄ l ī f í ʃ ɔ̃̀
tọrọ	t ɔ́ ɾ ɔ́
tọrọ	t ɔ̄ ɾ ɔ̄
tọọrọ agbọn	t ɔ́ ɔ́ ɾ ɔ́ à ɡ͡b ɔ̃̀
u	u
u	ú
u	ū
ua	ʊ̀ à
ubo	ū b ō
uda	ū d à
udako	ū d à k ó
udangho	ù d ã́ ɣ ò
uderegbe	ù d è ɾ è ɡ͡b è
udẹ	ū d ɛ̄
ugbade	ù ɡ͡b à d è
ugbalẹ	ù ɡ͡b á l ɛ̀
ugbin	ù ɡ͡b ĩ́
ugbẹ	ʊ̀ ɡ͡b ɛ̀
ugbẹn	ù ɡ͡b ɛ̃́
ugha	ù ɣ à
ugwẹ	ù ɡʷ ɛ̀
ugwọ	ù ɡʷ ɔ̄
uhin	ù h ĩ̀
ujaamẹṣẹ	ù d͡ʒ ā ā m ɛ̀ ʃ ɛ̀
uji	ū d͡ʒ ì
ukoko	ù k ò k ò
uku	ū k ù
uku	ū k ú
ulaa	ù l á á
ule	ū l é
uli	ū l í
ulikuli	ū l í k ú l í
ulooyinbo	ù l ō ò j ĩ̀ b ó
ulu	ù l ù
ulu	ù l ú
ulẹ	ū l ɛ̀
ulọta	ù l ɔ̄ t ā
un	ũ̄
un	ṹ
uparo	ù k͡p ā ɾ ò
upepe	ū k͡p è k͡p é
uranlọọ	ù ɾ ã̀ l ɔ́ ɔ́
usi	ù s ì
usobo	ù s ò b ò
usẹ	ū s ɛ́
uta	ū t ā
uta	ʊ̄ t ā
uwa	ù w à
uwe	ù w é
uwọ	ù w ɔ̄
uyi	ū j ì
uṣu	ū ʃ ū
uṣẹ	ū ʃ ɛ́
uṣẹṣe	ù ʃ ɛ̀ ʃ ē
w	w
w	w í
wa	w à
wa	w á
wa	w ā
waapa	w á á k͡p á
waasu	w à á s ù
wadowado	w á d ò w á d ò
wahala	w à h á l à
wakati	w á k à t í
warakaṣi	w à ɾ à k à ʃ ì
warapa	w á ɾ á k͡p á
were	w è ɾ è
wi	w í
wi	w ī
wolii	w ò l í ì
wukuwuku	w ù k ú w ù k ú
wundia	w ú ŋ́ d í á
wura	w ú ɾ à
wẹ	w ɛ̀
wọn	w ɔ̃́
y	j
y	j í
yagba	j à ɡ͡b à
yama	j á m à
yangan	j ã̄ ɡ ã̄
yanyan	j ã́ j ã̀
yauyauu	j à ú j à ú ù
yemọja	j ē m ɔ̃̄ d͡ʒ ā
yewa	j é w ā
yi	j í
yi	j ī
yimiyimi	j í m ĩ́ j í m ĩ́
yin	j ĩ́
yinki	j í ŋ̀ k ì
yinyin	j ĩ̀ j ĩ́
yoruba	j ō ɾ ù b á
yu	j ú
yubẹ	j ú b ɛ̀
yugọọti	j ú ɡ ɔ́ ɔ̀ t ì
yun	j ũ̀
yun	j ṹ
yungba	j ũ̀ ɡ͡b à
yureniọ	j ū ɾ é n ĩ́ ɔ̃̀
yuroopu	j ú ɾ ó ò k͡p ù
yẹri	j ɛ̀ ɾ ì
yẹti	j ɛ̄ t í
yẹukẹ	j ɛ́ ú k ɛ́
yọn	j ɔ̃̀
yọnda	j ɔ̀ ŋ̀ d ā
yọyinyọyin	j ɔ̄ j ĩ́ j ɔ̄ j ĩ́
zokoo	z ó k ò ó
zẹ	z ɛ̄
ṣ	ʃ
ṣ	ʃ í
ṣaanu	ʃ à á n ṹ
ṣabẹẹ	ʃ á b ɛ̀ ɛ́
ṣafikun	ʃ à f ī k ṹ
ṣagidi	ʃ ā ɡ í d í
ṣaina	ʃ á í n à
ṣainọn	ʃ à í n ɔ̃́
ṣakabula	ʃ ā k ā b ù l à
ṣalaisi	ʃ ā l á ì s í
ṣalanga	ʃ á l á ŋ́ ɡ á
ṣalaye	ʃ à l à j é
ṣango	ʃ ã̀ ɡ ó
ṣanpọnna	ʃ ã̀ k͡p ɔ̃̀ n ã́
ṣatunto	ʃ à t ṹ t ò
ṣatunṣe	ʃ à t ṹ ʃ ē
ṣawari	ʃ à w á ɾ í
ṣawawi	ʃ à w á w í
ṣaworo	ʃ à w ò ɾ ò
ṣaworo	ʃ ā w ō ɾ ō
ṣayẹwo	ʃ à j ɛ̀ w ò
ṣe	ʃ é
ṣe	ʃ ē
ṣege	ʃ é ɡ è
ṣegede	ʃ ē ɡ ē d ē
ṣelu	ʃ è l ú
ṣepinya	ʃ è k͡p ĩ́ j à
ṣere	ʃ ē ɾ é
ṣeto	ʃ è t ò
ṣewadii	ʃ è w á d ì í
ṣi	ʃ ì
ṣi	ʃ í
ṣi	ʃ ī
ṣibi	ʃ í b í
ṣikago	ʃ í k á ɡ ò
ṣingọọmu	ʃ ĩ̄ ɡ ɔ́ ɔ̀ m ũ̀
ṣiri pake	ʃ í ɾ í k͡p à k è
ṣiyemeji	ʃ ī j è m é d͡ʒ ì
ṣiṣe	ʃ í ʃ ē
ṣiṣẹ	ʃ ī ʃ ɛ́
ṣofofo	ʃ ò f ó f ó
ṣojo	ʃ ō d͡ʒ ō
ṣokoleeti	ʃ ō k ō l é è t ì
ṣokunfa	ʃ ō k ũ̀ f à
ṣoyinka	ʃ ó j í ŋ̄ k á
ṣuga	ʃ ú ɡ à
ṣẹda	ʃ ɛ̀ d à
ṣẹda	ʃ ɛ̀ d á
ṣẹkẹrẹ	ʃ ɛ̀ k ɛ̀ ɾ ɛ̀
ṣẹkẹtẹ	ʃ ɛ̀ k ɛ̀ t ɛ́
ṣẹkẹṣẹkẹ	ʃ ɛ̄ k ɛ́ ʃ ɛ̄ k ɛ̀
ṣẹpuṣẹpu	ʃ ɛ́ k͡p ú ʃ ɛ́ k͡p ú
ṣọbiri	ʃ ɔ́ b ì ɾ ì
ṣọdẹ	ʃ ɔ̄ d ɛ̄
ṣọkọrọgbọdọ	ʃ ɔ̄ k ɔ̄ ɾ ɔ̀ ɡ͡b ɔ̀ d ɔ̀
ṣọun	ʃ ɔ̀ ṹ
ṣọwọn	ʃ ɔ̀ w ɔ̃́
ṣọọki	ʃ ɔ́ ɔ̀ k ì
ṣọọn	ʃ ɔ̀ ɔ̃́
ṣọọṣi	ʃ ɔ́ ɔ̀ ʃ ì
ẹ	ɛ
ẹ	ɛ̀
ẹ	ɛ́
ẹ	ɛ̄
ẹ ṣe	ɛ̄ ʃ é
ẹ ṣeun	ɛ̄ ʃ ē ũ̄
ẹba	ɛ̀ b à
ẹba	ɛ̀ b á
ẹbi	ɛ̀ b í
ẹbi	ɛ̀ b ī
ẹbi	ɛ̄ b í
ẹbiti	ɛ̀ b ì t ì
ẹbu	ɛ̄ b ū
ẹbun	ɛ̀ b ũ̀
ẹdinwo	ɛ̀ d ĩ́ w ó
ẹdo	ɛ̄ d ó
ẹdun	ɛ̄ d ũ̄
ẹdọ	ɛ̀ d ɔ̀
ẹdọforo	ɛ̀ d ɔ̀ f ó ɾ ó
ẹdọn	ɛ̄ d ɔ̃̄
ẹfa	ɛ̀ f à
ẹfun	ɛ̄ f ũ̄
ẹfọn	ɛ̀ f ɔ̃́
ẹfọn	ɛ̀ f ɔ̃̄
ẹfọn	ɛ̄ f ɔ̃̀
ẹfọn	ɛ̄ f ɔ̃́
ẹfọnha	ɛ̄ f ɔ̃́ h à
ẹga	ɛ̀ ɡ à
ẹga	ɛ̀ ɡ ā
ẹgba	ɛ̀ ɡ͡b à
ẹgba	ɛ̀ ɡ͡b á
ẹgba	ɛ̄ ɡ͡b ā
ẹgbaa	ɛ̄ ɡ͡b à á
ẹgbado	ɛ̀ ɡ͡b á d ò
ẹgbẹ	ɛ̄ ɡ͡b ɛ́
ẹgbẹrun	ɛ̄ ɡ͡b ɛ̀ ɾ ṹ
ẹgbọn	ɛ̀ ɡ͡b ɔ̃́
ẹghẹn	ɛ ɣ ɛ̃̄
ẹghẹn	ɛ̀ ɣ ɛ̃̄
ẹgin	ɛ̀ ɡ ĩ̄
ẹgunsi	ɛ̀ ɡ ṹ s í
ẹgusi	ɛ̀ ɡ ú s í
ẹgwa	ɛ̀ ɡʷ à
ẹgwa	ɛ̀ ɡʷ á
ẹgwa	ɛ̄ ɡʷ à
ẹgẹ	ɛ̀ ɡ ɛ́
ẹja	ɛ̄ d͡ʒ á
ẹja	ɛ̄ d͡ʒ ā
ẹja apatamaja	à k͡p á t á m ā d͡ʒ à
ẹja arọ	ɛ̄ d͡ʒ ā à ɾ ɔ̀
ẹja onirungbọn	ɛ̄ d͡ʒ ā ō n ĩ́ ɾ ũ̀ ɡ͡b ɔ̃̀
ẹja ṣawa	ɛ̄ d͡ʒ ā ā ʃ á w á
ẹja ọsan	ɛ̄ d͡ʒ ā ɔ̄ s ã̀
ẹjẹ	ɛ̀ d͡ʒ ɛ̀
ẹjẹ riru	ɛ̀ d͡ʒ ɛ̀ ɾ í ɾ ū
ẹjọ	ɛ̀ d͡ʒ ɔ̄
ẹka	ɛ̄ k à
ẹka ede	ɛ̀ k ā è d è
ẹkikun	ɛ̄ k í k ũ̄
ẹkiri	ɛ̀ k ì ɾ ì
ẹkisodu	ɛ́ k í s ó d ù
ẹku	ɛ̀ k ú
ẹkun	ɛ̀ k ṹ
ẹkun	ɛ̄ k ũ̀
ẹkun	ɛ̄ k ṹ
ẹkurẹ	ɛ̀ k ʊ̀ ɾ ɛ́
ẹkuẹ	ɛ̀ k ù ɛ́
ẹkẹ	ɛ̄ k ɛ́
ẹkẹ	ɛ̄ k ɛ̄
ẹkọ	ɛ̀ k ɔ́
ẹkọ	ɛ̀ k ɔ̄
ẹkọ ile	ɛ̀ k ɔ́ ī l é
ẹla	ɛ̀ l à
ẹla	ɛ̄ l á
ẹliri	ɛ̀ l í ɾ í
ẹlomii	ɛ̄ l ò m ĩ́ ĩ̀
ẹlu	ɛ̀ l ú
ẹlulu	ɛ̀ l ú l ú
ẹlẹdẹ	ɛ̄ l ɛ́ d ɛ̀
ẹlẹha	ɛ̄ l ɛ́ h à
ẹlẹja	ɛ̄ l ɛ́ d͡ʒ ā
ẹlẹkọle	ɛ̄ l ɛ́ k ɔ̀ l é
ẹlẹluu	ɛ̄ l ɛ́ l ù ú
ẹlẹmu	ɛ̄ l ɛ́ m ũ̄
ẹlẹnu iru	ɛ̄ l ɛ́ n ũ̄ ī ɾ ú
ẹlẹpa	ɛ̄ l ɛ́ k͡p à
ẹlẹrindodo	ɛ̄ l ɛ́ ɾ ĩ̀ d ò d ò
ẹmi	ɛ̀ m ĩ́
ẹmu	ɛ̄ m ũ̄
ẹna	ɛ̄ n ã̀
ẹni	ɛ̄ n ĩ̄
ẹnikẹni	ɛ̄ n ĩ̄ k ɛ́ n ĩ̄
ẹnu	ɛ̄ n ũ̄
ẹpa	ɛ̀ k͡p à
ẹpa roro	ɛ̀ k͡p à ɾ ò ɾ ō
ẹpẹyọ	ɛ̀ k͡p ɛ̀ j ɔ̀
ẹran	ɛ̄ ɾ ã̄
ẹranko	ɛ̄ ɾ ã̄ k ō
ẹranmi	ɛ̄ ɾ ã̄ m ĩ̄
ẹrin	ɛ̀ ɾ ĩ́
ẹrin	ɛ̀ ɾ ĩ̄
ẹrin keekee	ɛ̀ ɾ ĩ́ k è é k è é
ẹrin kk	ɛ̀ ɾ ĩ́ k è é k è é
ẹrin kk	ɛ̀ ɾ ĩ́ k ɛ̀ ɛ́ k ɛ̀ ɛ́
ẹrin kẹẹkẹẹ	ɛ̀ ɾ ĩ́ k è é k è é
ẹrindinlaaadọta	ɛ̀ ɾ ĩ̀ d ĩ́ l á à á d ɔ́ t ā
ẹrindinlogoji	ɛ̀ ɾ ĩ̀ d ĩ́ l ó ɡ ó d͡ʒ ì
ẹrindinlogun	ɛ̀ ɾ ĩ̀ d ĩ́ l ó ɡ ṹ
ẹrindinlọgbọn	ɛ̀ ɾ ĩ̀ d ĩ́ l ɔ́ ɡ͡b ɔ̃̀
ẹrindinlọgọta	ɛ̀ ɾ ĩ̀ d ĩ́ l ɔ́ ɡ ɔ́ t ā
ẹrinla	ɛ̀ r ĩ̀ l á
ẹrinlelaaadọta	ɛ̀ ɾ ĩ̀ l é l á à á d ɔ́ t ā
ẹrinlelogoji	ɛ̀ ɾ ĩ̀ l é l ó ɡ ó d͡ʒ ì
ẹrinlelogun	ɛ̀ ɾ ĩ̀ l é l ó ɡ ṹ
ẹrinlelọgbọn	ɛ̀ ɾ ĩ̀ l é l ɔ́ ɡ͡b ɔ̃̀
ẹrun	ɛ̄ ɾ ũ̄
ẹrun	ɛ̄ ɾ ʊ̃̄
ẹrẹja	ɛ̄ ɾ ɛ́ d͡ʒ à
ẹrẹkẹ	ɛ̀ ɾ ɛ̀ k ɛ́
ẹrọ	ɛ̀ ɾ ɔ̄
ẹrọ agbaworanyọ	ɛ̀ ɾ ɔ̄ ā m ó ɡ͡b á w ò ɾ ã́ j ɔ̄
ẹrọ agbeniroke	ɛ̀ ɾ ɔ̄ ā ɡ͡b é n ĩ̄ ɾ ò k è
ẹrọ amohunmaworan	ɛ̀ ɾ ɔ̄ ā m ó h ũ̀ m á w ò ɾ ã́
ẹrọ amohuntutu	ɛ̀ ɾ ɔ̄ ā m ó h ũ̄ t ū t ù
ẹrọ amuletutu	ɛ̀ ɾ ɔ̄ ā m ṹ l é t ū t ù
ẹrọ amunawa	ɛ̀ ɾ ɔ̄ ā m ṹ n ã́ w á
ẹrọ amunawa alẹfuufu	ɛ̀ ɾ ɔ̄ ā m ṹ n ã́ w á ā l ɛ̀ f ú ù f ù
ẹrọ amunimi	ɛ̀ ɾ ɔ̄ ā m ṹ n ĩ̄ m ĩ́
ẹrọ asọrọmagbesi	ɛ̀ ɾ ɔ̄ ā s ɔ̀ ɾ ɔ̀ m á ɡ͡b è s ì
ẹrọ ayarabiaṣa	ɛ̀ ɾ ɔ̄ ā j á ɾ ā b í à ʃ á
ẹrọ ayaworan	ɛ̀ ɾ ɔ̄ ā j à w ò ɾ ã́
ẹrọ gbohungbohun	ɛ̀ ɾ ɔ̄ ɡ͡b ō h ũ̀ ɡ͡b ō h ũ̀
ẹrọ ibanisọrọ	ɛ̀ ɾ ɔ̄ ì b á n ĩ̄ s ɔ̀ ɾ ɔ̀
ẹrọ ifọbọ	ɛ̀ ɾ ɔ̄ ì f ɔ̄ b ɔ́
ẹrọ ifọṣọ	ɛ̀ ɾ ɔ̄ ì f ɔ̄ ʃ ɔ̄
ẹrọ ilọnkan	ɛ̀ ɾ ɔ̄ ì l ɔ̄ ŋ̀ k ã̄
ẹrọ iranṣọ	ɛ̀ ɾ ɔ̄ ì ɾ ã́ ʃ ɔ̄
ẹrọ itẹwe	ɛ̀ ɾ ɔ̄ ì t ɛ̀ w é
ẹrọ iṣawari	ɛ̀ ɾ ɔ̄ ì ʃ à w á ɾ í
ẹrọ iṣiro	ɛ̀ ɾ ɔ̄ ì ʃ í ɾ ò
ẹsa	ɛ̀ s à
ẹsan	ɛ̀ s ã̄
ẹsan	ɛ̀ s ɔ̃́
ẹsẹ	ɛ̄ s ɛ̀
ẹsẹ	ɛ̄ s ɛ̄
ẹta	ɛ̀ t ā
ẹtadinlaaadọta	ɛ̀ t à d ĩ́ l á à á d ɔ́ t ā
ẹtadinlogoji	ɛ̀ t à d ĩ́ l ó ɡ ó d͡ʒ ì
ẹtadinlogun	ɛ̀ t ã̀ d ĩ́ l ó ɡ ṹ
ẹtadinlọgbọn	ɛ̀ t à d ĩ́ l ɔ́ ɡ͡b ɔ̃̀
ẹtadinlọgọta	ɛ̀ t à d ĩ́ l ɔ́ ɡ ɔ́ t ā
ẹtala	ɛ̀ t à l á
ẹtalelaaadọta	ɛ̀ t à l é l á à á d ɔ́ t ā
ẹtalelogoji	ɛ̀ t à l é l ó ɡ ó d͡ʒ ì
ẹtalelogun	ɛ̀ t à l é l ó ɡ ṹ
ẹtalelọgbọn	ɛ̀ t à l é l ɔ́ ɡ͡b ɔ̃̀
ẹtu	ɛ̀ t ù
ẹtu	ɛ̄ t ù
ẹtu	ɛ̄ t ū
ẹtẹ	ɛ̀ t ɛ̀
ẹtẹ	ɛ̀ t ɛ́
ẹu	ɛ̄ ù
ẹun	ɛ̄ ũ̄
ẹwa	ɛ w à
ẹwa	ɛ̀ w à
ẹwa	ɛ̀ w á
ẹwadun	ɛ̀ w á d ṹ
ẹwiri	ɛ̄ w ì ɾ ì
ẹwẹn	ɛ̀ w ɛ̃̄
ẹyawo	ɛ̀ j á w ó
ẹyin	ɛ̀ j ĩ̀
ẹyin	ɛ̀ j ĩ̄
ẹyin	ɛ̄ j ĩ̀
ẹyin	ɛ̄ j ĩ̄
ẹyinju	ɛ̄ j ĩ̄ d͡ʒ ú
ẹyun	ɛ̄ j ṹ
ẹyẹ	ɛ̀ j ɛ̄
ẹyẹ	ɛ̄ j ɛ̄
ẹyẹ aganran	ɛ̄ j ɛ̄ ā ɡ ã́ ɾ ã́
ẹyẹ akoko	ɛ̄ j ɛ̄ à k ó k ó
ẹyẹ ṣango	ɛ̄ j ɛ̄ ʃ ã̀ ɡ ó
ẹyẹle	ɛ̄ j ɛ̄ l é
ẹṣin	ɛ̄ ʃ ĩ̄
ẹẹfa	ɛ̄ ɛ́ f à
ẹẹjọ	ɛ̄ ɛ́ d͡ʒ ɔ̄
ẹẹkan	ɛ̀ ɛ̀ k ã̄
ẹẹkẹ	ɛ̀ ɛ̀ k ɛ́
ẹẹmeje	ɛ̀ ɛ̀ m ē d͡ʒ ē
ẹẹmeji	ɛ̀ ɛ̀ m ē d͡ʒ ì
ẹẹmẹfa	ɛ̀ ɛ̀ m ɛ̄ f à
ẹẹmẹjọ	ɛ̀ ɛ̀ m ɛ̄ d͡ʒ ɔ̄
ẹẹmẹrin	ɛ̀ ɛ̀ m ɛ̄ ɾ ĩ̄
ẹẹmẹta	ɛ̀ ɛ̀ m ɛ̄ t ā
ẹẹmẹwaa	ɛ̀ ɛ̀ m ɛ̄ w à á
ẹẹra	ɛ̄ ɛ́ ɾ à
ẹẹrin	ɛ̄ ɛ́ ɾ ĩ̄
ẹẹta	ɛ̄ ɛ́ t ā
ẹẹwaa	ɛ̄ ɛ́ w à á
ọ	ɔ
ọ	ɔ́
ọ	ɔ̄
ọba	ɔ̄ b à
ọba	ɔ̄ b ā
ọbaala	ɔ̄ b ā á l á
ọbaluaye	ɔ̄ b ā l ú ā j é
ọbaluayesanya	ɔ̄ b ā l ú ā j é s ã̀ j à
ọbalufọn	ɔ̄ b à l ù f ɔ̃̀
ọbalufọn	ɔ̄ b ā l ù f ɔ̃̀
ọbara	ɔ̀ b à ɾ à
ọbasanya	ɔ̄ b á s ã̀ j à
ọbatala	ɔ̄ b à t á l á
ọbitun	ɔ̀ b ɪ̄ t ʊ̃̄
ọbitun	ɔ̄ b ɪ̄ t ʊ̃̄
ọbun	ɔ̀ b ũ̀
ọbẹ	ɔ̀ b ɛ̄
ọbẹ	ɔ̄ b ɛ̀
ọbọ	ɔ̀ b ɔ̀
ọbọ	ɔ̀ b ɔ̄
ọbọ	ɔ̄ b ɔ́
ọbọnbọn	ɔ̀ b ɔ̃̀ ũ̀ b ɔ̃̄ ũ̀
ọda	ɔ̀ d à
ọda	ɔ̀ d á
ọdan	ɔ̀ d ã̀
ọdan	ɔ̄ d ã́
ọdun	ɔ̀ d ũ̀
ọdun	ɔ̄ d ṹ
ọdẹ	ɔ̀ d ɛ̀
ọdẹ	ɔ̄ d ɛ̄
ọdẹgbami	ɔ̄ d ɛ́ ɡ͡b à m ĩ́
ọdẹmọ	ɔ̄ d ɛ̄ m ɔ̃̄
ọdọn	ɔ̄ d ɔ̃́
ọdọọdun	ɔ̄ d ɔ̄ ɔ̄ d ṹ
ọfa	ɔ̀ f à
ọfa	ɔ̄ f à
ọfiisi	ɔ́ f í ì s ì
ọfun	ɔ̀ f ũ̄
ọfọ	ɔ̄ f ɔ̀
ọga	ɔ̀ ɡ à
ọga	ɔ̀ ɡ á
ọganjọ	ɔ̀ ɡ ã̀ d͡ʒ ɔ́
ọgba	ɔ̀ ɡ͡b à
ọgba	ɔ̄ ɡ͡b à
ọgba	ɔ̄ ɡ͡b ā
ọgbase	ɔ̀ ɡ͡b à s è
ọgbun	ɔ̀ ɡ͡b ũ̄
ọgbun	ɔ̀ ɡ͡b ṹ
ọgbẹni	ɔ̀ ɡ͡b ɛ́ n ĩ̄
ọgbẹri	ɔ̀ ɡ͡b ɛ̀ ɾ ì
ọgbọn	ɔ̄ ɡ͡b ɔ̃̀
ọgbọn	ɔ̄ ɡ͡b ɔ̃́
ọghọn	ɔ̀ ɣ ɔ̃̄
ọginnitin	ɔ̀ ɡ ĩ̀ n ĩ̀ t ĩ̀
ọgunrun ọọ	ɔ̄ ɡ ũ̀ ɾ ũ̀ ɔ̄ ɔ́
ọgẹdẹ	ɔ̀ ɡ ɛ̀ d ɛ̀
ọgẹdẹ agbagba	ɔ̀ ɡ ɛ̀ d ɛ̀ à ɡ͡b ā ɡ͡b à
ọgọdọ	ɔ̀ ɡ ɔ̀ d ɔ̀
ọgọta	ɔ̄ ɡ ɔ́ t ā
ọja	ɔ̀ d͡ʒ à
ọja	ɔ̀ d͡ʒ á
ọja	ɔ̄ d͡ʒ à
ọjọ	ɔ̄ d͡ʒ ɔ́
ọjọ abamẹta	ɔ̄ d͡ʒ ɔ́ à b á m ɛ́ t ā
ọjọ aiku	ɔ̄ d͡ʒ ɔ́ à ì k ú
ọjọ aje	ɔ̄ d͡ʒ ɔ́ ā d͡ʒ é
ọjọ iṣẹgun	ɔ̄ d͡ʒ ɔ́ ì ʃ ɛ́ ɡ ũ̄
ọjọ ẹti	ɔ̄ d͡ʒ ɔ́ ɛ̄ t ì
ọjọbọ	ɔ̄ d͡ʒ ɔ́ b ɔ̀
ọjọkanri	ɔ̄ d͡ʒ ɔ́ k ã̄ ɾ í
ọjọru	ɔ̄ d͡ʒ ɔ́ ɾ ú
ọka	ɔ̄ k à
ọkada	ɔ̀ k ā d à
ọkan	ɔ̀ k ã̄
ọkan	ɔ̄ k ã̀
ọkan	ɔ̄ k ã́
ọkan	ɔ̄ k ã̄
ọkandinlaaadọta	ɔ̀ k ã̀ d ĩ́ l á à á d ɔ́ t ā
ọkandinlogoji	ɔ̀ k ã̀ d ĩ́ l ó ɡ ó d͡ʒ ì
ọkandinlogun	ɔ̀ k ã̀ d ĩ́ l ó ɡ ṹ
ọkandinlọgbọn	ɔ̀ k ã̀ d ĩ́ l ɔ́ ɡ͡b ɔ̃̀
ọkandinlọgọta	ɔ̀ k ã̀ d ĩ́ l ɔ́ ɡ ɔ́ t ā
ọkanjuwa	ɔ̀ k ã́ d͡ʒ ú w à
ọkanla	ɔ̀ k ã̀ l á
ọkanlelaaadọta	ɔ̀ k ã̀ l é l á à á d ɔ́ t ā
ọkanlelogoji	ɔ̀ k ã̀ l é l ó ɡ ó d͡ʒ ì
ọkanlelogun	ɔ̀ k ã̀ l é l ó ɡ ṹ
ọkanlelọgbọn	ɔ̀ k ã̀ l é l ɔ́ ɡ͡b ɔ̃̀
ọkanran	ɔ̀ k ã̀ ɾ ã̀
ọkin	ɔ̀ k ĩ́
ọkun	ɔ̀ k ũ̀
ọkunmẹ	ɔ̀ k ũ̀ m ɛ̀
ọkuta	ɔ̀ k ʊ́ t ā
ọkẹ	ɔ̀ k ɛ́
ọkẹrẹ	ɔ̀ k ɛ̀ ɾ ɛ̀
ọkẹrẹ	ɔ̀ k ɛ́ ɾ ɛ́
ọkọ	ɔ̀ k ɔ̀
ọkọ	ɔ̄ k ɔ̀
ọkọ	ɔ̄ k ɔ́
ọkọ	ɔ̄ k ɔ̄
ọkọ oju irin	ɔ̄ k ɔ̀ ō d͡ʒ ú ī ɾ ĩ̄
ọkọọkan	ɔ̀ k ɔ̀ ɔ̀ k ɔ̃̄
ọla	ɔ̀ l ā
ọla	ɔ̄ l à
ọla	ɔ̄ l á
ọlamiọbọ	ɔ l á m ɪ̃́ ɔ̀ b ɔ́
ọlua	ɔ̄ l ʊ́ ā
ọlẹ	ɔ̀ l ɛ̄
ọlẹ	ɔ̄ l ɛ̀
ọlẹdarun	ɔ̀ l ɛ́ d à ɾ ũ̀
ọlọ	ɔ̄ l ɔ̄
ọlọ inu	ɔ̄ l ɔ̄ ī n ṹ
ọlọbatala	ɔ̄ b à t á l á
ọlọfin	ɔ̄ l ɔ́ f ĩ̄
ọlọfinmẹyẹ	ɔ l ɔ́ f ɪ̃́ m ɛ̀ j ɛ̄
ọlọfinmẹyẹ	ɔ l ɔ́ f ɪ̃̄ m ɛ̀ j ɛ̄
ọlọfinmẹyẹ	ɔ̄ l ɔ́ f ĩ́ m ɛ̀ j ɛ̄
ọlọfinmẹyẹ	ɔ̄ l ɔ́ f ĩ̄ m ɛ̀ j ɛ̄
ọlọgẹdẹ	ɔ̄ l ɔ́ ɡ ɛ̀ d ɛ̀
ọlọpaa	ɔ̄ l ɔ́ꜜ k͡p á
ọlọrun	ɔ̄ l ɔ́ ɾ ũ
ọlọrọ	ɔ̄ l ɔ́ ɾ ɔ̀
ọlọwọ	ɔ̄ l ɔ́ w ɔ̀
ọlọṣun	ɔ̄ l ɔ́ ʃ ũ̄
ọma	ɔ̄ m ã̄
ọmakọma	ɔ̄ m ã̄ k ɔ́ m ã̄
ọmama	ɔ̄ m ã̄ m ã̄
ọmọ	ɔ̄ m ɔ̃̄
ọmọ ale	ɔ̄ m ɔ̃̄ à l è
ọmọ ile iwe	ɔ̄ m ɔ̃̄ ī l é ì w é
ọmọ odu	ɔ̄ m ɔ̃̄ ō d ù
ọmọ ẹgbẹ	ɔ̄ m ɔ̃̄ ɛ̄ ɡ͡b ɛ́
ọmọba	ɔ̄ m ɔ̃̄ b ā
ọmọbọsẹde	ɔ̄ m ɔ̃́ b ɔ́ s ɛ̀ d é
ọmọdo	ɔ̄ m ɔ̃̄ d ó
ọmọewi	ɔ̄ m ɔ̃̄ è w í
ọmọge	ɔ̄ m ɔ̃̄ ɡ ē
ọmọkọmọ	ɔ̄ m ɔ̃̄ k ɔ́ m ɔ̃̄
ọmọlanke	ɔ̄ m ɔ̃̄ l ā ŋ̄ k ē
ọmọleti	ɔ̄ m ɔ̃̄ l é t í
ọmọluwabi	ɔ̄ m ɔ̃̄ l ú w à b í
ọmọlọ	ɔ̄ m ɔ̃̄ l ɔ̄
ọmọnile	ɔ̄ m ɔ̃̄ n ĩ́ l é
ọmọniyan	ɔ̄ m ɔ̃̄ n ĩ̀ j ã̀
ọmọwu	ɔ̄ m ɔ̃̄ w ú
ọn	ɔ̃́
ọn	ɔ̃̄
ọna	ɔ̀ n ã̀
ọna	ɔ̀ n ã́
ọna	ɔ̄ n ã̀
ọni	ɔ n ɪ̃̄
ọni	ɔ̀ n ĩ̀
ọni	ɔ̀ n ĩ̄
ọni	ɔ̄ n ĩ̄
ọnikọni	ɔ̄ n ĩ̄ k ɔ́ n ĩ́
ọnikọni	ɔ̄ n ɪ̃̄ k ɔ́ n ɪ̃̄
ọnini	ɔ̀ n ĩ́ n ĩ́
ọniyan	ɔ̀ n ɪ̃̀ j ã̀
ọpalaba	ɔ̀ k͡p á l á b á
ọpalamba	ɔ̀ k͡p á l á ŋ́ b á
ọpalanba	ɔ̀ k͡p á l á ŋ́ b á
ọpẹ	ɔ̀ k͡p ɛ̀
ọpẹ	ɔ̀ k͡p ɛ̄
ọpẹ	ɔ̄ k͡p ɛ́
ọpẹlẹ	ɔ̀ k͡p ɛ̀ l ɛ̀
ọpọlọ	ɔ̀ k͡p ɔ̀ l ɔ́
ọpọlọ	ɔ̄ k͡p ɔ̄ l ɔ̄
ọpọlọ okun	ɔ̀ k͡p ɔ̀ l ɔ́ ò k ũ̄
ọpọn ifa	ɔ̄ k͡p ɔ̃́ ī f á
ọra	ɔ̀ ɾ á
ọrangun	ɔ̀ ɾ ã̀ ɡ ṹ
ọranmiyan	ɔ̀ ɾ ã̀ m ĩ́ j ã̀
ọriṣa	ɔ̀ ɾ ɪ̀ ʃ à
ọruka	ɔ̀ ɾ ʊ̀ k ā
ọrukọ	ɔ̄ ɾ ʊ́ k ɔ̄
ọrun	ɔ̀ ɾ ũ̄
ọrun	ɔ̀ ɾ ṹ
ọrun	ɔ̄ ɾ ũ̀
ọrun	ɔ̄ ɾ ũ̄
ọrun	ɔ̄ ɾ ṹ
ọrunmila	ɔ̀ ɾ ṹ m ĩ̀ l à
ọrẹ	ɔ̀ ɾ ɛ́
ọrẹ	ɔ̄ ɾ ɛ́
ọrẹ	ɔ̄ ɾ ɛ̄
ọrọ	ɔ̀ ɾ ɔ̀
ọrọ	ɔ̀ ɾ ɔ́
ọrọ	ɔ̄ ɾ ɔ̀
ọrọ	ɔ̄ ɾ ɔ́
ọrọ	ɔ̄ ɾ ɔ̄
ọrọ agba	ɔ̀ ɾ ɔ̀ à ɡ͡b à
ọrọ ajọsọ	ɔ̀ ɾ ɔ̀ à d͡ʒ ɔ̄ s ɔ̄
ọrọ akanlo	ɔ̀ ɾ ɔ̀ à k ã̀ l ò
ọrọ awada	ɔ̀ ɾ ɔ̀ à w à d à
ọrọ aṣiri	ɔ̀ ɾ ɔ̀ à ʃ í ɾ í
ọrọkọrọ	ɔ̀ ɾ ɔ̀ k ɔ́ ɾ ɔ̀
ọrọwa	ɔ̄ ɾ ɔ́ w á
ọsa	ɔ̀ s á
ọsagunda	ɔ̀ s á ɡ ṹ d á
ọsan	ɔ̀ s ã́
ọsan	ɔ̄ s ã̀
ọsan	ɔ̄ s ã́
ọsanyin	ɔ̀ s ã́ j ĩ̀
ọsanyin	ɔ̀ s ã̄ j ĩ̀
ọsijin	ɔ́ s í d͡ʒ ĩ̀
ọsin	ɔ̀ s ĩ̀
ọsun	ɔ̀ s ũ̄
ọsẹ	ɔ̀ s ɛ̀
ọsẹ	ɔ̀ s ɛ́
ọsọọsan	ɔ̀ s ɔ̀ ɔ̀ s ã́
ọta	ɔ̀ t á
ọta	ɔ̄ t ā
ọti	ɔ̄ t í
ọtin	ɔ̀ t ĩ̀
ọtin	ɔ̄ t ĩ́
ọtunla	ɔ̀ t ṹ l ā
ọtẹtẹ	ɔ̀ t ɛ́ t ɛ́
ọwa	ɔ̄ w á
ọwaara	ɔ̀ w à à ɾ à
ọwun	ɔ̄ w ũ̄
ọwurọ	ɔ̀ w ʊ́ ɾ ɔ̀
ọwọ	ɔ̀ w ɔ̀
ọwọ	ɔ̀ w ɔ́
ọwọ	ɔ̄ w ɔ̀
ọwọ	ɔ̄ w ɔ́
ọwọnrin	ɔ̀ w ɔ̃́ ɾ ĩ́
ọya	ɔ̀ j à
ọya	ɔ̀ j ā
ọya	ɔ̄ j ā
ọyaya	ɔ̀ j à j à
ọyun	ɔ̄ j ṹ
ọyẹ	ɔ̄ j ɛ́
ọyẹku	ɔ̀ j ɛ̀ k ú
ọyọ	ɔ̀ j ɔ́
ọyọmesi	ɔ̀ j ɔ́ m è s ì
ọṣa	ɔ̀ ʃ à
ọṣa	ɔ̀ ʃ ā
ọṣa	ɔ̄ ʃ à
ọṣaṣa	ɔ̀ ʃ á ʃ á
ọṣun	ɔ̀ ʃ ũ̄
ọṣupa	ɔ̀ ʃ ʊ̀ k͡p á
ọṣọ	ɔ̀ ʃ ɔ́
ọṣọsi	ɔ̀ ʃ ɔ́ s ì
ọṣọọsi	ɔ̀ ʃ ɔ́ ɔ̀ s ì
ọọ	ɔ̄ ɔ̀
ọọ	ɔ̄ ɔ́
ọọdunrun	ɔ̀ ɔ́ d ṹ ɾ ṹ
ọọni	ɔ̀ ɔ̀ n ĩ̄
ọọni	ɔ̄ ɔ̀ n ĩ̄
ọọrọ	ɔ̀ ɔ́ ɾ ɔ̀
ọọṣa	ɔ̀ ɔ̀ ʃ à
