arzan	a r z ɑ n
bari	b a r i
belki	b ɛ l c ɪ
bıze	b ɪ z ə
dare	d ɑ ɾ ə
dındon	d æ n d ɔː n
eza	e z ɑ h
herb	h e r b
kam	c a m
kardi	k h a ʃ d i
kılise	c i l i s ɛ
luwen	l y u̯ ə n
name	n ɔː m e
pa	p ɔː
qırm	q ɪ r m
rang	ɾ a ŋ ɡ
roh	ɾ oː
ruh	ɾ uː
tut	t u t
vızeri	ʋ ɨ z ɛ ɾ i
zeytun	z eː t u n
zıwan	z æ b əː n
ڨ	v i f
ڨ	v
