аб'явіць	a b j a vʲ i t͡sʲ
аб'яўляць	a b j a u̯ lʲ a t͡sʲ
абавязак	a b a vʲ a z a k
абавязацельства	a b a vʲ a z a t͡sʲ e lʲ s t v a
абавязковы	a b a vʲ a s k o v ɨ
абараняць	a b a r a nʲ a t͡sʲ
абараніць	a b a r a nʲ i t͡sʲ
абарачацца	a b a r a t͡ʂ a t͡sː a
абарона	a b a r o n a
абат	a b a t
абатыса	a b a t ɨ s a
абацтва	a b a t͡s t v a
абвозіць	a b v o zʲ i t͡sʲ
абвінаваціць	a b vʲ i n a v a t͡sʲ i t͡sʲ
абвінавачваць	a b vʲ i n a v a t͡ʂ v a t͡sʲ
абгаварыць	a b ɣ a v a r ɨ t͡sʲ
абгаворваць	a b ɣ a v o r v a t͡sʲ
абедаць	a bʲ e d a t͡sʲ
аблічча	a b lʲ i t͡ʂː a
абмеркаваць	a b mʲ e r k a v a t͡sʲ
абмяркоўваць	a b mʲ a r k o u̯ v a t͡sʲ
абносіць	a b n o sʲ i t͡sʲ
або	a b o
абразлівы	a b r a zʲ lʲ i v ɨ
абрус	a b r u s
абрыдлівы	a b r ɨ d lʲ i v ɨ
абрэвіятура	a b r e vʲ i j a t u r a
абсалютны	a p s a lʲ u t n ɨ
абстрактны	a p s t r a k t n ɨ
абцугі	a p t͡s u ɣʲ i
абяцаць	a bʲ a t͡s a t͡sʲ
авантура	a v a n t u r a
авантурны	a v a n t u r n ɨ
авечка	a vʲ e t͡ʂ k a
авёс	a vʲ o s
агарод	a ɣ a r o t
агароджа	a ɣ a r o d͡ʐ a
агая	a ɣ a j a
агледзець	a ɣ lʲ e d͡zʲ e t͡sʲ
аглядаць	a ɣ lʲ a d a t͡sʲ
агонь	a ɣ o nʲ
аграрны	a ɣ r a r n ɨ
агульны	a ɣ u lʲ n ɨ
агурок	a ɣ u r o k
агіда	a ɣʲ i d a
ад	a t
адам	a d a m
адвага	a d v a ɣ a
адважны	a d v a ʐ n ɨ
адвольны	a d v o lʲ n ɨ
адгаварыць	a d ɣ a v a r ɨ t͡sʲ
аддаваць	a dː a v a t͡sʲ
аддаць	a dː a t͡sʲ
адзежа	a d͡zʲ e ʐ a
адзёр	a d͡zʲ o r
адзін	a d͡zʲ i n
адзінаццаты	a d͡zʲ i n a t͡sː a t ɨ
адзінаццаць	a d͡zʲ i n a t͡sː a t͡sʲ
адзіны	a d͡zʲ i n ɨ
адказ	a t k a s
адказаць	a t k a z a t͡sʲ
адказваць	a t k a z v a t͡sʲ
адказны	a t k a z n ɨ
адклад	a t k ɫ a t
адкуль	a t k u lʲ
адна	a d n a
аднавокі	a d n a v o kʲ i
аднагалосны	a d n a ɣ a ɫ o s n ɨ
аднак	a d n a k
аднакаляровы	a d n a k a lʲ a r o v ɨ
аднарог	a d n a r o x
аднашлюбнасць	a d n a ʂ lʲ u b n a sʲ t͡sʲ
аднашлюбны	a d n a ʂ lʲ u b n ɨ
адно	a d n o
адносны	a d n o s n ɨ
адпачываць	a t p a t͡ʂ ɨ v a t͡sʲ
адпачынак	a t p a t͡ʂ ɨ n a k
адрас	a d r a s
адрозны	a d r o z n ɨ
адрэс	a d r e s
адсутнасць	a t s u t n a sʲ t͡sʲ
адсутны	a t s u t n ɨ
адсутнічаць	a t s u t nʲ i t͡ʂ a t͡sʲ
адсюль	a t͡sʲ sʲ u lʲ
адтуль	a tː u lʲ
адукацыя	a d u k a t͡s ɨ j a
адчыняць	a t ː͡ʂ ɨ nʲ a t͡sʲ
адчыніць	a t ː͡ʂ ɨ nʲ i t͡sʲ
адэлаіда	a d e ɫ a j i d a
азбука	a z b u k a
азербайджан	a zʲ e r b a j d͡ʐ a n
азербайджанец	a zʲ e r b a j d͡ʐ a nʲ e t͡s
азербайджанка	a zʲ e r b a j d͡ʐ a n k a
азербайджанскі	a zʲ e r b a j d͡ʐ a n s kʲ i
азэрбайджан	a z e r b a j d͡ʐ a n
азія	a zʲ i j a
азіяцкі	a zʲ i j a t͡s kʲ i
айцец	a j t͡sʲ e t͡s
айчына	a j t͡ʂ ɨ n a
акадэмія	a k a d e mʲ i j a
акалічнасць	a k a lʲ i t͡ʂ n a sʲ t͡sʲ
акно	a k n o
аксаміт	a k s a mʲ i t
актрыса	a k t r ɨ s a
актыўны	a k t ɨ u̯ n ɨ
акула	a k u ɫ a
акуляры	a k u lʲ a r ɨ
акцёр	a k t͡sʲ o r
акім	a kʲ i m
акіян	a kʲ i j a n
ала	a ɫ a
алах	a ɫ a x
албанец	a ɫ b a nʲ e t͡s
албанка	a ɫ b a n k a
албанскі	a ɫ b a n s kʲ i
албанія	a ɫ b a nʲ i j a
але	a lʲ e
алег	a lʲ e x
алена	a lʲ e n a
алень	a lʲ e nʲ
алжыр	a ɫ ʐ ɨ r
алжырац	a ɫ ʐ ɨ r a t͡s
алжырка	a ɫ ʐ ɨ r k a
аловак	a ɫ o v a k
альбанія	a lʲ b a nʲ i j a
алюміній	a lʲ u mʲ i nʲ i j
аляксандар	a lʲ a k s a n d a r
аляксандр	a lʲ a k s a n d r
аляксандра	a lʲ a k s a n d r a
аляксей	a lʲ a k sʲ e j
алёс	a lʲ o s
аліна	a lʲ i n a
аман	a m a n
амерыка	a mʲ e r ɨ k a
амерыканец	a mʲ e r ɨ k a nʲ e t͡s
амерыканка	a mʲ e r ɨ k a n k a
амерыканскі	a mʲ e r ɨ k a n s kʲ i
анамастыка	a n a m a s t ɨ k a
ананас	a n a n a s
анастасія	a n a s t a sʲ i j a
анатолій	a n a t o lʲ i j
ангельску	a n ɣʲ e lʲ s k u
ангельскі	a n ɣʲ e lʲ s kʲ i
ангельшчына	a n ɣʲ e lʲ ʂ t͡ʂ ɨ n a
ангеліна	a n ɣʲ e lʲ i n a
англійская	a n ɣ lʲ i j s k a j a
англійскі	a n ɣ lʲ i j s kʲ i
англія	a n ɣ lʲ i j a
ангола	a n ɣ o ɫ a
андора	a n d o r a
андорскі	a n d o r s kʲ i
андрэй	a n d r e j
анжаліка	a n ʐ a lʲ i k a
анжэла	a n ʐ e ɫ a
антаніна	a n t a nʲ i n a
антарктыда	a n t a r k t ɨ d a
антон	a n t o n
анісім	a nʲ i sʲ i m
апазнаваць	a p a z n a v a t͡sʲ
апазнаць	a p a z n a t͡sʲ
апарыш	a p a r ɨ ʂ
апостраф	a p o s t r a f
апошні	a p o ʂ nʲ i
апранацца	a p r a n a t͡sː a
апранаць	a p r a n a t͡sʲ
аптэка	a p t e k a
аптэкар	a p t e k a r
аптэкарка	a p t e k a r k a
апісальны	a pʲ i s a lʲ n ɨ
апісанне	a pʲ i s a nʲː e
апісаць	a pʲ i s a t͡sʲ
апісваць	a pʲ i s v a t͡sʲ
арабскі	a r a p s kʲ i
аранжавы	a r a n ʐ a v ɨ
аргазм	a r ɣ a z m
аргентына	a r ɣʲ e n t ɨ n a
аргенціна	a r ɣʲ e nʲ t͡sʲ i n a
аркадзій	a r k a d͡zʲ i j
аркуш	a r k u ʂ
арменія	a r mʲ e nʲ i j a
армэнія	a r m e nʲ i j a
армянка	a r mʲ a n k a
армянскі	a r mʲ a n s kʲ i
армянін	a r mʲ a nʲ i n
армія	a r mʲ i j a
арол	a r o ɫ
арсеній	a r sʲ e nʲ i j
артур	a r t u r
артыкул	a r t ɨ k u ɫ
артышок	a r t ɨ ʂ o k
арфаграфія	a r f a ɣ r a fʲ i j a
архітэктар	a r xʲ i t e k t a r
архітэктарка	a r xʲ i t e k t a r k a
арцём	a r t͡sʲ o m
арыстоцель	a r ɨ s t o t͡sʲ e lʲ
арышт	a r ɨ ʂ t
арэх	a r e x
аса	a s a
асаблівы	a s a b lʲ i v ɨ
асабісты	a s a bʲ i s t ɨ
асвета	a sʲ vʲ e t a
аселы	a sʲ e ɫ ɨ
аснова	a s n o v a
асноватворны	a s n o v a t v o r n ɨ
асоба	a s o b a
астраном	a s t r a n o m
астраномія	a s t r a n o mʲ i j a
астэроід	a s t e r o j i t
асяроддзе	a sʲ a r o d͡zʲː e
асёл	a sʲ o ɫ
атава	a t a v a
атмасфера	a t m a sʲ fʲ e r a
атрута	a t r u t a
атрутны	a t r u t n ɨ
атэлье	a t e lʲ j e
афанасій	a f a n a sʲ i j
афганец	a v ɣ a nʲ e t͡s
афганістан	a v ɣ a nʲ i s t a n
афрыка	a f r ɨ k a
афрыканец	a f r ɨ k a nʲ e t͡s
афрыканка	a f r ɨ k a n k a
афрыканскі	a f r ɨ k a n s kʲ i
ахвяра	a x vʲ a r a
ахоўны	a x o u̯ n ɨ
аэрапорт	a e r a p o r t
аўганістан	a u̯ ɣ a nʲ i s t a n
аўдоцця	a u̯ d o t͡sʲː a
аўстраліец	a u̯ s t r a lʲ i j e t͡s
аўстралійка	a u̯ s t r a lʲ i j k a
аўстралійскі	a u̯ s t r a lʲ i j s kʲ i
аўстралія	a u̯ s t r a lʲ i j a
аўстрыец	a u̯ s t r ɨ j e t͡s
аўстрыйка	a u̯ s t r ɨ j k a
аўстрыйскі	a u̯ s t r ɨ j s kʲ i
аўстрыя	a u̯ s t r ɨ j a
аўтамабіль	a u̯ t a m a bʲ i lʲ
аўтар	a u̯ t a r
аўтобус	a u̯ t o b u s
аўторак	a u̯ t o r a k
аўца	a u̯ t͡s a
баба	b a b a
бабуля	b a b u lʲ a
бабушка	b a b u ʂ k a
бабёр	b a bʲ o r
баваўняны	b a v a u̯ nʲ a n ɨ
бавоўна	b a v o u̯ n a
багаж	b a ɣ a ʂ
багаты	b a ɣ a t ɨ
багатыр	b a ɣ a t ɨ r
багацце	b a ɣ a t͡sʲː e
багдан	b a ɣ d a n
баграны	b a ɣ r a n ɨ
багуслаў	b a ɣ u s ɫ a u̯
багіня	b a ɣʲ i nʲ a
баклажан	b a k ɫ a ʐ a n
балгарка	b a ɫ ɣ a r k a
балгарскі	b a ɫ ɣ a r s kʲ i
балгарын	b a ɫ ɣ a r ɨ n
балгарыя	b a ɫ ɣ a r ɨ j a
балець	b a lʲ e t͡sʲ
балота	b a ɫ o t a
балтыйскі	b a ɫ t ɨ j s kʲ i
бальніца	b a lʲ nʲ i t͡s a
балюстрада	b a lʲ u s t r a d a
балючы	b a lʲ u t͡ʂ ɨ
балівія	b a lʲ i vʲ i j a
банан	b a n a n
бангладэш	b a n ɣ ɫ a d e ʂ
барада	b a r a d a
барадаты	b a r a d a t ɨ
баразна	b a r a z n a
баран	b a r a n
бародаўка	b a r o d a u̯ k a
барыс	b a r ɨ s
барысаў	b a r ɨ s a u̯
баскскі	b a s k s kʲ i
баснійскі	b a sʲ nʲ i j s kʲ i
батанічны	b a t a nʲ i t͡ʂ n ɨ
бацька	b a t͡sʲ k a
баця	b a t͡sʲ a
бацян	b a t͡sʲ a n
бачанне	b a t͡ʂ a nʲː e
бачны	b a t͡ʂ n ɨ
бачыць	b a t͡ʂ ɨ t͡sʲ
баяцца	b a j a t͡sː a
бегаць	bʲ e ɣ a t͡sʲ
бегемот	bʲ e ɣʲ e m o t
бегчы	bʲ e x t͡ʂ ɨ
бедната	bʲ e d n a t a
бедны	bʲ e d n ɨ
без	bʲ e s
бездань	bʲ e z d a nʲ
безназоўны	bʲ e z n a z o u̯ n ɨ
беларус	bʲ e ɫ a r u s
беларуска	bʲ e ɫ a r u s k a
беларускамоўны	bʲ e ɫ a r u s k a m o u̯ n ɨ
беларуская	bʲ e ɫ a r u s k a j a
беларускі	bʲ e ɫ a r u s kʲ i
беларусы	bʲ e ɫ a r u s ɨ
беларусь	bʲ e ɫ a r u sʲ
беларусяй	bʲ e ɫ a r u sʲ a j
беларусяю	bʲ e ɫ a r u sʲ a j u
беларусі	bʲ e ɫ a r u sʲ i
белы	bʲ e ɫ ɨ
бельгіец	bʲ e lʲ ɣʲ i j e t͡s
бельгійка	bʲ e lʲ ɣʲ i j k a
бельгійскі	bʲ e lʲ ɣʲ i j s kʲ i
бельгія	bʲ e lʲ ɣʲ i j a
беліз	bʲ e lʲ i s
бензін	bʲ e n zʲ i n
бенін	bʲ e nʲ i n
бераг	bʲ e r a x
берагчы	bʲ e r a x t͡ʂ ɨ
бераст	bʲ e r a s t
берасьце	bʲ e r a sʲ t͡sʲ e
бервяно	bʲ e r vʲ a n o
берлін	bʲ e r lʲ i n
берылій	bʲ e r ɨ lʲ i j
бес	bʲ e s
бессмяротны	bʲ e sʲː mʲ a r o t n ɨ
бесстаронні	bʲ e sː t a r o nʲː i
благі	b ɫ a ɣʲ i
блакітны	b ɫ a kʲ i t n ɨ
бледны	b lʲ e d n ɨ
блыха	b ɫ ɨ x a
блізка	b lʲ i s k a
блізкі	b lʲ i s kʲ i
блізнюк	b lʲ i zʲ nʲ u k
бог	b o x
божа	b o ʐ a
бок	b o k
боль	b o lʲ
больш	b o lʲ ʂ
большасць	b o lʲ ʂ a sʲ t͡sʲ
бомба	b o m b a
борзды	b o r z d ɨ
боснія	b o sʲ nʲ i j a
бразільскі	b r a zʲ i lʲ s kʲ i
бразілія	b r a zʲ i lʲ i j a
брак	b r a k
брама	b r a m a
браніслава	b r a nʲ i s ɫ a v a
браніслаў	b r a nʲ i s ɫ a u̯
брат	b r a t
брахня	b r a x nʲ a
брацтва	b r a t͡s t v a
браць	b r a t͡sʲ
браціслава	b r a t͡sʲ i s ɫ a v a
брод	b r o t
брудны	b r u d n ɨ
бруха	b r u x a
брыво	b r ɨ v o
брыдкі	b r ɨ t kʲ i
брытва	b r ɨ t v a
брэст	b r e s t
брэтонскі	b r e t o n s kʲ i
будаванне	b u d a v a nʲː e
будаваць	b u d a v a t͡sʲ
будзе	b u d͡zʲ e
будзем	b u d͡zʲ e m
будзеце	b u d͡zʲ e t͡sʲ e
будзеш	b u d͡zʲ e ʂ
буду	b u d u
будуць	b u d u t͡sʲ
будучы	b u d u t͡ʂ ɨ
будучыня	b u d u t͡ʂ ɨ nʲ a
будынак	b u d ɨ n a k
буйны	b u j n ɨ
буква	b u k v a
букініст	b u kʲ i nʲ i s t
булава	b u ɫ a v a
бульба	b u lʲ b a
бура	b u r a
бурак	b u r a k
бусел	b u sʲ e ɫ
бутан	b u t a n
бутэлька	b u t e lʲ k a
бык	b ɨ k
быкаў	b ɨ k a u̯
быстры	b ɨ s t r ɨ
быстрыня	b ɨ s t r ɨ nʲ a
быць	b ɨ t͡sʲ
бюро	bʲ u r o
бяда	bʲ a d a
бядро	bʲ a d r o
бязглузды	bʲ a z ɡ ɫ u z d ɨ
бялград	bʲ a ɫ ɣ r a t
бяроза	bʲ a r o z a
бярэмя	bʲ a r e mʲ a
бяспечны	bʲ a sʲ pʲ e t͡ʂ n ɨ
бібліятэка	bʲ i b lʲ i j a t e k a
бібліятэкар	bʲ i b lʲ i j a t e k a r
бібліятэкарка	bʲ i b lʲ i j a t e k a r k a
бізнес	bʲ i zʲ nʲ e s
бізнэс	bʲ i z n e s
бінокль	bʲ i n o k lʲ
бірманскі	bʲ i r m a n s kʲ i
бірузовы	bʲ i r u z o v ɨ
бітва	bʲ i t v a
біць	bʲ i t͡sʲ
бішкек	bʲ i ʂ kʲ e k
біялогія	bʲ i j a ɫ o ɣʲ i j a
в'етнам	v j e t n a m
в'етнамскі	v j e t n a m s kʲ i
вавёрка	v a vʲ o r k a
вага	v a ɣ a
вагі	v a ɣʲ i
вада	v a d a
вадарод	v a d a r o t
вадаспад	v a d a s p a t
вадзім	v a d͡zʲ i m
вадзіць	v a d͡zʲ i t͡sʲ
вадкі	v a t kʲ i
важкі	v a ʂ kʲ i
важны	v a ʐ n ɨ
вазіць	v a zʲ i t͡sʲ
вайна	v a j n a
валакно	v a ɫ a k n o
валам	v a ɫ a m
валамі	v a ɫ a mʲ i
валах	v a ɫ a x
валачы	v a ɫ a t͡ʂ ɨ
валерый	v a lʲ e r ɨ j
валоў	v a ɫ o u̯
валы	v a ɫ ɨ
валянцін	v a lʲ a nʲ t͡sʲ i n
валіза	v a lʲ i z a
валійскі	v a lʲ i j s kʲ i
ванда	v a n d a
вандроўны	v a n d r o u̯ n ɨ
ванна	v a nː a
ванная	v a nː a j a
вантроба	v a n t r o b a
ванітаваць	v a nʲ i t a v a t͡sʲ
вараны	v a r a n ɨ
варатар	v a r a t a r
варвара	v a r v a r a
варожы	v a r o ʐ ɨ
варона	v a r o n a
варочаць	v a r o t͡ʂ a t͡sʲ
варшава	v a r ʂ a v a
васьмёра	v a sʲ mʲ o r a
васямнаццаты	v a sʲ a m n a t͡sː a t ɨ
васямнаццаць	v a sʲ a m n a t͡sː a t͡sʲ
васіль	v a sʲ i lʲ
ваш	v a ʂ
ваша	v a ʂ a
ваўкалак	v a u̯ k a ɫ a k
ведаць	vʲ e d a t͡sʲ
вежа	vʲ e ʐ a
везці	vʲ e sʲ t͡sʲ i
вейка	vʲ e j k a
век	vʲ e k
вельмі	vʲ e lʲ mʲ i
велікамучанік	vʲ e lʲ i k a m u t͡ʂ a nʲ i k
велікамучаніца	vʲ e lʲ i k a m u t͡ʂ a nʲ i t͡s a
велічыня	vʲ e lʲ i t͡ʂ ɨ nʲ a
венгерка	vʲ e n ɣʲ e r k a
венгерскі	vʲ e n ɣʲ e r s kʲ i
венгр	vʲ e n ɣ r
венгрыя	vʲ e n ɣ r ɨ j a
вера	vʲ e r a
верабей	vʲ e r a bʲ e j
верагодны	vʲ e r a ɣ o d n ɨ
верад	vʲ e r a t
верасень	vʲ e r a sʲ e nʲ
верасеньскі	vʲ e r a sʲ e nʲ s kʲ i
верацяно	vʲ e r a t͡sʲ a n o
верны	vʲ e r n ɨ
верталёт	vʲ e r t a lʲ o t
верхнелужыцкі	vʲ e r x nʲ e ɫ u ʐ ɨ t͡s kʲ i
верш	vʲ e r ʂ
верыць	vʲ e r ɨ t͡sʲ
весці	vʲ e sʲ t͡sʲ i
ветка	vʲ e t k a
ветлівы	vʲ e t lʲ i v ɨ
ветраны	vʲ e t r a n ɨ
вецер	vʲ e t͡sʲ e r
вечар	vʲ e t͡ʂ a r
вечны	vʲ e t͡ʂ n ɨ
вешаць	vʲ e ʂ a t͡sʲ
воблака	v o b ɫ a k a
вобласць	v o b ɫ a sʲ t͡sʲ
вобраз	v o b r a s
водарасць	v o d a r a sʲ t͡sʲ
водка	v o t k a
водца	v o t ː͡s a
вожык	v o ʐ ɨ k
возера	v o zʲ e r a
войска	v o j s k a
вока	v o k a
вол	v o ɫ
волава	v o ɫ a v a
волас	v o ɫ a s
волат	v o ɫ a t
вольга	v o lʲ ɣ a
вораг	v o r a x
воран	v o r a n
восем	v o sʲ e m
восемдзесят	v o sʲ e m d͡zʲ e sʲ a t
восемсот	v o sʲ e m s o t
восень	v o sʲ e nʲ
воск	v o s k
востраў	v o s t r a u̯
востры	v o s t r ɨ
вось	v o sʲ
восьмы	v o sʲ m ɨ
воцат	v o t͡s a t
вош	v o ʂ
воўк	v o u̯ k
воўна	v o u̯ n a
вроцлаў	v r o t͡s ɫ a u̯
вугал	v u ɣ a ɫ
вугаль	v u ɣ a lʲ
вуглярод	v u ɣ lʲ a r o t
вугольчык	v u ɣ o lʲ t͡ʂ ɨ k
вугор	v u ɣ o r
вугоршчына	v u ɣ o r ʂ t͡ʂ ɨ n a
вуда	v u d a
вуж	v u ʂ
вуздэчка	v u z d e t͡ʂ k a
вузел	v u zʲ e ɫ
вузкі	v u s kʲ i
вулей	v u lʲ e j
вулкан	v u ɫ k a n
вуліца	v u lʲ i t͡s a
вус	v u s
вусень	v u sʲ e nʲ
вусны	v u s n ɨ
вустрыца	v u s t r ɨ t͡s a
вусік	v u sʲ i k
вуха	v u x a
вучыцца	v u t͡ʂ ɨ t͡sː a
вучыць	v u t͡ʂ ɨ t͡sʲ
вушны	v u ʂ n ɨ
вы	v ɨ
выбар	v ɨ b a r
выбары	v ɨ b a r ɨ
выбачайце	v ɨ b a t͡ʂ a j t͡sʲ e
выбачыць	v ɨ b a t͡ʂ ɨ t͡sʲ
выдаваць	v ɨ d a v a t͡sʲ
выдатны	v ɨ d a t n ɨ
выдаць	v ɨ d a t͡sʲ
выдра	v ɨ d r a
выебаць	v ɨ j e b a t͡sʲ
выйсці	v ɨ j sʲ t͡sʲ i
выкапаць	v ɨ k a p a t͡sʲ
выкапень	v ɨ k a pʲ e nʲ
выкарыстаць	v ɨ k a r ɨ s t a t͡sʲ
выкарыстоўваць	v ɨ k a r ɨ s t o u̯ v a t͡sʲ
выключаць	v ɨ k lʲ u t͡ʂ a t͡sʲ
выклічнік	v ɨ k lʲ i t͡ʂ nʲ i k
вымавіць	v ɨ m a vʲ i t͡sʲ
вымова	v ɨ m o v a
вымя	v ɨ mʲ a
вынаходства	v ɨ n a x o t s t v a
вынятак	v ɨ nʲ a t a k
вынятковы	v ɨ nʲ a t k o v ɨ
вынік	v ɨ nʲ i k
выпадак	v ɨ p a d a k
выпрабаванне	v ɨ p r a b a v a nʲː e
выпіць	v ɨ pʲ i t͡sʲ
выраз	v ɨ r a s
выразны	v ɨ r a z n ɨ
выслаць	v ɨ s ɫ a t͡sʲ
высокі	v ɨ s o kʲ i
выспа	v ɨ s p a
высылаць	v ɨ s ɨ ɫ a t͡sʲ
вытворчасць	v ɨ t v o r t͡ʂ a sʲ t͡sʲ
выхавальнік	v ɨ x a v a lʲ nʲ i k
выхавальніца	v ɨ x a v a lʲ nʲ i t͡s a
выходзіць	v ɨ x o d͡zʲ i t͡sʲ
вышыванка	v ɨ ʂ ɨ v a n k a
вядома	vʲ a d o m a
вядомы	vʲ a d o m ɨ
вядро	vʲ a d r o
вяз	vʲ a s
вязаць	vʲ a z a t͡sʲ
вязень	vʲ a zʲ e nʲ
вялізны	vʲ a lʲ i z n ɨ
вялікабрытанія	vʲ a lʲ i k a b r ɨ t a nʲ i j a
вялікдзень	vʲ a lʲ i ɡ d͡zʲ e nʲ
вялікі	vʲ a lʲ i kʲ i
вяпрук	vʲ a p r u k
вярба	vʲ a r b a
вярблюд	vʲ a r b lʲ u t
вяроўка	vʲ a r o u̯ k a
вяселле	vʲ a sʲ e lʲː e
вясло	vʲ a s ɫ o
вясна	vʲ a s n a
вясёлка	vʲ a sʲ o ɫ k a
вясёлы	vʲ a sʲ o ɫ ɨ
вятрак	vʲ a t r a k
вяхір	vʲ a xʲ i r
вячаслаў	vʲ a t͡ʂ a s ɫ a u̯
вячорка	vʲ a t͡ʂ o r k a
вячэраць	vʲ a t͡ʂ e r a t͡sʲ
вёска	vʲ o s k a
відавочны	vʲ i d a v o t͡ʂ n ɨ
відовішча	vʲ i d o vʲ i ʂ t͡ʂ a
відэа	vʲ i d e a
відэлец	vʲ i d e lʲ e t͡s
віза	vʲ i z a
вікенцій	vʲ i kʲ e nʲ t͡sʲ i j
віктар	vʲ i k t a r
вікторыя	vʲ i k t o r ɨ j a
вікіпэдыя	vʲ i kʲ i p e d ɨ j a
вільготны	vʲ i lʲ ɣ o t n ɨ
вільнюс	vʲ i lʲ nʲ u s
вінавальны	vʲ i n a v a lʲ n ɨ
вінаваты	vʲ i n a v a t ɨ
вінаграднік	vʲ i n a ɣ r a d nʲ i k
віно	vʲ i n o
віншаваць	vʲ i n ʂ a v a t͡sʲ
віншую	vʲ i n ʂ u j u
вірус	vʲ i r u s
вісець	vʲ i sʲ e t͡sʲ
віскі	vʲ i s kʲ i
вісла	vʲ i s ɫ a
віталій	vʲ i t a lʲ i j
вітаць	vʲ i t a t͡sʲ
вітаўт	vʲ i t a u̯ t
віхура	vʲ i x u r a
віцебск	vʲ i t͡sʲ e p s k
віялета	vʲ i j a lʲ e t a
габрэй	ɣ a b r e j
гаваркі	ɣ a v a r kʲ i
гаварлівы	ɣ a v a r lʲ i v ɨ
гаварыць	ɣ a v a r ɨ t͡sʲ
гадзіна	ɣ a d͡zʲ i n a
гадзіннік	ɣ a d͡zʲ i nʲː i k
газ	ɡ a s
газ	ɣ a s
газета	ɣ a zʲ e t a
газэта	ɡ a z e t a
газэта	ɣ a z e t a
гай	ɣ a j
гайка	ɣ a j k a
галава	ɣ a ɫ a v a
галандскі	ɣ a ɫ a n t s kʲ i
галодны	ɣ a ɫ o d n ɨ
галоўка	ɣ a ɫ o u̯ k a
галоўны	ɣ a ɫ o u̯ n ɨ
галстук	ɣ a ɫ s t u k
гальмо	ɣ a lʲ m o
гальштук	ɣ a lʲ ʂ t u k
галёнка	ɣ a lʲ o n k a
галіна	ɣ a lʲ i n a
ганак	ɡ a n a k
ганак	ɣ a n a k
ганарлівы	ɣ a n a r lʲ i v ɨ
гандаль	ɣ a n d a lʲ
гандляр	ɣ a n d lʲ a r
ганконг	ɣ a n k o n x
ганна	ɣ a nː a
ганчар	ɣ a n t͡ʂ a r
ганьба	ɣ a nʲ b a
ганяць	ɣ a nʲ a t͡sʲ
гара	ɣ a r a
гарачы	ɣ a r a t͡ʂ ɨ
гарбата	ɣ a r b a t a
гарбуз	ɣ a r b u s
гардзей	ɣ a r d͡zʲ e j
гармата	ɣ a r m a t a
гарнастай	ɣ a r n a s t a j
гародня	ɣ a r o d nʲ a
гародніна	ɣ a r o d nʲ i n a
гарох	ɣ a r o x
гарэлка	ɣ a r e ɫ k a
гарэць	ɣ a r e t͡sʲ
гаспадарка	ɣ a s p a d a r k a
гасцініца	ɣ a sʲ t͡sʲ i nʲ i t͡s a
гатовы	ɣ a t o v ɨ
гатунак	ɣ a t u n a k
гатэль	ɣ a t e lʲ
гаўно	ɣ a u̯ n o
гаўрыла	ɣ a u̯ r ɨ ɫ a
гвалт	ɡ v a ɫ t
гвалт	ɣ v a ɫ t
гвалтаваць	ɡ v a ɫ t a v a t͡sʲ
гвалтаваць	ɣ v a ɫ t a v a t͡sʲ
гвозд	ɣ v o s t
гданьск	ɣ d a nʲ s k
геаграфічны	ɣʲ e a ɣ r a fʲ i t͡ʂ n ɨ
геаграфія	ɣʲ e a ɣ r a fʲ i j a
гелій	ɣʲ e lʲ i j
генадзь	ɣʲ e n a t͡sʲ
генадзій	ɣʲ e n a d͡zʲ i j
георгій	ɣʲ e o r ɣʲ i j
герасім	ɣʲ e r a sʲ i m
германскі	ɣʲ e r m a n s kʲ i
германія	ɣʲ e r m a nʲ i j a
глаголіца	ɣ ɫ a ɣ o lʲ i t͡s a
гладкі	ɣ ɫ a t kʲ i
глеб	ɣ lʲ e p
глод	ɣ ɫ o t
глупства	ɣ ɫ u p s t v a
глухі	ɣ ɫ u xʲ i
глыбокі	ɣ ɫ ɨ b o kʲ i
глядзець	ɣ lʲ a d͡zʲ e t͡sʲ
гліна	ɣ lʲ i n a
гнаць	ɣ n a t͡sʲ
гной	ɣ n o j
гнуць	ɣ n u t͡sʲ
гняздо	ɣ nʲ a z d o
гнілы	ɣ nʲ i ɫ ɨ
год	ɣ o t
годнасць	ɣ o d n a sʲ t͡sʲ
годны	ɣ o d n ɨ
гожы	ɣ o ʐ ɨ
голад	ɣ o ɫ a t
голас	ɣ o ɫ a s
голасны	ɣ o ɫ a s n ɨ
голуб	ɣ o ɫ u p
голы	ɣ o ɫ ɨ
гольф	ɣ o lʲ f
гомасексуалізм	ɣ o m a sʲ e k s u a lʲ i z m
гомель	ɣ o mʲ e lʲ
гонар	ɣ o n a r
гора	ɣ o r a
горад	ɣ o r a t
горадня	ɣ o r a d nʲ a
горб	ɣ o r p
горды	ɣ o r d ɨ
горкі	ɣ o r kʲ i
горла	ɣ o r ɫ a
горшы	ɣ o r ʂ ɨ
госць	ɣ o sʲ t͡sʲ
граб	ɣ r a p
град	ɣ r a t
грамадзянства	ɣ r a m a d͡zʲ a n s t v a
грамадзянін	ɣ r a m a d͡zʲ a nʲ i n
грамадства	ɣ r a m a t s t v a
граната	ɣ r a n a t a
граніца	ɣ r a nʲ i t͡s a
гранічны	ɣ r a nʲ i t͡ʂ n ɨ
граць	ɣ r a t͡sʲ
грачанка	ɣ r a t͡ʂ a n k a
гродна	ɣ r o d n a
грошы	ɣ r o ʂ ɨ
грубы	ɣ r u b ɨ
грудзі	ɣ r u d͡zʲ i
грузін	ɣ r u zʲ i n
грузінка	ɣ r u zʲ i n k a
грузінскі	ɣ r u zʲ i n s kʲ i
грузія	ɣ r u zʲ i j a
група	ɣ r u p a
груша	ɣ r u ʂ a
грыб	ɣ r ɨ p
грыва	ɣ r ɨ v a
грызці	ɣ r ɨ sʲ t͡sʲ i
грэбці	ɣ r e p t͡sʲ i
грэк	ɣ r e k
грэх	ɣ r e x
грэцкі	ɣ r e t͡s kʲ i
грэцыя	ɣ r e t͡s ɨ j a
губа	ɣ u b a
губіць	ɣ u bʲ i t͡sʲ
гузік	ɡ u zʲ i k
гузік	ɣ u zʲ i k
гук	ɣ u k
гулец	ɣ u lʲ e t͡s
гуляць	ɣ u lʲ a t͡sʲ
гумарыст	ɣ u m a r ɨ s t
гусак	ɣ u s a k
густы	ɣ u s t ɨ
гусь	ɣ u sʲ
гусіт	ɣ u sʲ i t
гучны	ɣ u t͡ʂ n ɨ
гэта	ɣ e t a
гэтае	ɣ e t a j e
гэтая	ɣ e t a j a
гэты	ɣ e t ɨ
гэтыя	ɣ e t ɨ j a
гідкі	ɣʲ i t kʲ i
гіль	ɣʲ i lʲ
гісторык	ɣʲ i s t o r ɨ k
гісторыя	ɣʲ i s t o r ɨ j a
гітара	ɣʲ i t a r a
давай	d a v a j
давальны	d a v a lʲ n ɨ
даваць	d a v a t͡sʲ
даведнік	d a vʲ e d nʲ i k
давід	d a vʲ i t
дадаваць	d a d a v a t͡sʲ
дадатковы	d a d a t k o v ɨ
дадаць	d a d a t͡sʲ
дадому	d a d o m u
даехаць	d a j e x a t͡sʲ
дазваляць	d a z v a lʲ a t͡sʲ
дазволіць	d a z v o lʲ i t͡sʲ
дайсці	d a j sʲ t͡sʲ i
дакладны	d a k ɫ a d n ɨ
далонь	d a ɫ o nʲ
далоў	d a ɫ o u̯
далятаць	d a lʲ a t a t͡sʲ
даляцець	d a lʲ a t͡sʲ e t͡sʲ
далёкі	d a lʲ o kʲ i
даліна	d a lʲ i n a
дамінік	d a mʲ i nʲ i k
дамініка	d a mʲ i nʲ i k a
данелаг	d a nʲ e ɫ a x
даныя	d a n ɨ j a
данія	d a nʲ i j a
дапамагаць	d a p a m a ɣ a t͡sʲ
дапамагчы	d a p a m a x t͡ʂ ɨ
дапамога	d a p a m o ɣ a
дапытлівы	d a p ɨ t lʲ i v ɨ
дар'я	d a r j a
дарагі	d a r a ɣʲ i
дарадца	d a r a t ː͡s a
дарога	d a r o ɣ a
дарослы	d a r o s ɫ ɨ
дарыць	d a r ɨ t͡sʲ
дарэчы	d a r e t͡ʂ ɨ
даставаць	d a s t a v a t͡sʲ
дастаткова	d a s t a t k o v a
дастатковы	d a s t a t k o v ɨ
дастаць	d a s t a t͡sʲ
даступны	d a s t u p n ɨ
дасягаць	d a sʲ a ɣ a t͡sʲ
дасягнуць	d a sʲ a ɣ n u t͡sʲ
датчанка	d a t ː͡ʂ a n k a
датчанін	d a t ː͡ʂ a nʲ i n
дах	d a x
даходзіць	d a x o d͡zʲ i t͡sʲ
дацкі	d a t͡s kʲ i
даць	d a t͡sʲ
дачка	d a t͡ʂ k a
даязджаць	d a j a ʐ d͡ʐ a t͡sʲ
даіць	d a j i t͡sʲ
даўгата	d a u̯ ɣ a t a
даўні	d a u̯ nʲ i
даўніна	d a u̯ nʲ i n a
два	d v a
дванаццаты	d v a n a t͡sː a t ɨ
дванаццаць	d v a n a t͡sː a t͡sʲ
дваранства	d v a r a n s t v a
дваццаты	d v a t͡sː a t ɨ
дваццаць	d v a t͡sː a t͡sʲ
двое	d v o j e
двор	d v o r
джгаць	d͡ʐ ɡ a t͡sʲ
джыхад	d͡ʐ ɨ x a t
дзве	d͡zʲ vʲ e
дзверы	d͡zʲ vʲ e r ɨ
дзвесце	d͡zʲ vʲ e sʲ t͡sʲ e
дзе	d͡zʲ e
дзевер	d͡zʲ e vʲ e r
дзевяноста	d͡zʲ e vʲ a n o s t a
дзевятнаццаты	d͡zʲ e vʲ a t n a t͡sː a t ɨ
дзевятнаццаць	d͡zʲ e vʲ a t n a t͡sː a t͡sʲ
дзевяць	d͡zʲ e vʲ a t͡sʲ
дзевяцьсот	d͡zʲ e vʲ a t͡sʲ s o t
дзед	d͡zʲ e t
дзеепрыметнік	d͡zʲ e j e p r ɨ mʲ e t nʲ i k
дзеепрыслоўе	d͡zʲ e j e p r ɨ s ɫ o u̯ j e
дзейнік	d͡zʲ e j nʲ i k
дзейнічаць	d͡zʲ e j nʲ i t͡ʂ a t͡sʲ
дзень	d͡zʲ e nʲ
дзесьці	d͡zʲ e sʲ t͡sʲ i
дзесяць	d͡zʲ e sʲ a t͡sʲ
дзесяцігоддзе	d͡zʲ e sʲ a t͡sʲ i ɣ o d͡zʲː e
дзець	d͡zʲ e t͡sʲ
дзеці	d͡zʲ e t͡sʲ i
дзеяслоў	d͡zʲ e j a s ɫ o u̯
дзеяць	d͡zʲ e j a t͡sʲ
дзмітрый	d͡zʲ mʲ i t r ɨ j
дзьмуць	d͡zʲ m u t͡sʲ
дзюба	d͡zʲ u b a
дзявяты	d͡zʲ a vʲ a t ɨ
дзявяцера	d͡zʲ a vʲ a t͡sʲ e r a
дзядзька	d͡zʲ a t͡sʲ k a
дзякаваць	d͡zʲ a k a v a t͡sʲ
дзякуй	d͡zʲ a k u j
дзяніс	d͡zʲ a nʲ i s
дзяржава	d͡zʲ a r ʐ a v a
дзясяты	d͡zʲ a sʲ a t ɨ
дзясяцера	d͡zʲ a sʲ a t͡sʲ e r a
дзяцел	d͡zʲ a t͡sʲ e ɫ
дзяцінства	d͡zʲ a t͡sʲ i n s t v a
дзяўчына	d͡zʲ a u̯ t͡ʂ ɨ n a
дзёгаць	d͡zʲ o ɣ a t͡sʲ
дзён	d͡zʲ o n
дзіва	d͡zʲ i v a
дзікабраз	d͡zʲ i k a b r a s
дзікі	d͡zʲ i kʲ i
дзіця	d͡zʲ i t͡sʲ a
дзіўны	d͡zʲ i u̯ n ɨ
дно	d n o
дняпро	d nʲ a p r o
днях	d nʲ a x
дні	d nʲ i
добры	d o b r ɨ
дождж	d o ʂ t͡ʂ
доказ	d o k a s
долата	d o ɫ a t a
дом	d o m
дома	d o m a
дошка	d o ʂ k a
доўг	d o u̯ x
доўгі	d o u̯ ɣʲ i
драбіны	d r a bʲ i n ɨ
дракон	d r a k o n
драпаць	d r a p a t͡sʲ
дробны	d r o b n ɨ
дровы	d r o v ɨ
дрожджы	d r o ʐ d͡ʐ ɨ
дрот	d r o t
друг	d r u x
другі	d r u ɣʲ i
друкаваць	d r u k a v a t͡sʲ
дрэва	d r e v a
дрэнны	d r e nː ɨ
дуб	d u p
думаць	d u m a t͡sʲ
дупа	d u p a
дурны	d u r n ɨ
дух	d u x
душ	d u ʂ
душа	d u ʂ a
душны	d u ʂ n ɨ
ды	d ɨ
дыван	d ɨ v a n
дыктатар	d ɨ k t a t a r
дыктатура	d ɨ k t a t u r a
дым	d ɨ m
дыня	d ɨ nʲ a
дыхаць	d ɨ x a t͡sʲ
дэмакрат	d e m a k r a t
дэмакратка	d e m a k r a t k a
дэмакратыя	d e m a k r a t ɨ j a
дэндрахраналогія	d e n d r a x r a n a ɫ o ɣʲ i j a
ева	j e v a
егіпцянка	j e ɣʲ i p t͡sʲ a n k a
егіпцянін	j e ɣʲ i p t͡sʲ a nʲ i n
ездзіць	j e z d͡zʲ i t͡sʲ
ейны	j e j n ɨ
елізавета	j e lʲ i z a vʲ e t a
епіскап	j e pʲ i s k a p
ерэван	j e r e v a n
есці	j e sʲ t͡sʲ i
есьці	j e sʲ t͡sʲ i
ехаць	j e x a t͡sʲ
еўдакім	j e u̯ d a kʲ i m
еўдакія	j e u̯ d a kʲ i j a
еўрапеец	j e u̯ r a pʲ e j e t͡s
еўрапейка	j e u̯ r a pʲ e j k a
еўрапейскі	j e u̯ r a pʲ e j s kʲ i
еўропа	j e u̯ r o p a
жаба	ʐ a b a
жабрак	ʐ a b r a k
жабрачка	ʐ a b r a t͡ʂ k a
жаваранак	ʐ a v a r a n a k
жадаць	ʐ a d a t͡sʲ
жаласны	ʐ a ɫ a s n ɨ
жалеза	ʐ a lʲ e z a
жалоба	ʐ a ɫ o b a
жана	ʐ a n a
жанета	ʐ a nʲ e t a
жаноцкі	ʐ a n o t͡s kʲ i
жаночы	ʐ a n o t͡ʂ ɨ
жанчына	ʐ a n t͡ʂ ɨ n a
жанчыны	ʐ a n t͡ʂ ɨ n ɨ
жаніх	ʐ a nʲ i x
жарабец	ʐ a r a bʲ e t͡s
жарабя	ʐ a r a bʲ a
жарало	ʐ a r a ɫ o
жарсць	ʐ a r sʲ t͡sʲ
жарт	ʐ a r t
жах	ʐ a x
жахлівы	ʐ a x lʲ i v ɨ
жаўна	ʐ a u̯ n a
жнівень	ʐ nʲ i vʲ e nʲ
жнівеньскі	ʐ nʲ i vʲ e nʲ s kʲ i
жніво	ʐ nʲ i v o
жолаб	ʐ o ɫ a p
жолуд	ʐ o ɫ u t
жонка	ʐ o n k a
жопа	ʐ o p a
жорсткі	ʐ o r s t kʲ i
жоўты	ʐ o u̯ t ɨ
жоўць	ʐ o u̯ t͡sʲ
жук	ʐ u k
журнал	ʐ u r n a ɫ
журналіст	ʐ u r n a lʲ i s t
журналістка	ʐ u r n a lʲ i s t k a
жывот	ʐ ɨ v o t
жывы	ʐ ɨ v ɨ
жывёла	ʐ ɨ vʲ o ɫ a
жыд	ʐ ɨ t
жыла	ʐ ɨ ɫ a
жыта	ʐ ɨ t a
жыхар	ʐ ɨ x a r
жыццё	ʐ ɨ t͡sʲː o
жыць	ʐ ɨ t͡sʲ
жэрабя	ʐ e r a bʲ a
з'есці	zʲ j e sʲ t͡sʲ i
з'явіцца	zʲ j a vʲ i t͡sː a
з'яўляцца	zʲ j a u̯ lʲ a t͡sː a
заахвоціць	z a a x v o t͡sʲ i t͡sʲ
забабоны	z a b a b o n ɨ
забараняць	z a b a r a nʲ a t͡sʲ
забараніць	z a b a r a nʲ i t͡sʲ
забарона	z a b a r o n a
забастоўка	z a b a s t o u̯ k a
забеспячэнне	z a bʲ e sʲ pʲ a t͡ʂ e nʲː e
забойства	z a b o j s t v a
забойца	z a b o j t͡s a
забываць	z a b ɨ v a t͡sʲ
забыць	z a b ɨ t͡sʲ
забіваць	z a bʲ i v a t͡sʲ
забіць	z a bʲ i t͡sʲ
загадка	z a ɣ a t k a
загрэб	z a ɣ r e p
зайздрасць	z a j z d r a sʲ t͡sʲ
зайздросны	z a j z d r o s n ɨ
займеннік	z a j mʲ e nʲː i k
заканадаўства	z a k a n a d a u̯ s t v a
закон	z a k o n
закінуты	z a kʲ i n u t ɨ
залаты	z a ɫ a t ɨ
залежны	z a lʲ e ʐ n ɨ
заложны	z a ɫ o ʐ n ɨ
заложнік	z a ɫ o ʐ nʲ i k
залоза	z a ɫ o z a
залупа	z a ɫ u p a
замак	z a m a k
замежны	z a mʲ e ʐ n ɨ
замест	z a mʲ e s t
запавет	z a p a vʲ e t
запалка	z a p a ɫ k a
запальнічка	z a p a lʲ nʲ i t͡ʂ k a
заплаціць	z a p ɫ a t͡sʲ i t͡sʲ
запытаць	z a p ɨ t a t͡sʲ
запэўніваць	z a p e u̯ nʲ i v a t͡sʲ
запэўніць	z a p e u̯ nʲ i t͡sʲ
запякаць	z a pʲ a k a t͡sʲ
запясце	z a pʲ a sʲ t͡sʲ e
запячы	z a pʲ a t͡ʂ ɨ
зараплавец	z a r a p ɫ a vʲ e t͡s
засада	z a s a d a
заставацца	z a s t a v a t͡sː a
застацца	z a s t a t͡sː a
затым	z a t ɨ m
захад	z a x a t
захацець	z a x a t͡sʲ e t͡sʲ
заходні	z a x o d nʲ i
зачараваць	z a t͡ʂ a r a v a t͡sʲ
зачароўваць	z a t͡ʂ a r o u̯ v a t͡sʲ
зачыняць	z a t͡ʂ ɨ nʲ a t͡sʲ
зачыніць	z a t͡ʂ ɨ nʲ i t͡sʲ
заяц	z a j a t͡s
заўжды	z a u̯ ʐ d ɨ
заўзяты	z a u̯ zʲ a t ɨ
заўсёды	z a u̯ sʲ o d ɨ
заўтра	z a u̯ t r a
збежнасць	zʲ bʲ e ʐ n a sʲ t͡sʲ
зберагчы	zʲ bʲ e r a x t͡ʂ ɨ
збожжа	z b o ʐː a
зброя	z b r o j a
збіраць	zʲ bʲ i r a t͡sʲ
званіць	z v a nʲ i t͡sʲ
зваць	z v a t͡sʲ
звер	zʲ vʲ e r
звон	z v o n
звычай	z v ɨ t͡ʂ a j
звычайны	z v ɨ t͡ʂ a j n ɨ
звязда	zʲ vʲ a z d a
згаджацца	z ɡ a d͡ʐ a t͡sː a
згадзіцца	z ɡ a d͡zʲ i t͡sː a
згарэць	z ɡ a r e t͡sʲ
згвалтаваць	z ɡ v a ɫ t a v a t͡sʲ
згінуць	z ɡʲ i n u t͡sʲ
здань	z d a nʲ
здаровы	z d a r o v ɨ
здароўе	z d a r o u̯ j e
здольнасць	z d o lʲ n a sʲ t͡sʲ
здольны	z d o lʲ n ɨ
здрада	z d r a d a
здраднік	z d r a d nʲ i k
земфіра	zʲ e m fʲ i r a
зерне	zʲ e r nʲ e
зламацца	z ɫ a m a t͡sː a
зламаць	z ɫ a m a t͡sʲ
злачынства	z ɫ a t͡ʂ ɨ n s t v a
злодзей	z ɫ o d͡zʲ e j
злучнік	z ɫ u t͡ʂ nʲ i k
злы	z ɫ ɨ
змагчы	z m a x t͡ʂ ɨ
змораны	z m o r a n ɨ
змрок	z m r o k
змрочны	z m r o t͡ʂ n ɨ
змяняцца	zʲ mʲ a nʲ a t͡sː a
змяняць	zʲ mʲ a nʲ a t͡sʲ
змяніцца	zʲ mʲ a nʲ i t͡sː a
змяніць	zʲ mʲ a nʲ i t͡sʲ
змяя	zʲ mʲ a j a
знадворны	z n a d v o r n ɨ
знак	z n a k
знаходзіць	z n a x o d͡zʲ i t͡sʲ
знаць	z n a t͡sʲ
значыць	z n a t͡ʂ ɨ t͡sʲ
значэнне	z n a t͡ʂ e nʲː e
знаёміць	z n a j o mʲ i t͡sʲ
зноў	z n o u̯
знікаць	zʲ nʲ i k a t͡sʲ
знікнуць	zʲ nʲ i k n u t͡sʲ
знічка	zʲ nʲ i t͡ʂ k a
золата	z o ɫ a t a
зорачка	z o r a t͡ʂ k a
зорка	z o r k a
зося	z o sʲ a
зрабіць	z r a bʲ i t͡sʲ
зразумець	z r a z u mʲ e t͡sʲ
зрок	z r o k
зуб	z u p
зуба	z u b a
зша	ʂː a
зычны	z ɨ t͡ʂ n ɨ
зялёны	zʲ a lʲ o n ɨ
зямля	zʲ a m lʲ a
зяць	zʲ a t͡sʲ
зіма	zʲ i m a
каб	k a p
кабета	k a bʲ e t a
кабура	k a b u r a
кабыла	k a b ɨ ɫ a
кава	k a v a
кавадла	k a v a d ɫ a
кавун	k a v u n
кавярня	k a vʲ a r nʲ a
кажух	k a ʐ u x
каза	k a z a
казак	k a z a k
казахскі	k a z a x s kʲ i
казахстан	k a z a x s t a n
казаць	k a z a t͡sʲ
казка	k a s k a
казёл	k a zʲ o ɫ
казімір	k a zʲ i mʲ i r
калаўрот	k a ɫ a u̯ r o t
калена	k a lʲ e n a
калодзеж	k a ɫ o d͡zʲ e ʂ
калоць	k a ɫ o t͡sʲ
калчан	k a ɫ t͡ʂ a n
калыска	k a ɫ ɨ s k a
каляды	k a lʲ a d ɨ
каляндар	k a lʲ a n d a r
калёсы	k a lʲ o s ɨ
калі	k a lʲ i
калій	k a lʲ i j
камар	k a m a r
камбоджа	k a m b o d͡ʐ a
камень	k a mʲ e nʲ
камета	k a mʲ e t a
камп'ютар	k a m p j u t a r
камп'ютэр	k a m p j u t e r
канада	k a n a d a
канадскі	k a n a t s kʲ i
канверт	k a n vʲ e r t
кандрат	k a n d r a t
канец	k a nʲ e t͡s
каноплі	k a n o p lʲ i
канстанцін	k a n s t a nʲ t͡sʲ i n
канстытуцыя	k a n s t ɨ t u t͡s ɨ j a
кантынент	k a n t ɨ nʲ e n t
кантычка	k a n t ɨ t͡ʂ k a
капаць	k a p a t͡sʲ
капейка	k a pʲ e j k a
капуста	k a p u s t a
капыт	k a p ɨ t
капялюш	k a pʲ a lʲ u ʂ
кара	k a r a
карабель	k a r a bʲ e lʲ
карабельня	k a r a bʲ e lʲ nʲ a
каралева	k a r a lʲ e v a
каралевіч	k a r a lʲ e vʲ i t͡ʂ
каралеўна	k a r a lʲ e u̯ n a
каралеўскі	k a r a lʲ e u̯ s kʲ i
каралеўства	k a r a lʲ e u̯ s t v a
караліна	k a r a lʲ i n a
каранавірус	k a r a n a vʲ i r u s
карандаш	k a r a n d a ʂ
карл	k a r ɫ
карлік	k a r lʲ i k
каробка	k a r o p k a
карова	k a r o v a
кароль	k a r o lʲ
карона	k a r o n a
кароста	k a r o s t a
кароткі	k a r o t kʲ i
карта	k a r t a
карчма	k a r t͡ʂ m a
карыснасць	k a r ɨ s n a sʲ t͡sʲ
карысны	k a r ɨ s n ɨ
карыта	k a r ɨ t a
карыца	k a r ɨ t͡s a
карычневы	k a r ɨ t͡ʂ nʲ e v ɨ
карэйскі	k a r e j s kʲ i
карэя	k a r e j a
каса	k a s a
касаваць	k a s a v a t͡sʲ
кастрычнік	k a s t r ɨ t͡ʂ nʲ i k
кастрычніцкі	k a s t r ɨ t͡ʂ nʲ i t͡s kʲ i
касір	k a sʲ i r
касірка	k a sʲ i r k a
кат	k a t
катаваць	k a t a v a t͡sʲ
каталонскі	k a t a ɫ o n s kʲ i
кафэ	k a f e
каханне	k a x a nʲː e
кахаць	k a x a t͡sʲ
кацяня	k a t͡sʲ a nʲ a
кацярына	k a t͡sʲ a r ɨ n a
кацёл	k a t͡sʲ o ɫ
качарга	k a t͡ʂ a r ɣ a
качка	k a t͡ʂ k a
качканос	k a t͡ʂ k a n o s
каша	k a ʂ a
кашалёк	k a ʂ a lʲ o k
кашмар	k a ʂ m a r
каштоўны	k a ʂ t o u̯ n ɨ
кашубскі	k a ʂ u p s kʲ i
кашуля	k a ʂ u lʲ a
каўбаса	k a u̯ b a s a
каўтун	k a u̯ t u n
квадрат	k v a d r a t
кватэра	k v a t e r a
кветка	k vʲ e t k a
кепскі	kʲ e p s kʲ i
класці	k ɫ a sʲ t͡sʲ i
класіфікацыя	k ɫ a sʲ i fʲ i k a t͡s ɨ j a
клетка	k lʲ e t k a
ключ	k lʲ u t͡ʂ
клясыфікацыя	k lʲ a s ɨ fʲ i k a t͡s ɨ j a
клён	k lʲ o n
клікаць	k lʲ i k a t͡sʲ
клікнуць	k lʲ i k n u t͡sʲ
клінтух	k lʲ i n t u x
клітар	k lʲ i t a r
клічнік	k lʲ i t͡ʂ nʲ i k
князь	k nʲ a sʲ
князёк	k nʲ a zʲ o k
кніга	k nʲ i ɣ a
кожны	k o ʐ n ɨ
кола	k o ɫ a
колас	k o ɫ a s
коласа	k o ɫ a s a
колер	k o lʲ e r
колькасны	k o lʲ k a s n ɨ
колькасць	k o lʲ k a sʲ t͡sʲ
колькі	k o lʲ kʲ i
конь	k o nʲ
корань	k o r a nʲ
корнскі	k o r n s kʲ i
косава	k o s a v a
коска	k o s k a
косць	k o sʲ t͡sʲ
кот	k o t
кошка	k o ʂ k a
кошык	k o ʂ ɨ k
коўдра	k o u̯ d r a
краб	k r a p
край	k r a j
кракадзіл	k r a k a d͡zʲ i ɫ
кракаў	k r a k a u̯
крама	k r a m a
красавік	k r a s a vʲ i k
красавіцкі	k r a s a vʲ i t͡s kʲ i
красці	k r a sʲ t͡sʲ i
краявід	k r a j a vʲ i t
краіна	k r a j i n a
крок	k r o k
кропка	k r o p k a
кропля	k r o p lʲ a
крот	k r o t
кроў	k r o u̯
круг	k r u x
круглы	k r u ɣ ɫ ɨ
круты	k r u t ɨ
крывавы	k r ɨ v a v ɨ
крывы	k r ɨ v ɨ
крыжанка	k r ɨ ʐ a n k a
крыжмаваць	k r ɨ ʐ m a v a t͡sʲ
крызіс	k r ɨ zʲ i s
крыло	k r ɨ ɫ o
крысціна	k r ɨ sʲ t͡sʲ i n a
крыху	k r ɨ x u
крэйда	k r e j d a
крэмень	k r e mʲ e nʲ
крэмль	k r e m lʲ
крэпасць	k r e p a sʲ t͡sʲ
крэпкі	k r e p kʲ i
крэсла	k r e s ɫ a
ксенія	k sʲ e nʲ i j a
ксёндз	k sʲ o n t͡s
куды	k u d ɨ
кудысьці	k u d ɨ sʲ t͡sʲ i
кузьма	k u zʲ m a
куколь	k u k o lʲ
кулак	k u ɫ a k
культура	k u lʲ t u r a
куля	k u lʲ a
куніца	k u nʲ i t͡s a
купляць	k u p lʲ a t͡sʲ
купіць	k u pʲ i t͡sʲ
курбыка	k u r b ɨ k a
курва	k u r v a
курыца	k u r ɨ t͡s a
курыць	k u r ɨ t͡sʲ
кусаць	k u s a t͡sʲ
кут	k u t
кухня	k u x nʲ a
кхмерскі	k x mʲ e r s kʲ i
кшталт	k ʂ t a ɫ t
кыргызстан	k ɨ r ɣ ɨ sː t a n
кёльн	kʲ o lʲ n
кідаць	kʲ i d a t͡sʲ
кіеў	kʲ i j e u̯
кіеўскі	kʲ i j e u̯ s kʲ i
кій	kʲ i j
кілаграм	kʲ i ɫ a ɣ r a m
кіламетр	kʲ i ɫ a mʲ e t r
кілім	kʲ i lʲ i m
кінатэатр	kʲ i n a t e a t r
кінжал	kʲ i n ʐ a ɫ
кіно	kʲ i n o
кінуць	kʲ i n u t͡sʲ
кіпрыёт	kʲ i p r ɨ j o t
кіпрыётка	kʲ i p r ɨ j o t k a
кіраўнік	kʲ i r a u̯ nʲ i k
кіргіскі	kʲ i r ɣʲ i s kʲ i
кіроўца	kʲ i r o u̯ t͡s a
кірыл	kʲ i r ɨ ɫ
кірыліца	kʲ i r ɨ lʲ i t͡s a
кісларод	kʲ i s ɫ a r o t
кіслы	kʲ i s ɫ ɨ
кіт	kʲ i t
кітаец	kʲ i t a j e t͡s
кітай	kʲ i t a j
кітайскі	kʲ i t a j s kʲ i
кітаянка	kʲ i t a j a n k a
кішка	kʲ i ʂ k a
лавіць	ɫ a vʲ i t͡sʲ
ладдзя	ɫ a d͡zʲː a
лазіць	ɫ a zʲ i t͡sʲ
лайно	ɫ a j n o
ламацца	ɫ a m a t͡sː a
ламаць	ɫ a m a t͡sʲ
ланцуг	ɫ a n t͡s u x
лаоскі	ɫ a o s kʲ i
лапата	ɫ a p a t a
лапаць	ɫ a p a t͡sʲ
ларыса	ɫ a r ɨ s a
ласка	ɫ a s k a
ласось	ɫ a s o sʲ
ластаўка	ɫ a s t a u̯ k a
латвіец	ɫ a t vʲ i j e t͡s
латвія	ɫ a t vʲ i j a
латышскі	ɫ a t ɨ sː kʲ i
лацінскі	ɫ a t͡sʲ i n s kʲ i
лаўка	ɫ a u̯ k a
лаўрэнцій	ɫ a u̯ r e nʲ t͡sʲ i j
лгаць	ɫ ɣ a t͡sʲ
леанід	lʲ e a nʲ i t
лебедзь	lʲ e bʲ e t͡sʲ
лебядзіны	lʲ e bʲ a d͡zʲ i n ɨ
левы	lʲ e v ɨ
легчы	lʲ e x t͡ʂ ɨ
лезці	lʲ e sʲ t͡sʲ i
лекар	lʲ e k a r
лекарка	lʲ e k a r k a
лекі	lʲ e kʲ i
ленін	lʲ e nʲ i n
лепшы	lʲ e p ʂ ɨ
лес	lʲ e s
лета	lʲ e t a
леў	lʲ e u̯
лоб	ɫ o p
лодка	ɫ o t k a
ложак	ɫ o ʐ a k
локаць	ɫ o k a t͡sʲ
локшына	ɫ o k ʂ ɨ n a
лондан	ɫ o n d a n
лось	ɫ o sʲ
луг	ɫ u x
лужыца	ɫ u ʐ ɨ t͡s a
лужыцкі	ɫ u ʐ ɨ t͡s kʲ i
лук	ɫ u k
лукашэнка	ɫ u k a ʂ e n k a
лукашэнкам	ɫ u k a ʂ e n k a m
лукашэнкамі	ɫ u k a ʂ e n k a mʲ i
лукашэнках	ɫ u k a ʂ e n k a x
лукашэнкаў	ɫ u k a ʂ e n k a u̯
лукашэнку	ɫ u k a ʂ e n k u
лукашэнкі	ɫ u k a ʂ e n kʲ i
лыжка	ɫ ɨ ʂ k a
лысы	ɫ ɨ s ɨ
лытка	ɫ ɨ t k a
люблін	lʲ u b lʲ i n
любоў	lʲ u b o u̯
любы	lʲ u b ɨ
любіць	lʲ u bʲ i t͡sʲ
людзі	lʲ u d͡zʲ i
людскі	lʲ u t s kʲ i
люксембургскі	lʲ u k sʲ e m b u r x s kʲ i
люстэрка	lʲ u s t e r k a
лютаўскі	lʲ u t a u̯ s kʲ i
люты	lʲ u t ɨ
ляжаць	lʲ a ʐ a t͡sʲ
лялька	lʲ a lʲ k a
лянівы	lʲ a nʲ i v ɨ
лятаць	lʲ a t a t͡sʲ
лёгкае	lʲ o x k a j e
лёгкі	lʲ o x kʲ i
лёд	lʲ o t
лёс	lʲ o s
лётнішча	lʲ o t nʲ i ʂ t͡ʂ a
лідар	lʲ i d a r
лідзія	lʲ i d͡zʲ i j a
лік	lʲ i k
лінія	lʲ i nʲ i j a
ліпень	lʲ i pʲ e nʲ
ліпеньскі	lʲ i pʲ e nʲ s kʲ i
ліса	lʲ i s a
ліст	lʲ i s t
лістапад	lʲ i s t a p a t
лістападаўскі	lʲ i s t a p a d a u̯ s kʲ i
літара	lʲ i t a r a
літаратура	lʲ i t a r a t u r a
літва	lʲ i t v a
літоўскі	lʲ i t o u̯ s kʲ i
ліфт	lʲ i f t
ліхтар	lʲ i x t a r
ліхі	lʲ i xʲ i
ліць	lʲ i t͡sʲ
лічба	lʲ i d͡ʐ b a
лічыць	lʲ i t͡ʂ ɨ t͡sʲ
ліўскі	lʲ i u̯ s kʲ i
мааізм	m a a j i z m
магазін	m a ɣ a zʲ i n
магдалена	m a ɣ d a lʲ e n a
магній	m a ɣ nʲ i j
магутны	m a ɣ u t n ɨ
магчы	m a x t͡ʂ ɨ
магчымасць	m a x t͡ʂ ɨ m a sʲ t͡sʲ
магчымы	m a x t͡ʂ ɨ m ɨ
магіла	m a ɣʲ i ɫ a
магілёў	m a ɣʲ i lʲ o u̯
мажджэр	m a ʐ d͡ʐ e r
маз	m a s
май	m a j
майскі	m a j s kʲ i
майстэрня	m a j s t e r nʲ a
македонскі	m a kʲ e d o n s kʲ i
македонія	m a kʲ e d o nʲ i j a
макрыца	m a k r ɨ t͡s a
максім	m a k sʲ i m
макшанская	m a k ʂ a n s k a j a
малады	m a ɫ a d ɨ
малайскі	m a ɫ a j s kʲ i
малако	m a ɫ a k o
маланка	m a ɫ a n k a
малдова	m a ɫ d o v a
маленькі	m a lʲ e nʲ kʲ i
малпа	m a ɫ p a
малпачка	m a ɫ p a t͡ʂ k a
малы	m a ɫ ɨ
мальта	m a lʲ t a
малітва	m a lʲ i t v a
мама	m a m a
манах	m a n a x
мангольскі	m a n ɣ o lʲ s kʲ i
манголія	m a n ɣ o lʲ i j a
мапа	m a p a
мара	m a r a
маргарыта	m a r ɣ a r ɨ t a
марка	m a r k a
марожанае	m a r o ʐ a n a j e
мароз	m a r o s
марудны	m a r u d n ɨ
марыва	m a r ɨ v a
марына	m a r ɨ n a
марыя	m a r ɨ j a
маска	m a s k a
маскат	m a s k a t
масква	m a s k v a
масла	m a s ɫ a
мастак	m a s t a k
мастацтва	m a s t a t͡s t v a
матвей	m a t vʲ e j
матор	m a t o r
матыль	m a t ɨ lʲ
матылёк	m a t ɨ lʲ o k
матэматыка	m a t e m a t ɨ k a
мацвей	m a t͡sʲ vʲ e j
маці	m a t͡sʲ i
машонка	m a ʂ o n k a
машына	m a ʂ ɨ n a
маяк	m a j a k
маўклівы	m a u̯ k lʲ i v ɨ
маўчаць	m a u̯ t͡ʂ a t͡sʲ
медзь	mʲ e t͡sʲ
межаваць	mʲ e ʐ a v a t͡sʲ
мексіка	mʲ e k sʲ i k a
мексіканскі	mʲ e k sʲ i k a n s kʲ i
мелкі	mʲ e ɫ kʲ i
менавіта	mʲ e n a vʲ i t a
менск	mʲ e n s k
менш	mʲ e n ʂ
меншасць	mʲ e n ʂ a sʲ t͡sʲ
месны	mʲ e s n ɨ
места	mʲ e s t a
месца	mʲ e s t͡s a
месці	mʲ e sʲ t͡sʲ i
месяц	mʲ e sʲ a t͡s
мех	mʲ e x
мець	mʲ e t͡sʲ
меч	mʲ e t͡ʂ
млын	m ɫ ɨ n
многа	m n o ɣ a
множны	m n o ʐ n ɨ
мо	m o
мова	m o v a
мовазнаўства	m o v a z n a u̯ s t v a
могілкі	m o ɣʲ i ɫ kʲ i
мозг	m o s k
мой	m o j
мокры	m o k r ɨ
моладзь	m o ɫ a t͡sʲ
молат	m o ɫ a t
момант	m o m a n t
мора	m o r a
морак	m o r a k
морква	m o r k v a
мост	m o s t
моц	m o t͡s
моцны	m o t͡s n ɨ
моўны	m o u̯ n ɨ
мсціслаў	m sʲ t͡sʲ i s ɫ a u̯
мудры	m u d r ɨ
муж	m u ʂ
мужнасць	m u ʐ n a sʲ t͡sʲ
мужчына	m u ʂ t͡ʂ ɨ n a
мужчынскі	m u ʂ t͡ʂ ɨ n s kʲ i
музыка	m u z ɨ k a
музычны	m u z ɨ t͡ʂ n ɨ
муляр	m u lʲ a r
мур	m u r
мурашка	m u r a ʂ k a
мурашнік	m u r a ʂ nʲ i k
мусіць	m u sʲ i t͡sʲ
мутэрка	m u t e r k a
муха	m u x a
мы	m ɨ
мыла	m ɨ ɫ a
мыцца	m ɨ t͡sː a
мыць	m ɨ t͡sʲ
мыш	m ɨ ʂ
мэбля	m e b lʲ a
мэлён	m e lʲ o n
мэнскі	m e n s kʲ i
мэтар	m e t a r
мядзведзь	mʲ a d͡zʲ vʲ e t͡sʲ
мядзведзю	mʲ a d͡zʲ vʲ e d͡zʲ u
мядзведзя	mʲ a d͡zʲ vʲ e d͡zʲ a
мядзведзі	mʲ a d͡zʲ vʲ e d͡zʲ i
мяжа	mʲ a ʐ a
мяккі	mʲ a kʲː i
мяне	mʲ a nʲ e
мянчук	mʲ a n t͡ʂ u k
мярэжа	mʲ a r e ʐ a
мяса	mʲ a s a
мятла	mʲ a t ɫ a
мяць	mʲ a t͡sʲ
мяч	mʲ a t͡ʂ
мяшанец	mʲ a ʂ a nʲ e t͡s
мяшок	mʲ a ʂ o k
мёд	mʲ o t
мёртвы	mʲ o r t v ɨ
міжнародны	mʲ i ʐ n a r o d n ɨ
мікалай	mʲ i k a ɫ a j
мікрафон	mʲ i k r a f o n
мікіта	mʲ i kʲ i t a
мілы	mʲ i ɫ ɨ
мільён	mʲ i lʲ j o n
міліметр	mʲ i lʲ i mʲ e t r
мілімэтар	mʲ i lʲ i m e t a r
міліцыя	mʲ i lʲ i t͡s ɨ j a
мінск	mʲ i n s k
мінулае	mʲ i n u ɫ a j e
мінулы	mʲ i n u ɫ ɨ
міністар	mʲ i nʲ i s t a r
міністр	mʲ i nʲ i s t r
мірон	mʲ i r o n
мітынг	mʲ i t ɨ n x
міхаіл	mʲ i x a j i ɫ
на	n a
навалачка	n a v a ɫ a t͡ʂ k a
навальніца	n a v a lʲ nʲ i t͡s a
наверсе	n a vʲ e r sʲ e
наверх	n a vʲ e r x
навошта	n a v o ʂ t a
навука	n a v u k a
навіна	n a vʲ i n a
навіны	n a vʲ i n ɨ
нага	n a ɣ a
нагарода	n a ɣ a r o d a
нагі	n a ɣʲ i
над	n a t
надвор'е	n a d v o r j e
надзейны	n a d͡zʲ e j n ɨ
надзець	n a d͡zʲ e t͡sʲ
надзея	n a d͡zʲ e j a
надзяваць	n a d͡zʲ a v a t͡sʲ
нажніцы	n a ʐ nʲ i t͡s ɨ
нажы	n a ʐ ɨ
назва	n a z v a
наздра	n a z d r a
назоўны	n a z o u̯ n ɨ
назоўнік	n a z o u̯ nʲ i k
найгоршы	n a j ɣ o r ʂ ɨ
найлепшы	n a j lʲ e p ʂ ɨ
намер	n a mʲ e r
намібія	n a mʲ i bʲ i j a
напарстак	n a p a r s t a k
напляваць	n a p lʲ a v a t͡sʲ
напрыклад	n a p r ɨ k ɫ a t
напэўна	n a p e u̯ n a
напісаць	n a pʲ i s a t͡sʲ
нара	n a r a
нарада	n a r a d a
нараджэнне	n a r a d͡ʐ e nʲː e
нарадзіць	n a r a d͡zʲ i t͡sʲ
нарвегія	n a r vʲ e ɣʲ i j a
нарвежскі	n a r vʲ e sː kʲ i
народ	n a r o t
народны	n a r o d n ɨ
нарысаваць	n a r ɨ s a v a t͡sʲ
насарог	n a s a r o x
насельнік	n a sʲ e lʲ nʲ i k
насельніцтва	n a sʲ e lʲ nʲ i t͡s t v a
насенне	n a sʲ e nʲː e
настаўнік	n a s t a u̯ nʲ i k
наступальны	n a s t u p a lʲ n ɨ
наступны	n a s t u p n ɨ
наступства	n a s t u p s t v a
насякомае	n a sʲ a k o m a j e
насіць	n a sʲ i t͡sʲ
наталля	n a t a lʲː a
натоўп	n a t o u̯ p
націск	n a t͡sʲ i s k
начарціць	n a t͡ʂ a r t͡sʲ i t͡sʲ
начлег	n a t͡ʂ lʲ e x
наш	n a ʂ
наша	n a ʂ a
нашчадак	n a ʂ t͡ʂ a d a k
наяўны	n a j a u̯ n ɨ
наўмысны	n a u̯ m ɨ s n ɨ
не	nʲ a
не	nʲ e
неабвержны	nʲ e a b vʲ e r ʐ n ɨ
неабходны	nʲ e a p x o d n ɨ
неадкладны	nʲ e a t k ɫ a d n ɨ
неба	nʲ e b a
небасяг	nʲ e b a sʲ a x
небяспека	nʲ e bʲ a sʲ pʲ e k a
небяспечны	nʲ e bʲ a sʲ pʲ e t͡ʂ n ɨ
невымоўны	nʲ e v ɨ m o u̯ n ɨ
недастатковы	nʲ e d a s t a t k o v ɨ
недахоп	nʲ e d a x o p
незалежнасць	nʲ e z a lʲ e ʐ n a sʲ t͡sʲ
незалежны	nʲ e z a lʲ e ʐ n ɨ
незаменны	nʲ e z a mʲ e nː ɨ
незвычайны	nʲ e z v ɨ t͡ʂ a j n ɨ
нейкі	nʲ e j kʲ i
немаўля	nʲ e m a u̯ lʲ a
немец	nʲ e mʲ e t͡s
немка	nʲ e m k a
ненавідзець	nʲ e n a vʲ i d͡zʲ e t͡sʲ
ненадзейны	nʲ e n a d͡zʲ e j n ɨ
непазбежны	nʲ e p a zʲ bʲ e ʐ n ɨ
непал	nʲ e p a ɫ
непаслушэнства	nʲ e p a s ɫ u ʂ e n s t v a
непасрэдны	nʲ e p a s r e d n ɨ
непасціжны	nʲ e p a sʲ t͡sʲ i ʐ n ɨ
несці	nʲ e sʲ t͡sʲ i
нетапыр	nʲ e t a p ɨ r
нехта	nʲ e x t a
нецярплівы	nʲ e t͡sʲ a r p lʲ i v ɨ
нешта	nʲ e ʂ t a
новы	n o v ɨ
нож	n o ʂ
ноздра	n o z d r a
нораў	n o r a u̯
нос	n o s
носьбіт	n o zʲ bʲ i t
ноч	n o t͡ʂ
нуль	n u lʲ
нумар	n u m a r
нырка	n ɨ r k a
нюх	nʲ u x
нюхаць	nʲ u x a t͡sʲ
ня	nʲ a
нябачны	nʲ a b a t͡ʂ n ɨ
нявінны	nʲ a vʲ i nː ɨ
нядзеля	nʲ a d͡zʲ e lʲ a
нядзелі	nʲ a d͡zʲ e lʲ i
нязграбны	nʲ a z ɡ r a b n ɨ
няма	nʲ a m a
нямецкі	nʲ a mʲ e t͡s kʲ i
нямеччына	nʲ a mʲ e t͡ʂː ɨ n a
нямы	nʲ a m ɨ
нянавісць	nʲ a n a vʲ i sʲ t͡sʲ
нячутны	nʲ a t͡ʂ u t n ɨ
няшмат	nʲ a ʂ m a t
няўхільны	nʲ a u̯ xʲ i lʲ n ɨ
нёман	nʲ o m a n
ніадкуль	nʲ i a t k u lʲ
нідзе	nʲ i d͡zʲ e
нідэрланды	nʲ i d e r ɫ a n d ɨ
ніж	nʲ i ʂ
ніжнелужыцкі	nʲ i ʐ nʲ e ɫ u ʐ ɨ t͡s kʲ i
нізкі	nʲ i s kʲ i
нікарагуа	nʲ i k a r a ɣ u a
ніколі	nʲ i k o lʲ i
нікуды	nʲ i k u d ɨ
ніна	nʲ i n a
ніхто	nʲ i x t o
нішто	nʲ i ʂ t o
ніякі	nʲ i j a kʲ i
ок	o k
опера	o pʲ e r a
осла	o s ɫ a
офіс	o fʲ i s
п'яны	p j a n ɨ
паабедаць	p a a bʲ e d a t͡sʲ
пабачэнне	p a b a t͡ʂ e nʲː e
пабегаць	p a bʲ e ɣ a t͡sʲ
пабудаваць	p a b u d a v a t͡sʲ
пабіць	p a bʲ i t͡sʲ
павадзіць	p a v a d͡zʲ i t͡sʲ
павазіць	p a v a zʲ i t͡sʲ
паведамляць	p a vʲ e d a m lʲ a t͡sʲ
паведаміць	p a vʲ e d a mʲ i t͡sʲ
павезці	p a vʲ e sʲ t͡sʲ i
павека	p a vʲ e k a
павел	p a vʲ e ɫ
паверх	p a vʲ e r x
паверыць	p a vʲ e r ɨ t͡sʲ
павесці	p a vʲ e sʲ t͡sʲ i
павет	p a vʲ e t
паветра	p a vʲ e t r a
павешаць	p a vʲ e ʂ a t͡sʲ
паводзіны	p a v o d͡zʲ i n ɨ
павольны	p a v o lʲ n ɨ
павук	p a v u k
павуціна	p a v u t͡sʲ i n a
павячэраць	p a vʲ a t͡ʂ e r a t͡sʲ
павінен	p a vʲ i nʲ e n
павіншаваць	p a vʲ i n ʂ a v a t͡sʲ
павісець	p a vʲ i sʲ e t͡sʲ
пагадненне	p a ɣ a d nʲ e nʲː e
паганяць	p a ɣ a nʲ a t͡sʲ
пагарда	p a ɣ a r d a
пагарджаць	p a ɣ a r d͡ʐ a t͡sʲ
пагардлівы	p a ɣ a r d lʲ i v ɨ
пагаршаць	p a ɣ a r ʂ a t͡sʲ
паглынаць	p a ɣ ɫ ɨ n a t͡sʲ
паглынуць	p a ɣ ɫ ɨ n u t͡sʲ
паглядзець	p a ɣ lʲ a d͡zʲ e t͡sʲ
пагнаць	p a ɣ n a t͡sʲ
пагода	p a ɣ o d a
пагорак	p a ɣ o r a k
пагоршыць	p a ɣ o r ʂ ɨ t͡sʲ
пагроза	p a ɣ r o z a
пад	p a t
падаконнік	p a d a k o nʲː i k
падарожжа	p a d a r o ʐː a
падарунак	p a d a r u n a k
падарыць	p a d a r ɨ t͡sʲ
падаць	p a d a t͡sʲ
падбародак	p a d b a r o d a k
падзейнічаць	p a d͡zʲ e j nʲ i t͡ʂ a t͡sʲ
падзея	p a d͡zʲ e j a
падлетак	p a d lʲ e t a k
падлога	p a d ɫ o ɣ a
паднябенне	p a d nʲ a bʲ e nʲː e
падняць	p a d nʲ a t͡sʲ
паднімаць	p a d nʲ i m a t͡sʲ
падобны	p a d o b n ɨ
падпаха	p a t p a x a
падручнік	p a d r u t͡ʂ nʲ i k
падсітак	p a t͡sʲ sʲ i t a k
паездзіць	p a j e z d͡zʲ i t͡sʲ
паехаць	p a j e x a t͡sʲ
пажадаць	p a ʐ a d a t͡sʲ
пажар	p a ʐ a r
пажарышча	p a ʐ a r ɨ ʂ t͡ʂ a
пазваніць	p a z v a nʲ i t͡sʲ
пазваць	p a z v a t͡sʲ
пазнаёміць	p a z n a j o mʲ i t͡sʲ
пазногаць	p a z n o ɣ a t͡sʲ
пазычаць	p a z ɨ t͡ʂ a t͡sʲ
пазычыць	p a z ɨ t͡ʂ ɨ t͡sʲ
пайсці	p a j sʲ t͡sʲ i
паказаць	p a k a z a t͡sʲ
паказваць	p a k a z v a t͡sʲ
пакет	p a kʲ e t
пакласці	p a k ɫ a sʲ t͡sʲ i
пакой	p a k o j
пакорлівы	p a k o r lʲ i v ɨ
пакрываць	p a k r ɨ v a t͡sʲ
пакуль	p a k u lʲ
пакупнік	p a k u p nʲ i k
пакурыць	p a k u r ɨ t͡sʲ
пакідаць	p a kʲ i d a t͡sʲ
пакінуць	p a kʲ i n u t͡sʲ
пакістан	p a kʲ i s t a n
палазіць	p a ɫ a zʲ i t͡sʲ
паласа	p a ɫ a s a
палатно	p a ɫ a t n o
палахлівы	p a ɫ a x lʲ i v ɨ
палац	p a ɫ a t͡s
палезці	p a lʲ e sʲ t͡sʲ i
палена	p a lʲ e n a
палепшыць	p a lʲ e p ʂ ɨ t͡sʲ
палестына	p a lʲ e s t ɨ n a
палец	p a lʲ e t͡s
палка	p a ɫ k a
палова	p a ɫ o v a
палон	p a ɫ o n
пальчатка	p a lʲ t͡ʂ a t k a
паляваць	p a lʲ a v a t͡sʲ
паляк	p a lʲ a k
паляпшаць	p a lʲ a p ʂ a t͡sʲ
палячка	p a lʲ a t͡ʂ k a
паляўніцтвазнаўства	p a lʲ a u̯ nʲ i t͡s t v a z n a u̯ s t v a
паляўнічы	p a lʲ a u̯ nʲ i t͡ʂ ɨ
паліна	p a lʲ i n a
палітыка	p a lʲ i t ɨ k a
паліцыя	p a lʲ i t͡s ɨ j a
паліць	p a lʲ i t͡sʲ
палічыць	p a lʲ i t͡ʂ ɨ t͡sʲ
памагаць	p a m a ɣ a t͡sʲ
памагчы	p a m a x t͡ʂ ɨ
памер	p a mʲ e r
памылка	p a m ɨ ɫ k a
памыцца	p a m ɨ t͡sː a
памыць	p a m ɨ t͡sʲ
памянуць	p a mʲ a n u t͡sʲ
памятаць	p a mʲ a t a t͡sʲ
памяць	p a mʲ a t͡sʲ
памідор	p a mʲ i d o r
паміж	p a mʲ i ʂ
памінаць	p a mʲ i n a t͡sʲ
паміраць	p a mʲ i r a t͡sʲ
пан	p a n
панасіць	p a n a sʲ i t͡sʲ
панесці	p a nʲ e sʲ t͡sʲ i
панчоха	p a n t͡ʂ o x a
панядзелак	p a nʲ a d͡zʲ e ɫ a k
пані	p a nʲ i
папера	p a pʲ e r a
паплаваць	p a p ɫ a v a t͡sʲ
паплыць	p a p ɫ ɨ t͡sʲ
папрасіць	p a p r a sʲ i t͡sʲ
папугай	p a p u ɣ a j
паражэнне	p a r a ʐ e nʲː e
паралон	p a r a ɫ o n
парасон	p a r a s o n
параход	p a r a x o t
параўнанне	p a r a u̯ n a nʲː e
параўнаць	p a r a u̯ n a t͡sʲ
парк	p a r k
парнаграфічны	p a r n a ɣ r a fʲ i t͡ʂ n ɨ
парнаграфія	p a r n a ɣ r a fʲ i j a
парог	p a r o x
парожні	p a r o ʐ nʲ i
парсюк	p a r sʲ u k
партрэт	p a r t r e t
партугальскі	p a r t u ɣ a lʲ s kʲ i
партугалія	p a r t u ɣ a lʲ i j a
партфель	p a r t fʲ e lʲ
партфэль	p a r t f e lʲ
партыя	p a r t ɨ j a
парыж	p a r ɨ ʂ
парыжскі	p a r ɨ sː kʲ i
парэнча	p a r e n t͡ʂ a
пасад	p a s a t
пасведчанне	p a sʲ vʲ e t ː͡ʂ a nʲː e
паскарацца	p a s k a r a t͡sː a
паскараць	p a s k a r a t͡sʲ
паскарэнне	p a s k a r e nʲː e
паскорыцца	p a s k o r ɨ t͡sː a
паскорыць	p a s k o r ɨ t͡sʲ
паслухаць	p a s ɫ u x a t͡sʲ
паслухмяны	p a s ɫ u x mʲ a n ɨ
паслушны	p a s ɫ u ʂ n ɨ
паслушэнства	p a s ɫ u ʂ e n s t v a
пасол	p a s o ɫ
паспрабаваць	p a s p r a b a v a t͡sʲ
паспрачацца	p a s p r a t͡ʂ a t͡sː a
паспрыяць	p a s p r ɨ j a t͡sʲ
пасрэдны	p a s r e d n ɨ
паставіць	p a s t a vʲ i t͡sʲ
пастаяць	p a s t a j a t͡sʲ
паступаць	p a s t u p a t͡sʲ
паступіць	p a s t u pʲ i t͡sʲ
пасці	p a sʲ t͡sʲ i
пасылаць	p a s ɨ ɫ a t͡sʲ
паток	p a t o k
патрабаваць	p a t r a b a v a t͡sʲ
патыліца	p a t ɨ lʲ i t͡s a
пафарбаваць	p a f a r b a v a t͡sʲ
пах	p a x
пахадзіць	p a x a d͡zʲ i t͡sʲ
пахнуць	p a x n u t͡sʲ
пацалаваць	p a t͡s a ɫ a v a t͡sʲ
пацалунак	p a t͡s a ɫ u n a k
пацук	p a t͡s u k
пачакаць	p a t͡ʂ a k a t͡sʲ
пачатак	p a t͡ʂ a t a k
пачацца	p a t͡ʂ a t͡sː a
пачаць	p a t͡ʂ a t͡sʲ
пачварны	p a t͡ʂ v a r n ɨ
пачуццё	p a t͡ʂ u t͡sʲː o
пачуць	p a t͡ʂ u t͡sʲ
пачынацца	p a t͡ʂ ɨ n a t͡sː a
пачынаць	p a t͡ʂ ɨ n a t͡sʲ
пачысціць	p a t͡ʂ ɨ sʲ t͡sʲ i t͡sʲ
пашпарт	p a ʂ p a r t
паіць	p a j i t͡sʲ
паўвостраў	p a u̯ v o s t r a u̯
паўднёвы	p a u̯ d nʲ o v ɨ
паўзці	p a u̯ sʲ t͡sʲ i
паўночны	p a u̯ n o t͡ʂ n ɨ
паўстанне	p a u̯ s t a nʲː e
паўтара	p a u̯ t a r a
паўтараць	p a u̯ t a r a t͡sʲ
паўтарыць	p a u̯ t a r ɨ t͡sʲ
певень	pʲ e vʲ e nʲ
педагогіка	pʲ e d a ɣ o ɣʲ i k a
пекар	pʲ e k a r
пекарка	pʲ e k a r k a
пекін	pʲ e kʲ i n
пенсільванія	pʲ e n sʲ i lʲ v a nʲ i j a
пень	pʲ e nʲ
пеніс	pʲ e nʲ i s
пераапранацца	pʲ e r a a p r a n a t͡sː a
перавага	pʲ e r a v a ɣ a
перад	pʲ e r a t
перажываць	pʲ e r a ʐ ɨ v a t͡sʲ
перажыць	pʲ e r a ʐ ɨ t͡sʲ
пераклад	pʲ e r a k ɫ a t
перакладаць	pʲ e r a k ɫ a d a t͡sʲ
перакладчык	pʲ e r a k ɫ a t ː͡ʂ ɨ k
перакладчыца	pʲ e r a k ɫ a t ː͡ʂ ɨ t͡s a
перамагчы	pʲ e r a m a x t͡ʂ ɨ
перамога	pʲ e r a m o ɣ a
перасаджвацца	pʲ e r a s a d͡ʐ v a t͡sː a
перац	pʲ e r a t͡s
пераязджаць	pʲ e r a j a ʐ d͡ʐ a t͡sʲ
персцень	pʲ e r sʲ t͡sʲ e nʲ
персідскі	pʲ e r sʲ i t s kʲ i
персік	pʲ e r sʲ i k
першамучанік	pʲ e r ʂ a m u t͡ʂ a nʲ i k
першамучаніца	pʲ e r ʂ a m u t͡ʂ a nʲ i t͡s a
першы	pʲ e r ʂ ɨ
песня	pʲ e sʲ nʲ a
печ	pʲ e t͡ʂ
печань	pʲ e t͡ʂ a nʲ
печка	pʲ e t͡ʂ k a
пеўню	pʲ e vʲ e nʲ
плаваць	p ɫ a v a t͡sʲ
плакаць	p ɫ a k a t͡sʲ
план	p ɫ a n
планета	p ɫ a nʲ e t a
платформа	p ɫ a t f o r m a
плаціна	p ɫ a t͡sʲ i n a
плаціць	p ɫ a t͡sʲ i t͡sʲ
племя	p lʲ e mʲ a
плесці	p lʲ e sʲ t͡sʲ i
плод	p ɫ o t
плоскі	p ɫ o s kʲ i
плошча	p ɫ o ʂ t͡ʂ a
плуг	p ɫ u x
плысці	p ɫ ɨ sʲ t͡sʲ i
плыць	p ɫ ɨ t͡sʲ
пляваць	p lʲ a v a t͡sʲ
пляменнік	p lʲ a mʲ e nʲː i k
пляменніца	p lʲ a mʲ e nʲː i t͡s a
плячо	p lʲ a t͡ʂ o
побач	p o b a t͡ʂ
поезд	p o j e s t
познань	p o z n a nʲ
пол	p o ɫ
полаз	p o ɫ a s
поле	p o lʲ e
полы	p o ɫ ɨ
полымны	p o ɫ ɨ m n ɨ
полымя	p o ɫ ɨ mʲ a
полька	p o lʲ k a
польскі	p o lʲ s kʲ i
польшча	p o lʲ ʂ t͡ʂ a
помнік	p o m nʲ i k
помніць	p o m nʲ i t͡sʲ
помста	p o m s t a
поп	p o p
попел	p o pʲ e ɫ
попельніца	p o pʲ e lʲ nʲ i t͡s a
порах	p o r a x
поспех	p o s pʲ e x
пот	p o t
похва	p o x v a
пошта	p o ʂ t a
пояс	p o j a s
поўдзень	p o u̯ d͡zʲ e nʲ
поўнач	p o u̯ n a t͡ʂ
поўны	p o u̯ n ɨ
прабабуля	p r a b a b u lʲ a
прабачэнне	p r a b a t͡ʂ e nʲː e
праблема	p r a b lʲ e m a
права	p r a v a
правадыр	p r a v a d ɨ r
правапіс	p r a v a pʲ i s
правы	p r a v ɨ
правіла	p r a vʲ i ɫ a
правільны	p r a vʲ i lʲ n ɨ
прага	p r a ɣ a
праграма	p r a ɣ r a m a
праграмны	p r a ɣ r a m n ɨ
прадаваць	p r a d a v a t͡sʲ
прадаць	p r a d a t͡sʲ
прадзед	p r a d͡zʲ e t
прадпрыемства	p r a t p r ɨ j e m s t v a
прадстаўнік	p r a t s t a u̯ nʲ i k
пража	p r a ʐ a
празрысты	p r a z r ɨ s t ɨ
пракофій	p r a k o fʲ i j
прамень	p r a mʲ e nʲ
прамоўца	p r a m o u̯ t͡s a
прамы	p r a m ɨ
праніклівы	p r a nʲ i k lʲ i v ɨ
прас	p r a s
праславянскі	p r a s ɫ a vʲ a n s kʲ i
праспект	p r a s pʲ e k t
прастата	p r a s t a t a
прастол	p r a s t o ɫ
прастытутка	p r a s t ɨ t u t k a
прасіць	p r a sʲ i t͡sʲ
праца	p r a t͡s a
працаваць	p r a t͡s a v a t͡sʲ
працаўнік	p r a t͡s a u̯ nʲ i k
працоўны	p r a t͡s o u̯ n ɨ
праць	p r a t͡sʲ
прачнуцца	p r a t͡ʂ n u t͡sː a
прачынацца	p r a t͡ʂ ɨ n a t͡sː a
прачытаць	p r a t͡ʂ ɨ t a t͡sʲ
праўда	p r a u̯ d a
праўдашукальнік	p r a u̯ d a ʂ u k a lʲ nʲ i k
продак	p r o d a k
прозвішча	p r o zʲ vʲ i ʂ t͡ʂ a
проса	p r o s a
просты	p r o s t ɨ
проціяддзе	p r o t͡sʲ i j a d͡zʲː e
пруткі	p r u t kʲ i
пры	p r ɨ
прывет	p r ɨ vʲ e t
прывозіць	p r ɨ v o zʲ i t͡sʲ
прывід	p r ɨ vʲ i t
прывітанне	p r ɨ vʲ i t a nʲː e
прывітаць	p r ɨ vʲ i t a t͡sʲ
прыгажосць	p r ɨ ɣ a ʐ o sʲ t͡sʲ
прыгажун	p r ɨ ɣ a ʐ u n
прыгажуня	p r ɨ ɣ a ʐ u nʲ a
прыгожы	p r ɨ ɣ o ʐ ɨ
прыдатны	p r ɨ d a t n ɨ
прыехаць	p r ɨ j e x a t͡sʲ
прызямленне	p r ɨ zʲ a m lʲ e nʲː e
прыйсці	p r ɨ j sʲ t͡sʲ i
прыказка	p r ɨ k a s k a
прыклад	p r ɨ k ɫ a t
прымаць	p r ɨ m a t͡sʲ
прыметнік	p r ɨ mʲ e t nʲ i k
прыназоўнік	p r ɨ n a z o u̯ nʲ i k
прынамсі	p r ɨ n a m sʲ i
прынесці	p r ɨ nʲ e sʲ t͡sʲ i
прыносіць	p r ɨ n o sʲ i t͡sʲ
прынтар	p r ɨ n t a r
прыняць	p r ɨ nʲ a t͡sʲ
прыпяць	p r ɨ pʲ a t͡sʲ
прырода	p r ɨ r o d a
прыродны	p r ɨ r o d n ɨ
прыслоўе	p r ɨ s ɫ o u̯ j e
прыстасаванне	p r ɨ s t a s a v a nʲː e
прысутнасць	p r ɨ s u t n a sʲ t͡sʲ
прысутны	p r ɨ s u t n ɨ
прысяга	p r ɨ sʲ a ɣ a
прытулак	p r ɨ t u ɫ a k
прыходзіць	p r ɨ x o d͡zʲ i t͡sʲ
прычына	p r ɨ t͡ʂ ɨ n a
прыязджаць	p r ɨ j a ʐ d͡ʐ a t͡sʲ
прыяцель	p r ɨ j a t͡sʲ e lʲ
прэзідэнт	p r e zʲ i d e n t
прэстыжны	p r e s t ɨ ʐ n ɨ
птушка	p t u ʂ k a
публіка	p u b lʲ i k a
пуга	p u ɣ a
пудзіла	p u d͡zʲ i ɫ a
пуп	p u p
пурпурны	p u r p u r n ɨ
пусты	p u s t ɨ
пустыня	p u s t ɨ nʲ a
пустэльнік	p u s t e lʲ nʲ i k
пуць	p u t͡sʲ
пчала	p t͡ʂ a ɫ a
пшаніца	p ʂ a nʲ i t͡s a
пыл	p ɨ ɫ
пыласос	p ɨ ɫ a s o s
пытальнік	p ɨ t a lʲ nʲ i k
пытанне	p ɨ t a nʲː e
пытаць	p ɨ t a t͡sʲ
пэндзаль	p e n d͡z a lʲ
пэўны	p e u̯ n ɨ
пякарня	pʲ a k a r nʲ a
пярдзець	pʲ a r d͡zʲ e t͡sʲ
пяро	pʲ a r o
пярсцёнак	pʲ a r sʲ t͡sʲ o n a k
пярэсты	pʲ a r e s t ɨ
пясок	pʲ a s o k
пятка	pʲ a t k a
пятля	pʲ a t lʲ a
пятнаццаты	pʲ a t n a t͡sː a t ɨ
пятнаццаць	pʲ a t n a t͡sː a t͡sʲ
пятніца	pʲ a t nʲ i t͡s a
пятніцы	pʲ a t nʲ i t͡s ɨ
пятро	pʲ a t r o
пяты	pʲ a t ɨ
пяць	pʲ a t͡sʲ
пяцьдзесят	pʲ a d͡zʲː e sʲ a t
пяцьсот	pʲ a t͡sʲ s o t
пяцёра	pʲ a t͡sʲ o r a
пячаць	pʲ a t͡ʂ a t͡sʲ
пячоначны	pʲ a t͡ʂ o n a t͡ʂ n ɨ
пячора	pʲ a t͡ʂ o r a
пячы	pʲ a t͡ʂ ɨ
пяшчота	pʲ a ʂ t͡ʂ o t a
пяшчотны	pʲ a ʂ t͡ʂ o t n ɨ
пёс	pʲ o s
пётр	pʲ o t r
піва	pʲ i v a
півавар	pʲ i v a v a r
піваварка	pʲ i v a v a r k a
півоня	pʲ i v o nʲ a
пізда	pʲ i z d a
піла	pʲ i ɫ a
пінск	pʲ i n s k
пірог	pʲ i r o x
пісаць	pʲ i s a t͡sʲ
піскулька	pʲ i s k u lʲ k a
пісьменнік	pʲ i sʲ mʲ e nʲː i k
пісьменніца	pʲ i sʲ mʲ e nʲː i t͡s a
пісьмо	pʲ i sʲ m o
піццё	pʲ i t͡sʲː o
піць	pʲ i t͡sʲ
піў	pʲ i u̯
раб	r a p
рабро	r a b r o
рабяты	r a bʲ a t ɨ
рабёнак	r a bʲ o n a k
рабіць	r a bʲ i t͡sʲ
радасны	r a d a s n ɨ
радасць	r a d a sʲ t͡sʲ
раджацца	r a d͡ʐ a t͡sː a
радзівон	r a d͡zʲ i v o n
радзіма	r a d͡zʲ i m a
радзіна	r a d͡zʲ i n a
радзіцца	r a d͡zʲ i t͡sː a
радзіць	r a d͡zʲ i t͡sʲ
радыё	r a d ɨ j o
радыёстанцыя	r a d ɨ j o s t a n t͡s ɨ j a
раз	r a s
разбівацца	r a zʲ bʲ i v a t͡sː a
разбіваць	r a zʲ bʲ i v a t͡sʲ
разбіцца	r a zʲ bʲ i t͡sː a
разбіць	r a z bʲ i t͡sʲ
размаўляць	r a z m a u̯ lʲ a t͡sʲ
размова	r a z m o v a
разумець	r a z u mʲ e t͡sʲ
разумны	r a z u m n ɨ
рай	r a j
рак	r a k
рака	r a k a
ракета	r a kʲ e t a
рала	r a ɫ a
раман	r a m a n
рана	r a n a
ранні	r a nʲː i
раніца	r a nʲ i t͡s a
раптам	r a p t a m
раптоўны	r a p t o u̯ n ɨ
рапуха	r a p u x a
раса	r a s a
расамаха	r a s a m a x a
расейскі	r a sʲ e j s kʲ i
расея	r a sʲ e j a
расклад	r a s k ɫ a t
раскоша	r a s k o ʂ a
расліна	r a sʲ lʲ i n a
рассеяны	r a sʲː e j a n ɨ
расці	r a sʲ t͡sʲ i
расціслаў	r a sʲ t͡sʲ i s ɫ a u̯
расчараваць	r a ʂ t͡ʂ a r a v a t͡sʲ
расьліна	r a sʲ lʲ i n a
расійскі	r a sʲ i j s kʲ i
расія	r a sʲ i j a
расіянка	r a sʲ i j a n k a
расіянін	r a sʲ i j a nʲ i n
рахунак	r a x u n a k
рашаць	r a ʂ a t͡sʲ
рашыць	r a ʂ ɨ t͡sʲ
рашэнне	r a ʂ e nʲː e
раён	r a j o n
раіса	r a j i s a
раіць	r a j i t͡sʲ
раўнівы	r a u̯ nʲ i v ɨ
рваць	r v a t͡sʲ
ржаць	r ʐ a t͡sʲ
робат	r o b a t
ровар	r o v a r
рог	r o x
род	r o t
родны	r o d n ɨ
розны	r o z n ɨ
розум	r o z u m
рок	r o k
ром	r o m
рот	r o t
роў	r o u̯
роўнабочны	r o u̯ n a b o t͡ʂ n ɨ
роўны	r o u̯ n ɨ
рубель	r u bʲ e lʲ
ружовы	r u ʐ o v ɨ
рука	r u k a
румынскі	r u m ɨ n s kʲ i
румынія	r u m ɨ nʲ i j a
руская	r u s k a j a
рускі	r u s kʲ i
русь	r u sʲ
рух	r u x
рухавік	r u x a vʲ i k
ручка	r u t͡ʂ k a
ручнік	r u t͡ʂ nʲ i k
рыба	r ɨ b a
рыгор	r ɨ ɣ o r
рыдлёўка	r ɨ d lʲ o u̯ k a
рыж	r ɨ ʂ
рыла	r ɨ ɫ a
рым	r ɨ m
рынак	r ɨ n a k
рыс	r ɨ s
рыса	r ɨ s a
рысаваць	r ɨ s a v a t͡sʲ
рысь	r ɨ sʲ
рыць	r ɨ t͡sʲ
рэвалюцыя	r e v a lʲ u t͡s ɨ j a
рэгіна	r e ɣʲ i n a
рэгіён	r e ɣʲ i j o n
рэдка	r e t k a
рэдкі	r e t kʲ i
рэзаць	r e z a t͡sʲ
рэклама	r e k ɫ a m a
рэлігія	r e lʲ i ɣʲ i j a
рэмень	r e mʲ e nʲ
рэспубліка	r e s p u b lʲ i k a
рэстаран	r e s t a r a n
рэферэндум	r e fʲ e r e n d u m
рэч	r e t͡ʂ
рэчыва	r e t͡ʂ ɨ v a
рэшата	r e ʂ a t a
рэшта	r e ʂ t a
сабака	s a b a k a
сабор	s a b o r
сабраць	s a b r a t͡sʲ
сава	s a v a
савет	s a vʲ e t
савецкі	s a vʲ e t͡s kʲ i
сад	s a t
садавіна	s a d a vʲ i n a
сажалка	s a ʐ a ɫ k a
сакавік	s a k a vʲ i k
сакавіцкі	s a k a vʲ i t͡s kʲ i
салавей	s a ɫ a vʲ e j
салгаць	s a ɫ ɣ a t͡sʲ
салдат	s a ɫ d a t
салодкі	s a ɫ o t kʲ i
салома	s a ɫ o m a
сам	s a m
самагубства	s a m a ɣ u p s t v a
самалёт	s a m a lʲ o t
самастрэл	s a m a s t r e ɫ
самаход	s a m a x o t
самотны	s a m o t n ɨ
сані	s a nʲ i
сапраўднае	s a p r a u̯ d n a j e
сапраўдны	s a p r a u̯ d n ɨ
сапраўды	s a p r a u̯ d ɨ
сараева	s a r a j e v a
сарамлівы	s a r a m lʲ i v ɨ
сарна	s a r n a
сарока	s a r o k a
сасна	s a s n a
сатана	s a t a n a
сацыялізм	s a t͡s ɨ j a lʲ i z m
сачавіца	s a t͡ʂ a vʲ i t͡s a
саюз	s a j u s
саўдзельнік	s a u̯ d͡zʲ e lʲ nʲ i k
свабода	s v a b o d a
свабодны	s v a b o d n ɨ
сведка	sʲ vʲ e t k a
свежы	sʲ vʲ e ʐ ɨ
свет	sʲ vʲ e t
светлы	sʲ vʲ e t ɫ ɨ
свечка	sʲ vʲ e t͡ʂ k a
свой	s v o j
свякроў	sʲ vʲ a k r o u̯
свякруха	sʲ vʲ a k r u x a
свята	sʲ vʲ a t a
святар	sʲ vʲ a t a r
святлана	sʲ vʲ a t ɫ a n a
святлафор	sʲ vʲ a t ɫ a f o r
святы	sʲ vʲ a t ɨ
свёкар	sʲ vʲ o k a r
свінец	sʲ vʲ i nʲ e t͡s
свісток	sʲ vʲ i s t o k
світанне	sʲ vʲ i t a nʲː e
секунда	sʲ e k u n d a
селядзец	sʲ e lʲ a d͡zʲ e t͡s
селязёнка	sʲ e lʲ a zʲ o n k a
сем	sʲ e m
семдзесят	sʲ e m d͡zʲ e sʲ a t
семсот	sʲ e m s o t
семя	sʲ e mʲ a
сена	sʲ e n a
сене	sʲ e nʲ e
сену	sʲ e n u
сені	sʲ e nʲ i
серабро	sʲ e r a b r o
серада	sʲ e r a d a
серады	sʲ e r a d ɨ
сербскі	sʲ e r p s kʲ i
сербія	sʲ e r bʲ i j a
серп	sʲ e r p
сесці	sʲ e sʲ t͡sʲ i
сеул	sʲ e u ɫ
сказаць	s k a z a t͡sʲ
скараціць	s k a r a t͡sʲ i t͡sʲ
скарачаць	s k a r a t͡ʂ a t͡sʲ
скарпіён	s k a r pʲ i j o n
скарыстаць	s k a r ɨ s t a t͡sʲ
скарыстоўваць	s k a r ɨ s t o u̯ v a t͡sʲ
скасаваць	s k a s a v a t͡sʲ
скланенне	s k ɫ a nʲ e nʲː e
склон	s k ɫ o n
скоп'е	s k o p j e
скорасць	s k o r a sʲ t͡sʲ
скрасці	s k r a sʲ t͡sʲ i
скромны	s k r o m n ɨ
скрыпка	s k r ɨ p k a
скупы	s k u p ɨ
скура	s k u r a
сківіца	s kʲ i vʲ i t͡s a
слабы	s ɫ a b ɨ
слава	s ɫ a v a
славак	s ɫ a v a k
славакія	s ɫ a v a kʲ i j a
славацкі	s ɫ a v a t͡s kʲ i
славачка	s ɫ a v a t͡ʂ k a
славенскі	s ɫ a vʲ e n s kʲ i
славенія	s ɫ a vʲ e nʲ i j a
славонія	s ɫ a v o nʲ i j a
славянка	s ɫ a vʲ a n k a
славянскі	s ɫ a vʲ a n s kʲ i
славянін	s ɫ a vʲ a nʲ i n
славінскі	s ɫ a vʲ i n s kʲ i
сланечнік	s ɫ a nʲ e t͡ʂ nʲ i k
слаць	s ɫ a t͡sʲ
слесар	sʲ lʲ e s a r
слова	s ɫ o v a
слон	s ɫ o n
слоўны	s ɫ o u̯ n ɨ
слоўнік	s ɫ o u̯ nʲ i k
служба	s ɫ u ʐ b a
служыць	s ɫ u ʐ ɨ t͡sʲ
слуп	s ɫ u p
слухаць	s ɫ u x a t͡sʲ
слухач	s ɫ u x a t͡ʂ
слухачка	s ɫ u x a t͡ʂ k a
слушнасць	s ɫ u ʂ n a sʲ t͡sʲ
слых	s ɫ ɨ x
сляза	sʲ lʲ a z a
сляпы	sʲ lʲ a p ɨ
сліва	sʲ lʲ i v a
слімак	sʲ lʲ i m a k
сліна	sʲ lʲ i n a
смактаць	s m a k t a t͡sʲ
смелы	sʲ mʲ e ɫ ɨ
смерць	sʲ mʲ e r t͡sʲ
смех	sʲ mʲ e x
смецце	sʲ mʲ e t͡sʲː e
смоўж	s m o u̯ ʂ
смык	s m ɨ k
смычок	s m ɨ t͡ʂ o k
смярдзець	sʲ mʲ a r d͡zʲ e t͡sʲ
смяротны	sʲ mʲ a r o t n ɨ
смяяцца	sʲ mʲ a j a t͡sː a
снег	sʲ nʲ e x
снегу	sʲ nʲ e ɣ u
снежань	sʲ nʲ e ʐ a nʲ
снежаньскі	sʲ nʲ e ʐ a nʲ s kʲ i
сноп	s n o p
снягір	sʲ nʲ a ɣʲ i r
сняданак	sʲ nʲ a d a n a k
сняжынка	sʲ nʲ a ʐ ɨ n k a
собаль	s o b a lʲ
сойка	s o j k a
сок	s o k
сокал	s o k a ɫ
солад	s o ɫ a t
соль	s o lʲ
сон	s o n
сонечны	s o nʲ e t͡ʂ n ɨ
сонны	s o nː ɨ
сонца	s o n t͡s a
сорак	s o r a k
сорам	s o r a m
соты	s o t ɨ
соф'я	s o f j a
спаборніцтва	s p a b o r nʲ i t͡s t v a
спавядальнік	s p a vʲ a d a lʲ nʲ i k
спадар	s p a d a r
спадарожнік	s p a d a r o ʐ nʲ i k
спадарства	s p a d a r s t v a
спадарыня	s p a d a r ɨ nʲ a
спадзявацца	s p a d͡zʲ a v a t͡sː a
спазніцца	s p a zʲ nʲ i t͡sː a
спакой	s p a k o j
спакойны	s p a k o j n ɨ
спальня	s p a lʲ nʲ a
спаць	s p a t͡sʲ
сперма	sʲ pʲ e r m a
спорт	s p o r t
спрабаваць	s p r a b a v a t͡sʲ
справа	s p r a v a
спражэнне	s p r a ʐ e nʲː e
спрачацца	s p r a t͡ʂ a t͡sː a
спроба	s p r o b a
спрыяць	s p r ɨ j a t͡sʲ
спускацца	s p u s k a t͡sː a
спусціцца	s p u sʲ t͡sʲ i t͡sː a
спытаць	s p ɨ t a t͡sʲ
спяваць	sʲ pʲ a v a t͡sʲ
спякотны	sʲ pʲ a k o t n ɨ
спячы	sʲ pʲ a t͡ʂ ɨ
спіна	sʲ pʲ i n a
срэбра	s r e b r a
ссаць	sː a t͡sʲ
ставіць	s t a vʲ i t͡sʲ
стагоддзе	s t a ɣ o d͡zʲː e
стадыён	s t a d ɨ j o n
стакан	s t a k a n
сталіца	s t a lʲ i t͡s a
стамеска	s t a mʲ e s k a
станавіцца	s t a n a vʲ i t͡sː a
станцыя	s t a n t͡s ɨ j a
станіслаў	s t a nʲ i s ɫ a u̯
старадаўні	s t a r a d a u̯ nʲ i
старажытны	s t a r a ʐ ɨ t n ɨ
старана	s t a r a n a
стараста	s t a r a s t a
старонка	s t a r o n k a
старшыня	s t a r ʂ ɨ nʲ a
стары	s t a r ɨ
стаць	s t a t͡sʲ
стаяць	s t a j a t͡sʲ
ствол	s t v o ɫ
сто	s t o
стог	s t o x
стол	s t o ɫ
столь	s t o lʲ
стольнік	s t o lʲ nʲ i k
стомлены	s t o m lʲ e n ɨ
стораж	s t o r a ʂ
страла	s t r a ɫ a
страляць	s t r a lʲ a t͡sʲ
страх	s t r a x
страўнік	s t r a u̯ nʲ i k
стронга	s t r o n ɣ a
стрыгчы	s t r ɨ x t͡ʂ ɨ
стрыечны	s t r ɨ j e t͡ʂ n ɨ
стрэл	s t r e ɫ
стрэлка	s t r e ɫ k a
стрэльба	s t r e lʲ b a
стрэліць	s t r e lʲ i t͡sʲ
стрэмя	s t r e mʲ a
студзень	s t u d͡zʲ e nʲ
студзеньскі	s t u d͡zʲ e nʲ s kʲ i
студэнт	s t u d e n t
студэнтка	s t u d e n t k a
ступень	s t u pʲ e nʲ
суайчыннік	s u a j t͡ʂ ɨ nʲː i k
субота	s u b o t a
суботы	s u b o t ɨ
суграмадзянін	s u ɣ r a m a d͡zʲ a nʲ i n
суд	s u t
суддзя	s u d͡zʲː a
судна	s u d n a
сукенка	s u kʲ e n k a
сумець	s u mʲ e t͡sʲ
сумка	s u m k a
сумленне	s u m lʲ e nʲː e
сумленны	s u m lʲ e nː ɨ
сумнеў	s u m nʲ e u̯
сумны	s u m n ɨ
сумнявацца	s u m nʲ a v a t͡sː a
супрацоўніцтва	s u p r a t͡s o u̯ nʲ i t͡s t v a
супраць	s u p r a t͡sʲ
сур'ёзны	s u r j o z n ɨ
сура	s u r a
сусвет	s u s vʲ e t
сусед	s u sʲ e t
сустрэча	s u s t r e t͡ʂ a
суфікс	s u fʲ i k s
сухазем'е	s u x a zʲ e m j e
сухі	s u xʲ i
сучасны	s u t͡ʂ a s n ɨ
сцябло	sʲ t͡sʲ a b ɫ o
сцяг	sʲ t͡sʲ a x
сцягно	sʲ t͡sʲ a ɣ n o
сцяна	sʲ t͡sʲ a n a
сцяпан	sʲ t͡sʲ a p a n
сціплы	sʲ t͡sʲ i p ɫ ɨ
сын	s ɨ n
сыр	s ɨ r
сыры	s ɨ r ɨ
сысці	s ɨ sʲ t͡sʲ i
сыты	s ɨ t ɨ
сыходзіць	s ɨ x o d͡zʲ i t͡sʲ
сьлімак	sʲ lʲ i m a k
сэрца	s e r t͡s a
сюды	sʲ u d ɨ
сябар	sʲ a b a r
сябе	sʲ a bʲ e
сяброўства	sʲ a b r o u̯ s t v a
сягоння	sʲ a ɣ o nʲː a
сядзець	sʲ a d͡zʲ e t͡sʲ
сядзіба	sʲ a d͡zʲ i b a
сядло	sʲ a d ɫ o
сякера	sʲ a kʲ e r a
сяло	sʲ a ɫ o
сям'я	sʲ a m j a
сямнаццаты	sʲ a m n a t͡sː a t ɨ
сямнаццаць	sʲ a m n a t͡sː a t͡sʲ
сямён	sʲ a mʲ o n
сямёра	sʲ a mʲ o r a
сяргей	sʲ a r ɣʲ e j
сярдзіты	sʲ a r d͡zʲ i t ɨ
сярод	sʲ a r o t
сярэбраны	sʲ a r e b r a n ɨ
сярэдні	sʲ a r e d nʲ i
сястра	sʲ a s t r a
сястрой	sʲ a s t r o j
сястру	sʲ a s t r u
сястры	sʲ a s t r ɨ
сятчатка	sʲ a t ː͡ʂ a t k a
сёмы	sʲ o m ɨ
сёння	sʲ o nʲː a
сёстрам	sʲ o s t r a m
сёстрамі	sʲ o s t r a mʲ i
сёстрах	sʲ o s t r a x
сёстраў	sʲ o s t r a u̯
сёстры	sʲ o s t r ɨ
сібір	sʲ i bʲ i r
сівы	sʲ i v ɨ
сіла	sʲ i ɫ a
сінагога	sʲ i n a ɣ o ɣ a
сінгапур	sʲ i n ɡ a p u r
сінгапур	sʲ i n ɣ a p u r
сінонім	sʲ i n o nʲ i m
сіньцзян	sʲ i nʲ d͡zʲ zʲ a n
сіні	sʲ i nʲ i
сініца	sʲ i nʲ i t͡s a
сіта	sʲ i t a
табліца	t a b lʲ i t͡s a
тавар	t a v a r
таварыш	t a v a r ɨ ʂ
тагальскі	t a ɣ a lʲ s kʲ i
таджыкскі	t a d͡ʐ ɨ k s kʲ i
таджыкістан	t a d͡ʐ ɨ kʲ i s t a n
тады	t a d ɨ
тайна	t a j n a
тайскі	t a j s kʲ i
так	t a k
таксама	t a k s a m a
таксі	t a k sʲ i
такі	t a kʲ i
талерка	t a lʲ e r k a
там	t a m
тамара	t a m a r a
танзанія	t a n z a nʲ i j a
танны	t a nː ɨ
танцаваць	t a n t͡s a v a t͡sʲ
тапор	t a p o r
таран	t a r a n
тарашкевіца	t a r a ʂ kʲ e vʲ i t͡s a
тата	t a t a
таццяна	t a t͡sʲː a n a
таямніца	t a j a m nʲ i t͡s a
твар	t v a r
тварог	t v a r o x
твой	t v o j
творны	t v o r n ɨ
творчы	t v o r t͡ʂ ɨ
ткацтва	t k a t͡s t v a
тлумач	t ɫ u m a t͡ʂ
тлусты	t ɫ u s t ɨ
тлушч	t ɫ u ʂ t͡ʂ
тое	t o j e
той	t o j
токіа	t o kʲ i a
толькі	t o lʲ kʲ i
том	t o m
тонкі	t o n kʲ i
торт	t o r t
тоўсты	t o u̯ s t ɨ
трава	t r a v a
травень	t r a vʲ e nʲ
травеньскі	t r a vʲ e nʲ s kʲ i
традыцыя	t r a d ɨ t͡s ɨ j a
трактар	t r a k t a r
трактарыст	t r a k t a r ɨ s t
трактарыстка	t r a k t a r ɨ s t k a
трасянка	t r a sʲ a n k a
трое	t r o j e
трохвугольнік	t r o x v u ɣ o lʲ nʲ i k
труна	t r u n a
трус	t r u s
трусы	t r u s ɨ
труцень	t r u t͡sʲ e nʲ
тры	t r ɨ
трымаць	t r ɨ m a t͡sʲ
трынаццаты	t r ɨ n a t͡sː a t ɨ
трынаццаць	t r ɨ n a t͡sː a t͡sʲ
трыснёг	t r ɨ sʲ nʲ o x
трыста	t r ɨ s t a
трыццаць	t r ɨ t͡sː a t͡sʲ
трэсці	t r e sʲ t͡sʲ i
трэці	t r e t͡sʲ i
туалет	t u a lʲ e t
тугі	t u ɣʲ i
туды	t u d ɨ
туман	t u m a n
туніс	t u nʲ i s
тупы	t u p ɨ
турак	t u r a k
туркменскі	t u r k mʲ e n s kʲ i
туркменістан	t u r k mʲ e nʲ i s t a n
турма	t u r m a
турцыя	t u r t͡s ɨ j a
турчанка	t u r t͡ʂ a n k a
турэцкі	t u r e t͡s kʲ i
тут	t u t
тхор	t x o r
ты	t ɨ
тыгр	t ɨ ɣ r
тыдзень	t ɨ d͡zʲ e nʲ
тысяча	t ɨ sʲ a t͡ʂ a
тысячагоддзе	t ɨ sʲ a t͡ʂ a ɣ o d͡zʲː e
тытунь	t ɨ t u nʲ
тэатр	t e a t r
тэкст	t e k s t
тэлебачанне	t e lʲ e b a t͡ʂ a nʲː e
тэлевізар	t e lʲ e vʲ i z a r
тэлефон	t e lʲ e f o n
тэрмін	t e r mʲ i n
тэст	t e s t
тэстастэрон	t e s t a s t e r o n
тэсцікула	t e sʲ t͡sʲ i k u ɫ a
у	u
убачыць	u b a t͡ʂ ɨ t͡sʲ
увага	u v a ɣ a
увайсці	u v a j sʲ t͡sʲ i
уваходзіць	u v a x o d͡zʲ i t͡sʲ
уведаць	u vʲ e d a t͡sʲ
увесну	u vʲ e s n u
увосень	u v o sʲ e nʲ
угорскі	u ɣ o r s kʲ i
удараць	u d a r a t͡sʲ
ударыць	u d a r ɨ t͡sʲ
удзел	u d͡zʲ e ɫ
удзельнік	u d͡zʲ e lʲ nʲ i k
удзячны	u d͡zʲ a t͡ʂ n ɨ
ужо	u ʐ o
ужываць	u ʐ ɨ v a t͡sʲ
ужыць	u ʐ ɨ t͡sʲ
узбекскі	u zʲ bʲ e k s kʲ i
узбекістан	u zʲ bʲ e kʲ i s t a n
узнаўленне	u z n a u̯ lʲ e nʲː e
узровень	u z r o vʲ e nʲ
узрост	u z r o s t
узяць	u zʲ a t͡sʲ
узімку	u zʲ i m k u
уключаць	u k lʲ u t͡ʂ a t͡sʲ
украіна	u k r a j i n a
украінец	u k r a j i nʲ e t͡s
украінка	u k r a j i n k a
украінская	u k r a j i n s k a j a
украінскі	u k r a j i n s kʲ i
улада	u ɫ a d a
уладзімер	u ɫ a d͡zʲ i mʲ e r
уладзімір	u ɫ a d͡zʲ i mʲ i r
уладзіслаў	u ɫ a d͡zʲ i s ɫ a u̯
уласны	u ɫ a s n ɨ
улетку	u lʲ e t k u
улляна	u lʲː a n a
улонне	u ɫ o nʲː e
умець	u mʲ e t͡sʲ
умова	u m o v a
унук	u n u k
унутраны	u n u t r a n ɨ
унучка	u n u t͡ʂ k a
універмаг	u nʲ i vʲ e r m a x
універсітэт	u nʲ i vʲ e r sʲ i t e t
унікаць	u nʲ i k a t͡sʲ
унікнуць	u nʲ i k n u t͡sʲ
упарты	u p a r t ɨ
упасці	u p a sʲ t͡sʲ i
упершыню	u pʲ e r ʂ ɨ nʲ u
уплывовы	u p ɫ ɨ v o v ɨ
уплыў	u p ɫ ɨ u̯
упякаць	u pʲ a k a t͡sʲ
урад	u r a t
уражальны	u r a ʐ a lʲ n ɨ
уражанне	u r a ʐ a nʲː e
усе	u sʲ e
усеагульны	u sʲ e a ɣ u lʲ n ɨ
усмешка	u sʲ mʲ e ʂ k a
усміхацца	u sʲ mʲ i x a t͡sː a
усміхнуцца	u sʲ mʲ i x a t͡sː a
уставаць	u s t a v a t͡sʲ
устаць	u s t a t͡sʲ
усход	u s x o t
усходнеславянскі	u s x o d nʲ e s ɫ a vʲ a n s kʲ i
усходні	u s x o d nʲ i
усюды	u sʲ u d ɨ
усё	u sʲ o
усёмагутны	u sʲ o m a ɣ u t n ɨ
ухіляцца	u xʲ i lʲ a t͡sː a
ухіліцца	u xʲ i lʲ i t͡sː a
учора	u t͡ʂ o r a
учуць	u t͡ʂ u t͡sʲ
уявіць	u j a vʲ i t͡sʲ
уяўляць	u j a u̯ lʲ a t͡sʲ
фабрыка	f a b r ɨ k a
файна	f a j n a
файны	f a j n ɨ
факт	f a k t
фараон	f a r a o n
фарба	f a r b a
фарбаваць	f a r b a v a t͡sʲ
фартэпіяна	f a r t e pʲ i j a n a
фарэрскі	f a r e r s kʲ i
фатэль	f a t e lʲ
фах	f a x
федэрацыя	fʲ e d e r a t͡s ɨ j a
ферма	fʲ e r m a
форма	f o r m a
фосфар	f o s f a r
францужанка	f r a n t͡s u ʐ a n k a
француз	f r a n t͡s u s
французскі	f r a n t͡s u sː kʲ i
францыск	f r a n t͡s ɨ s k
францыя	f r a n t͡s ɨ j a
фрызскі	f r ɨ sː kʲ i
фургон	f u r ɣ o n
фурман	f u r m a n
фёдар	fʲ o d a r
фёкла	fʲ o k ɫ a
фізіка	fʲ i zʲ i k a
філасофія	fʲ i ɫ a s o fʲ i j a
фільм	fʲ i lʲ m
філіжанка	fʲ i lʲ i ʐ a n k a
філіп	fʲ i lʲ i p
фінвал	fʲ i n v a ɫ
фінляндыя	fʲ i n lʲ a n d ɨ j a
фінскі	fʲ i n s kʲ i
фінік	fʲ i nʲ i k
фірма	fʲ i r m a
фіялетавы	fʲ i j a lʲ e t a v ɨ
хава	x a v a
хадзіць	x a d͡zʲ i t͡sʲ
халадзільнік	x a ɫ a d͡zʲ i lʲ nʲ i k
халасцяк	x a ɫ a sʲ t͡sʲ a k
халодны	x a ɫ o d n ɨ
харват	x a r v a t
харватка	x a r v a t k a
харватыя	x a r v a t ɨ j a
харвацкі	x a r v a t͡s kʲ i
харобры	x a r o b r ɨ
хата	x a t a
хацець	x a t͡sʲ e t͡sʲ
хваля	x v a lʲ a
хвароба	x v a r o b a
хварэць	x v a r e t͡sʲ
хвораст	x v o r a s t
хворы	x v o r ɨ
хвост	x v o s t
хвіля	x vʲ i lʲ a
хвіліна	x vʲ i lʲ i n a
хлеб	x lʲ e p
хлеў	x lʲ e u̯
хлопец	x ɫ o pʲ e t͡s
хлусня	x ɫ u sʲ nʲ a
хмара	x m a r a
хобі	x o bʲ i
холад	x o ɫ a t
храм	x r a m
хрушч	x r u ʂ t͡ʂ
хрыстос	x r ɨ s t o s
хрысціянін	x r ɨ sʲ t͡sʲ i j a nʲ i n
хрэн	x r e n
хто	x t o
хтось	x t o sʲ
хтосьці	x t o sʲ t͡sʲ i
худы	x u d ɨ
хуй	x u j
хуйло	x u j ɫ o
хурма	x u r m a
хустка	x u s t k a
хуткі	x u t kʲ i
хіба	xʲ i b a
хімія	xʲ i mʲ i j a
хіндзі	xʲ i nʲ d͡zʲ i
хітры	xʲ i t r ɨ
цалаваць	t͡s a ɫ a v a t͡sʲ
цана	t͡s a n a
цар	t͡s a r
царква	t͡s a r k v a
царства	t͡s a r s t v a
царыца	t͡s a r ɨ t͡s a
цацка	t͡s a t͡s k a
цвет	t͡sʲ vʲ e t
цвярозы	t͡sʲ vʲ a r o z ɨ
цвёрды	t͡sʲ vʲ o r d ɨ
цвік	t͡sʲ vʲ i k
цвісці	t͡sʲ vʲ i sʲ t͡sʲ i
цела	t͡sʲ e ɫ a
целы	t͡sʲ e ɫ ɨ
цемя	t͡sʲ e mʲ a
цень	t͡sʲ e nʲ
церці	t͡sʲ e r t͡sʲ i
цесны	t͡sʲ e s n ɨ
цеста	t͡sʲ e s t a
цесць	t͡sʲ e sʲ t͡sʲ
цешча	t͡sʲ e ʂ t͡ʂ a
цнатлівы	t͡s n a t lʲ i v ɨ
цнота	t͡s n o t a
цуд	t͡s u t
цудоўны	t͡s u d o u̯ n ɨ
цукар	t͡s u k a r
цукерка	t͡s u kʲ e r k a
цыбуля	t͡s ɨ b u lʲ a
цыгарэта	t͡s ɨ ɣ a r e t a
цырк	t͡s ɨ r k
цырульня	t͡s ɨ r u lʲ nʲ a
цырульнік	t͡s ɨ r u lʲ nʲ i k
цырымонія	t͡s ɨ r ɨ m o nʲ i j a
цэлы	t͡s e ɫ ɨ
цэнтр	t͡s e n t r
цэсар	t͡s e s a r
цюлень	t͡sʲ u lʲ e nʲ
цягаць	t͡sʲ a ɣ a t͡sʲ
цягліца	t͡sʲ a ɣ lʲ i t͡s a
цягнуць	t͡sʲ a ɣ n u t͡sʲ
цягнік	t͡sʲ a ɣ nʲ i k
цяжар	t͡sʲ a ʐ a r
цяжарнасць	t͡sʲ a ʐ a r n a sʲ t͡sʲ
цяжарны	t͡sʲ a ʐ a r n ɨ
цяжкі	t͡sʲ a ʂ kʲ i
цяля	t͡sʲ a lʲ a
цямніца	t͡sʲ a m nʲ i t͡s a
цяпер	t͡sʲ a pʲ e r
цяпло	t͡sʲ a p ɫ o
цярплівы	t͡sʲ a r p lʲ i v ɨ
цясла	t͡sʲ a s ɫ a
цячы	t͡sʲ a t͡ʂ ɨ
цёмны	t͡sʲ o m n ɨ
цёплы	t͡sʲ o p ɫ ɨ
цётка	t͡sʲ o t k a
цёця	t͡sʲ o t͡sʲ a
ці	t͡sʲ i
цікавы	t͡sʲ i k a v ɨ
цімафей	t͡sʲ i m a fʲ e j
ціск	t͡sʲ i s k
ціха	t͡sʲ i x a
ціхан	t͡sʲ i x a n
ціханоўская	t͡sʲ i x a n o u̯ s k a j a
ціханоўскі	t͡sʲ i x a n o u̯ s kʲ i
ціхі	t͡sʲ i xʲ i
чай	t͡ʂ a j
чакаць	t͡ʂ a k a t͡sʲ
чалавек	t͡ʂ a ɫ a vʲ e k
чалавецтва	t͡ʂ a ɫ a vʲ e t͡s t v a
чалавечы	t͡ʂ a ɫ a vʲ e t͡ʂ ɨ
чало	t͡ʂ a ɫ o
чамадан	t͡ʂ a m a d a n
чаму	t͡ʂ a m u
чапля	t͡ʂ a p lʲ a
чаравік	t͡ʂ a r a vʲ i k
чарапаха	t͡ʂ a r a p a x a
чараўнік	t͡ʂ a r a u̯ nʲ i k
чарвяк	t͡ʂ a r vʲ a k
чарга	t͡ʂ a r ɣ a
чарнагорскі	t͡ʂ a r n a ɣ o r s kʲ i
чарнагорыя	t͡ʂ a r n a ɣ o r ɨ j a
чарніла	t͡ʂ a r nʲ i ɫ a
чаромха	t͡ʂ a r o m x a
чарот	t͡ʂ a r o t
чарпак	t͡ʂ a r p a k
чарціць	t͡ʂ a r t͡sʲ i t͡sʲ
чарэшня	t͡ʂ a r e ʂ nʲ a
час	t͡ʂ a s
часам	t͡ʂ a s a m
часнок	t͡ʂ a s n o k
часта	t͡ʂ a s t a
частка	t͡ʂ a s t k a
частковы	t͡ʂ a s t k o v ɨ
часты	t͡ʂ a s t ɨ
чатырнаццаты	t͡ʂ a t ɨ r n a t͡sː a t ɨ
чатырнаццаць	t͡ʂ a t ɨ r n a t͡sː a t͡sʲ
чатыры	t͡ʂ a t ɨ r ɨ
чатырыста	t͡ʂ a t ɨ r ɨ s t a
чацвер	t͡ʂ a t͡sʲ vʲ e r
чацвёра	t͡ʂ a t͡sʲ vʲ o r a
чацвёрты	t͡ʂ a t͡sʲ vʲ o r t ɨ
чацьвер	t͡ʂ a t͡sʲ vʲ e r
чаша	t͡ʂ a ʂ a
човен	t͡ʂ o vʲ e n
чорны	t͡ʂ o r n ɨ
чорт	t͡ʂ o r t
чужаземны	t͡ʂ u ʐ a zʲ e m n ɨ
чужы	t͡ʂ u ʐ ɨ
чутны	t͡ʂ u t n ɨ
чухаць	t͡ʂ u x a t͡sʲ
чуць	t͡ʂ u t͡sʲ
чыгунка	t͡ʂ ɨ ɣ u n k a
чый	t͡ʂ ɨ j
чырвоны	t͡ʂ ɨ r v o n ɨ
чысты	t͡ʂ ɨ s t ɨ
чысціць	t͡ʂ ɨ sʲ t͡sʲ i t͡sʲ
чытаць	t͡ʂ ɨ t a t͡sʲ
чэрава	t͡ʂ e r a v a
чэрап	t͡ʂ e r a p
чэрвень	t͡ʂ e r vʲ e nʲ
чэрвеньскі	t͡ʂ e r vʲ e nʲ s kʲ i
чэсць	t͡ʂ e sʲ t͡sʲ
чэх	t͡ʂ e x
чэхаславакія	t͡ʂ e x a s ɫ a v a kʲ i j a
чэхія	t͡ʂ e xʲ i j a
чэшка	t͡ʂ e ʂ k a
чэшскі	t͡ʂ e s kʲ i
чэшскі	t͡ʂ e sː kʲ i
ш	ʂ
шабля	ʂ a b lʲ a
шаг	ʂ a x
шакалад	ʂ a k a ɫ a t
шалом	ʂ a ɫ o m
шалёны	ʂ a lʲ o n ɨ
шалік	ʂ a lʲ i k
шаноўны	ʂ a n o u̯ n ɨ
шапка	ʂ a p k a
шарф	ʂ a r f
шаснаццаты	ʂ a s n a t͡sː a t ɨ
шаснаццаць	ʂ a s n a t͡sː a t͡sʲ
шасцёра	ʂ a sʲ t͡sʲ o r a
шатландскі	ʂ a t ɫ a n t s kʲ i
шатландыя	ʂ a t ɫ a n d ɨ j a
шахматы	ʂ a x m a t ɨ
шахматыст	ʂ a x m a t ɨ s t
шахматыстка	ʂ a x m a t ɨ s t k a
швагер	ʂ v a ɣʲ e r
шведскі	ʂ vʲ e t s kʲ i
швейцарыя	ʂ vʲ e j t͡s a r ɨ j a
швецыя	ʂ vʲ e t͡s ɨ j a
шкада	ʂ k a d a
шкадаваць	ʂ k a d a v a t͡sʲ
шкарпэтка	ʂ k a r p e t k a
шкатулка	ʂ k a t u ɫ k a
шкло	ʂ k ɫ o
шклянка	ʂ k lʲ a n k a
шкода	ʂ k o d a
шкоднасны	ʂ k o d n a s n ɨ
шкодны	ʂ k o d n ɨ
школа	ʂ k o ɫ a
шкілет	ʂ kʲ i lʲ e t
шлюб	ʂ lʲ u p
шлях	ʂ lʲ a x
шмат	ʂ m a t
шосты	ʂ o s t ɨ
шоўк	ʂ o u̯ k
шруба	ʂ r u b a
штаны	ʂ t a n ɨ
што	ʂ t o
штодзённы	ʂ t o d͡zʲ o nː ɨ
штось	ʂ t o sʲ
штосьці	ʂ t o sʲ t͡sʲ i
штурхаць	ʂ t u r x a t͡sʲ
шукальнік	ʂ u k a lʲ nʲ i k
шукаць	ʂ u k a t͡sʲ
шуфляда	ʂ u f lʲ a d a
шчака	ʂ t͡ʂ a k a
шчаслівы	ʂ t͡ʂ a sʲ lʲ i v ɨ
шчасце	ʂ t͡ʂ a sʲ t͡sʲ e
шчодры	ʂ t͡ʂ o d r ɨ
шчотка	ʂ t͡ʂ o t k a
шчыкалатка	ʂ t͡ʂ ɨ k a ɫ a t k a
шчыльны	ʂ t͡ʂ ɨ lʲ n ɨ
шчыры	ʂ t͡ʂ ɨ r ɨ
шчыт	ʂ t͡ʂ ɨ t
шчэцін	ʂ t͡ʂ e t͡sʲ i n
шыбеніца	ʂ ɨ bʲ e nʲ i t͡s a
шыльда	ʂ ɨ lʲ d a
шыр	ʂ ɨ r
шырата	ʂ ɨ r a t a
шырокі	ʂ ɨ r o kʲ i
шыць	ʂ ɨ t͡sʲ
шыя	ʂ ɨ j a
шэршань	ʂ e r ʂ a nʲ
шэры	ʂ e r ɨ
шэсць	ʂ e sʲ t͡sʲ
шэсцьдзесят	ʂ e z d͡zʲː e sʲ a t
шэсцьсот	ʂ e sʲ t͡sʲ s o t
ы	ɨ
эдуард	e d u a r t
эканоміка	e k a n o mʲ i k a
экран	e k r a n
эльзас	e lʲ z a s
эльзаскі	e lʲ z a s kʲ i
эліпс	e lʲ i p s
эпістэмалогія	e pʲ i s t e m a ɫ o ɣʲ i j a
эрэкцыя	e r e k t͡s ɨ j a
эстонец	e s t o nʲ e t͡s
эстонка	e s t o n k a
эстонскі	e s t o n s kʲ i
эстонія	e s t o nʲ i j a
этымалогія	e t ɨ m a ɫ o ɣʲ i j a
эякуляцыя	e j a k u lʲ a t͡s ɨ j a
юбілей	j u bʲ i lʲ e j
югаславія	j u ɣ a s ɫ a vʲ i j a
юлія	j u lʲ i j a
юны	j u n ɨ
юрый	j u r ɨ j
ябаць	j a b a t͡sʲ
яблык	j a b ɫ ɨ k
ягада	j a ɣ a d a
ягня	j a ɣ nʲ a
яго	j a ɣ o
ягоны	j a ɣ o n ɨ
ягор	j a ɣ o r
ядваб	j a d v a p
ядвіга	j a d vʲ i ɣ a
ядловец	j a d ɫ o vʲ e t͡s
яднаць	j a d n a t͡sʲ
ядраны	j a d r a n ɨ
яе	j a j e
яечка	j a j e t͡ʂ k a
язык	j a z ɨ k
яйка	j a j k a
яйцо	j a j t͡s o
як	j a k
якасны	j a k a s n ɨ
якасць	j a k a sʲ t͡sʲ
якаў	j a k a u̯
які	j a kʲ i
якісьці	j a kʲ i sʲ t͡sʲ i
ялта	j a ɫ t a
яліты	j a lʲ i t ɨ
яма	j a m a
ян	j a n
яна	j a n a
яно	j a n o
яны	j a n ɨ
японскі	j a p o n s kʲ i
японія	j a p o nʲ i j a
яраслаў	j a r a s ɫ a u̯
яркі	j a r kʲ i
ярмо	j a r m o
ясень	j a sʲ e nʲ
ясны	j a s n ɨ
ястраб	j a s t r a p
яфім	j a fʲ i m
ячмень	j a t͡ʂ mʲ e nʲ
яшчарка	j a ʂ t͡ʂ a r k a
яшчэ	j a ʂ t͡ʂ e
яўген	j a u̯ ɣʲ e n
яўгеній	j a u̯ ɣʲ e nʲ i j
яўгенія	j a u̯ ɣʲ e nʲ i j a
яўрэй	j a u̯ r e j
яўрэйскі	j a u̯ r e j s kʲ i
ё	j o
ёлка	j o ɫ k a
ён	j o n
ёсць	j o sʲ t͡sʲ
і	j i
іарданія	j i a r d a nʲ i j a
іван	j i v a n
іваноў	j i v a n o u̯
ігар	j i ɣ a r
ігла	j i ɣ ɫ a
ігнат	j i ɣ n a t
іголка	j i ɣ o ɫ k a
ігра	j i ɣ r a
іграць	j i ɣ r a t͡sʲ
ізраіль	j i z r a j i lʲ
ізраільскі	j i z r a j i lʲ s kʲ i
ілгаць	j i ɫ ɣ a t͡sʲ
ілья	j i lʲ j a
імбір	j i m bʲ i r
імгла	j i m ɣ ɫ a
імперыя	j i m pʲ e r ɨ j a
імя	j i mʲ a
інаўгурацыя	j i n a u̯ ɡ u r a t͡s ɨ j a
інаўгурацыя	j i n a u̯ ɣ u r a t͡s ɨ j a
інданезійскі	j i n d a nʲ e zʲ i j s kʲ i
інданезія	j i n d a nʲ e zʲ i j a
індыйскі	j i n d ɨ j s kʲ i
індыя	j i n d ɨ j a
інтэрв'ю	j i n t e r v j u
інтэрнат	j i n t e r n a t
інфармацыя	j i n f a r m a t͡s ɨ j a
інцэст	j i n t͡s e s t
іншаземец	j i n ʂ a zʲ e mʲ e t͡s
іншы	j i n ʂ ɨ
іосіф	j i o sʲ i f
ірак	j i r a k
іран	j i r a n
ірваць	j i r v a t͡sʲ
іржа	j i r ʐ a
іржавы	j i r ʐ a v ɨ
іржаць	j i r ʐ a t͡sʲ
іркуцк	j i r k u t͡s k
ірландзец	j i r ɫ a nʲ d͡zʲ e t͡s
ірландка	j i r ɫ a n t k a
ірландскі	j i r ɫ a n t s kʲ i
ірландыя	j i r ɫ a n d ɨ j a
ірына	j i r ɨ n a
ірэна	j i r e n a
іскра	j i s k r a
ісландскі	j i s ɫ a n t s kʲ i
ісландыя	j i s ɫ a n d ɨ j a
іспанскі	j i s p a n s kʲ i
іспанія	j i s p a nʲ i j a
істотны	j i s t o t n ɨ
ісус	j i s u s
ісці	j i sʲ t͡sʲ i
італьянец	j i t a lʲ j a nʲ e t͡s
італьянка	j i t a lʲ j a n k a
італьянскі	j i t a lʲ j a n s kʲ i
італія	j i t a lʲ i j a
іх	j i x
іхны	j i x n ɨ
ішак	j i ʂ a k
ўведаць	w vʲ e d a t͡sʲ
ўвесну	w vʲ e s n u
ўвосень	w v o sʲ e nʲ
ўдараць	w d a r a t͡sʲ
ўдарыць	w d a r ɨ t͡sʲ
ўжываць	w ʐ ɨ v a t͡sʲ
ўжыць	w ʐ ɨ t͡sʲ
ўзрост	w z r o s t
ўзяць	w zʲ a t͡sʲ
ўзімку	w zʲ i m k u
ўключаць	w k lʲ u t͡ʂ a t͡sʲ
ўладзімер	w ɫ a d͡zʲ i mʲ e r
ўладзіслаў	w ɫ a d͡zʲ i s ɫ a u̯
ўласны	w ɫ a s n ɨ
ўлетку	w lʲ e t k u
ўмець	w mʲ e t͡sʲ
ўнікаць	w nʲ i k a t͡sʲ
ўнікнуць	w nʲ i k n u t͡sʲ
ўплыў	w p ɫ ɨ u̯
ўставаць	w s t a v a t͡sʲ
ўстаць	w s t a t͡sʲ
ўсход	w s x o t
ўсходні	w s x o d nʲ i
ўхіляцца	w xʲ i lʲ a t͡sː a
ўхіліцца	w xʲ i lʲ i t͡sː a
ўчора	w t͡ʂ o r a
ўчуць	w t͡ʂ u t͡sʲ
ўэльс	w e lʲ s
ґанак	ɡ a n a k
