α	a
α	a
αβάνα	a v a n a
αβανγκάρντ	a v a ŋ ɡ a ɾ d
αβανγκαρντισμέ	a v a ŋ ɡ a ɾ d i z m e
αβανγκαρντισμό	a v a ŋ ɡ a ɾ d i z m o
αβανγκαρντισμοί	a v a ŋ ɡ a ɾ d i z m i
αβανγκαρντισμόσ	a v a ŋ ɡ a ɾ d i z m o s
αβανγκαρντισμού	a v a ŋ ɡ a ɾ d i z m u
αβανγκαρντισμούσ	a v a ŋ ɡ a ɾ d i z m u s
αβανγκαρντισμών	a v a ŋ ɡ a ɾ d i z m o n
αβάρα	a v a ɾ a
αβάραρα	a v a ɾ a ɾ a
αβάραρε	a v a ɾ a ɾ e
αβαράριζα	a v a ɾ a ɾ i z a
αβαράριζε	a v a ɾ a ɾ i z e
αβαράρισα	a v a ɾ a ɾ i s a
αβαράρισε	a v a ɾ a ɾ i s e
αβαράρω	a v a ɾ a ɾ o
αβασκαμένοσ	a v a s k a m e n o s
αβγατίζομαι	a v ɣ a t i z o m e
αβγατίζω	a v ɣ a t i z o
αβγάτισα	a v ɣ a t i s a
αβγατισμένα	a v ɣ a t i z m e n a
αβγατισμένε	a v ɣ a t i z m e n e
αβγατισμένεσ	a v ɣ a t i z m e n e s
αβγατισμένη	a v ɣ a t i z m e n i
αβγατισμένησ	a v ɣ a t i z m e n i s
αβγατισμένο	a v ɣ a t i z m e n o
αβγατισμένοι	a v ɣ a t i z m e n i
αβγατισμένοσ	a v ɣ a t i z m e n o s
αβγατισμένου	a v ɣ a t i z m e n u
αβγατισμένουσ	a v ɣ a t i z m e n u s
αβγατισμένων	a v ɣ a t i z m e n o n
αβγατίστηκα	a v ɣ a t i s t i k a
αβγό	a v ɣ o
αβγοθήκη	a v ɣ o θ i c i
αβγοκόβω	a v ɣ o k o v o
αβγοκομμένα	a v ɣ o k o m e n a
αβγοκομμένε	a v ɣ o k o m e n e
αβγοκομμένεσ	a v ɣ o k o m e n e s
αβγοκομμένη	a v ɣ o k o m e n i
αβγοκομμένησ	a v ɣ o k o m e n i s
αβγοκομμένο	a v ɣ o k o m e n o
αβγοκομμένοι	a v ɣ o k o m e n i
αβγοκομμένοσ	a v ɣ o k o m e n o s
αβγοκομμένου	a v ɣ o k o m e n u
αβγοκομμένουσ	a v ɣ o k o m e n u s
αβγοκομμένων	a v ɣ o k o m e n o n
αβγουλάκι	a v ɣ u l a c i
αβεβαίωσ	a v e v e o s
αβλαβέστεροσ	a v l a v e s t e r o s
αβλαβήσ	a v l a v i s
άβλαβοσ	a v l a v o s
άβλαπτοσ	a v l a p t o s
άβλαφτοσ	a v l a f t o s
αβουλησία	a v u l i s i a
αβουλησίασ	a v u l i s i a s
αβουλησίεσ	a v u l i s i e s
αβουλησιών	a v u l i s i o n
αβουλία	a v u l i a
αβούλιαχτοσ	a v u ʎ a x t o s
αβουλίεσ	a v u l i e s
αβουλιών	a v u l i o n
αβροδίαιτοσ	a v r o ð i e t o s
αγαθοπιστία	a ɣ a θ o p i s t i a
αγαθοπιστίασ	a ɣ a θ o p i s t i a s
αγαθοπιστίεσ	a ɣ a θ o p i s t i e s
αγαθοπιστιών	a ɣ a θ o p i s t i o n
αγάμητοσ	a ɣ a m i t o s
αγανάκτησα	a ɣ a n a k t i s a
αγανακτισμένα	a ɣ a n a k t i z m e n a
αγανακτισμένε	a ɣ a n a k t i z m e n e
αγανακτισμένεσ	a ɣ a n a k t i z m e n e s
αγανακτισμένη	a ɣ a n a k t i z m e n i
αγανακτισμένησ	a ɣ a n a k t i z m e n i s
αγανακτισμένο	a ɣ a n a k t i z m e n o
αγανακτισμένοι	a ɣ a n a k t i z m e n i
αγανακτισμένοσ	a ɣ a n a k t i z m e n o s
αγανακτισμένου	a ɣ a n a k t i z m e n u
αγανακτισμένουσ	a ɣ a n a k t i z m e n u s
αγανακτισμένων	a ɣ a n a k t i z m e n o n
αγανακτώ	a ɣ a n a k t o
αγανάχτησα	a ɣ a n a x t i s a
αγαναχτισμένοσ	a ɣ a n a x t i z m e n o s
αγαναχτώ	a ɣ a n a x t o
αγανόσ	a ɣ a n o s
αγάνταρα	a ɣ a n d a r a
αγάνταρε	a ɣ a n d a r e
αγαντάριζα	a ɣ a n d a r i z a
αγαντάριζε	a ɣ a n d a r i z e
αγαντάρισα	a ɣ a n d a r i s a
αγαντάρισε	a ɣ a n d a r i s e
αγανταρισμένοσ	a ɣ a n d a ɾ i z m e n o s
αγαντάρω	a ɣ a n d a ɾ o
αγάπαγα	a ɣ a p a ɣ a
αγαπάω	a ɣ a p a o
αγαπηθεί	a ɣ a p i θ i
αγαπήθηκα	a ɣ a p i θ i k a
αγαπημένα	a ɣ a p i m e n a
αγαπημένε	a ɣ a p i m e n e
αγαπημένεσ	a ɣ a p i m e n e s
αγαπημένη	a ɣ a p i m e n i
αγαπημένησ	a ɣ a p i m e n i s
αγαπημένο	a ɣ a p i m e n o
αγαπημένοι	a ɣ a p i m e n i
αγαπημένοσ	a ɣ a p i m e n o s
αγαπημένου	a ɣ a p i m e n u
αγαπημένουσ	a ɣ a p i m e n u s
αγαπημένων	a ɣ a p i m e n o n
αγάπησα	a ɣ a p i s a
αγαπήσει	a ɣ a p i s i
αγαπούσα	a ɣ a p u s a
αγαπώ	a ɣ a p o
αγγαρεμένοσ	a ŋ ɡ a ɾ e m e n o s
αγγαρεύομαι	a ŋ ɡ a ɾ e v o m e
αγγαρεύτηκα	a ŋ ɡ a ɾ e f t i k a
αγγαρεύω	a ŋ ɡ a ɾ e v o
αγγάρεψα	a ŋ ɡ a ɾ e p s a
αγγελιασμένοσ	a ŋ ɟ e ʎ a z m e n o s
αγγελμένοσ	a ŋ ɟ e l m e n o s
αγγελοκρούομαι	a ŋ ɟ e l o k r u o m e
αγγελοκρούομε	a ŋ ɟ e l o k r u o m e
αγγελοκρούουμε	a ŋ ɟ e l o k r u u m e
αγγελόκρουσα	a ŋ ɟ e l o k r u s a
αγγελοκρουσμένοσ	a ŋ ɟ e l o k ɾ u z m e n o s
αγγελοκρούστηκα	a ŋ ɟ e l o k r u s t i k a
αγγελοκρούω	a ŋ ɟ e l o k r u o
άγγελοσ	a ŋ ɟ e l o s
άγγελου	a ŋ ɟ e l u
αγγέλου	a ŋ ɟ e l u
αγγελούδι	a ŋ ɟ e l u ð i
αγγελούδια	a ŋ ɟ e l u ð ʝ a
αγγέλω	a ŋ ɟ e l o
αγγιγμένα	a ŋ ɟ i ɣ m e n a
αγγιγμένε	a ŋ ɟ i ɣ m e n e
αγγιγμένεσ	a ŋ ɟ i ɣ m e n e s
αγγιγμένη	a ŋ ɟ i ɣ m e n i
αγγιγμένησ	a ŋ ɟ i ɣ m e n i s
αγγιγμένο	a ŋ ɟ i ɣ m e n o
αγγιγμένοι	a ŋ ɟ i ɣ m e n i
αγγιγμένοσ	a ŋ ɟ i ɣ m e n o s
αγγιγμένου	a ŋ ɟ i ɣ m e n u
αγγιγμένουσ	a ŋ ɟ i ɣ m e n u s
αγγιγμένων	a ŋ ɟ i ɣ m e n o n
αγγίζομαι	a ŋ ɟ i z o m e
αγγίζομε	a ŋ ɟ i z o m e
αγγίζουμε	a ŋ ɟ i z u m e
αγγίζω	a ŋ ɟ i z o
άγγιξα	a ŋ ɟ i k s a
άγγισα	a ŋ ɟ i s a
αγγισμένα	a ŋ ɟ i z m e n a
αγγισμένε	a ŋ ɟ i z m e n e
αγγισμένεσ	a ŋ ɟ i z m e n e s
αγγισμένη	a ŋ ɟ i z m e n i
αγγισμένησ	a ŋ ɟ i z m e n i s
αγγισμένο	a ŋ ɟ i z m e n o
αγγισμένοι	a ŋ ɟ i z m e n i
αγγισμένοσ	a ŋ ɟ i z m e n o s
αγγισμένου	a ŋ ɟ i z m e n u
αγγισμένουσ	a ŋ ɟ i z m e n u s
αγγισμένων	a ŋ ɟ i z m e n o n
αγγίστηκα	a ŋ ɟ i s t i k a
αγγίχτηκα	a ŋ ɟ i x t i k a
αγγλία	a ŋ ɡ l i a
αγγλοποιήθηκα	a ŋ ɡ l o p i i θ i k a
αγγλοποιημένοσ	a ŋ ɡ l o p i i m e n o s
αγγλοποίησα	a ŋ ɡ l o p i i s a
αγγλοποιούμαι	a ŋ ɡ l o p i u m e
αγγλοποιούμε	a ŋ ɡ l o p i u m e
αγγόνι	a ŋ ɡ o n i
αγγόνια	a ŋ ɡ o ɲ a
αγγονιού	a ŋ ɡ o ɲ u
αγγονιών	a ŋ ɡ o ɲ o n
αγγούρι	a ŋ ɡ u ɾ i
αγγούρια	a ŋ ɡ u ɾ ʝ a
αγγουριά	a ŋ ɡ u ɾ ʝ a
αγγουριού	a ŋ ɡ u ɾ ʝ u
αγγουριών	a ŋ ɡ u ɾ ʝ o n
αγελάδα	a ʝ e l a ð a
αγένεια	a ʝ e n i a
αγένειοσ	a ʝ e n i o s
αγενήσ	a ʝ e n i s
άγια	a ʝ i a
αγία	a ʝ i a
αγία	a ʝ i a
αγιάγκαθο	a ʝ a ŋ ɡ a θ o
αγιάζομαι	a ʝ i a z o m e
αγιάζομαι	a ʝ a z o m e
αγιάζω	a ʝ i a z o
αγιάζω	a ʝ a z o
αγίασ	a ʝ i a s
αγίασ	a ʝ i a s
άγιασα	a ʝ a s a
αγίασα	a ʝ i a s a
αγιάσθηκα	a ʝ i a s θ i k a
αγιασματάρι	a ʝ a z m a t a r i
αγιασματάρια	a ʝ a z m a t a r ʝ a
αγιασματάρια	a ʝ a z m a t a r i a
αγιασματάριο	a ʝ a z m a t a r i o
αγιασμένοσ	a ʝ i a z m e n o s
αγιασμένοσ	a ʝ a z m e n o s
αγιάστηκα	a ʝ i a s t i k a
αγιάστηκα	a ʝ a s t i k a
αγιατολάχ	a ʝ a t o l a x
άγιε	a ʝ i e
άγιεσ	a ʝ i e s
άγιο	a ʝ i o
αγιογραφημένοσ	a ʝ i o ɣ ɾ a f i m e n o s
άγιοι	a ʝ i i
αγιοκέρι	a ʝ o c e r i
αγιοποιημένα	a ʝ i o p i i m e n a
αγιοποιημένε	a ʝ i o p i i m e n e
αγιοποιημένεσ	a ʝ i o p i i m e n e s
αγιοποιημένη	a ʝ i o p i i m e n i
αγιοποιημένησ	a ʝ i o p i i m e n i s
αγιοποιημένο	a ʝ i o p i i m e n o
αγιοποιημένοι	a ʝ i o p i i m e n i
αγιοποιημένοσ	a ʝ i o p i i m e n o s
ἁγιοποιημένοσ	a ʝ i o p i i m e n o s
αγιοποιημένου	a ʝ i o p i i m e n u
αγιοποιημένουσ	a ʝ i o p i i m e n u s
αγιοποιημένων	a ʝ i o p i i m e n o n
αγιοποιώ	a ʝ i o p i o
αγιοπούλι	a ʝ o p u l i
αγιοπούλια	a ʝ o p u ʎ a
αγιοπουλιού	a ʝ o p u ʎ u
αγιοπουλιών	a ʝ o p u ʎ o n
άγιοσ	a ʝ i o s
αγίου	a ʝ i u
αγίου	a ʝ i u
αγίουσ	a ʝ i u s
αγίουσ	a ʝ i u s
αγίων	a ʝ i o n
αγίων	a ʝ i o n
αγκαζάρισα	a ŋ ɡ a z a ɾ i s a
αγκαζαρισμένοσ	a ŋ ɡ a z a ɾ i z m e n o s
αγκαζαρίστηκα	a ŋ ɡ a z a ɾ i s t i k a
αγκαζάρομαι	a ŋ ɡ a z a ɾ o m e
αγκαζάρω	a ŋ ɡ a z a ɾ o
αγκαλιάζομαι	a ŋ ɡ a ʎ a z o m e
αγκαλιάζω	a ŋ ɡ a ʎ a z o
αγκάλιασα	a ŋ ɡ a ʎ a s a
αγκαλιασμένοσ	a ŋ ɡ a ʎ a z m e n o s
αγκαλιάστηκα	a ŋ ɡ a ʎ a s t i k a
αγκίδι	a ŋ ɟ i ð i
αγκίστρι	a ŋ ɟ i s t r i
άγκιστρο	a ŋ ɟ i s t r o
αγκιστρωμένοσ	a ŋ ɟ i s t ɾ o m e n o s
αγκιστρώνω	a ŋ ɟ i s t ɾ o n o
αγκύλι	a ŋ ɟ i l i
αγκύλια	a ŋ ɟ i ʎ a
αγκύλια	a ŋ ɟ i l i a
αγκύλιο	a ŋ ɟ i l i o
αγκυλίου	a ŋ ɟ i l i u
αγκυλιού	a ŋ ɟ i ʎ u
αγκυλίων	a ŋ ɟ i l i o n
αγκυλιών	a ŋ ɟ i ʎ o n
αγκυλώνω	a ŋ ɟ i l o n o
αγκυροβολημένοσ	a ŋ ɟ i ɾ o v o l i m e n o s
αγκωνάρι	a ŋ ɡ o n a r i
αγκωνιάζομαι	a ŋ ɡ o ɲ a z o m e
αγκωνιάζω	a ŋ ɡ o ɲ a z o
αγκώνιασα	a ŋ ɡ o ɲ a s a
αγκωνιάστηκα	a ŋ ɡ o ɲ a s t i k a
αγλάισμα	a ɣ l a i z m a
αγλαϊσμένοσ	a ɣ l a i z m e n o s
αγλαόσ	a ɣ l a o s
αγνάντευε	a ɣ n a n d e v e
αγναντεύω	a ɣ n a n d e v o
αγνάντεψα	a ɣ n a n d e p s a
αγνάντεψε	a ɣ n a n d e p s e
αγνάντιο	a ɣ n a n d ʝ o
αγνοημένοσ	a ɣ n o i m e n o s
αγνοούμενοσ	a ɣ n o u m e n o s
αγνώμονασ	a ɣ n o m o n a s
αγνωμοσύνη	a ɣ n o m o s i n i
αγνώμων	a ɣ n o m o n
άγνωροσ	a ɣ n o ɾ o s
αγόγγυστοσ	a ɣ o ŋ ɟ i s t o s
αγονία	a ɣ o n i a
αγορά	a ɣ o r a
ἀγορά	a ɣ o ɾ a
αγοράζομαι	a ɣ o ɾ a z o m e
αγοράζω	a ɣ o ɾ a z o
αγοράσ	a ɣ o r a s
αγόρασα	a ɣ o ɾ a s a
αγορασμένοσ	a ɣ o ɾ a z m e n o s
αγοράστηκα	a ɣ o ɾ a s t i k a
αγορέσ	a ɣ o r e s
αγορεύω	a ɣ o r e v o
αγόρι	a ɣ o r i
αγορών	a ɣ o r o n
άγραφοσ	a ɣ r a f o s
αγριεμένοσ	a ɣ ɾ i e m e n o s
αγριεύομαι	a ɣ ɾ i e v o m e
αγριεύτηκα	a ɣ ɾ i e f t i k a
αγριεύω	a ɣ ɾ i e v o
αγρίεψα	a ɣ ɾ i e p s a
αγρίνιο	a ɣ r i n i o
αγριοκοιταγμένοσ	a ɣ ɾ i o k i t a ɣ m e n o s
αγριοκοιτάζομαι	a ɣ ɾ i o c i t a z o m e
αγριοκοιτάζω	a ɣ ɾ i o c i t a z o
αγρόκτημα	a ɣ ɾ o k t i m a
αγρυπνισμένοσ	a ɣ ɾ i p n i z m e n o s
άγρωστη	a ɣ ɾ o s t i
αγυιά	a ʝ i a
αγυιόπαι	a ʝ i o p e
αγυιόπαιδα	a ʝ i o p e ð a
αγυιόπαιδασ	a ʝ i o p e ð a s
αγυιόπαιδεσ	a ʝ i o p e ð e s
αγυιόπαιδο	a ʝ i o p e ð o
αγυιόπαιδοσ	a ʝ i o p e ð o s
αγυιόπαιδου	a ʝ i o p e ð u
αγυιόπαιδων	a ʝ i o p e ð o n
αγυιοπαίδων	a ʝ i o p e ð o n
αγυιόπαισ	a ʝ i o p e s
αγύρτησ	a ʝ i ɾ t i s
αγχωμένοσ	a ŋ x o m e n o s
αγχώνομαι	a ŋ x o n o m e
αγχώνω	a ŋ x o n o
άγω	a ɣ o
αγωνία	a ɣ o n i a
αγωνίζομαι	a ɣ o n i z o m e
αγωνιζόμενοσ	a ɣ o n i z o m e n o s
αγωνιστέσ	a ɣ o n i s t e s
αγωνιστή	a ɣ o n i s t i
αγωνιστών	a ɣ o n i s t o n
αδειάζομαι	a ð ʝ a z o m e
αδειάζω	a ð ʝ a z o
αδειασμένοσ	a ð i̯ a z m e n o s
αδειασμένοσ	a ð ʝ a z m e n o s
αδειάστηκα	a ð ʝ a s t i k a
αδελφοκτονία	a ð e l f o k t o n i a
αδελφομάνα	a ð e l f o m a n a
αδελφωμένοσ	a ð e l f o m e n o s
άδενδροσ	a ð e n ð ɾ o s
άδεντροσ	a ð e n d ɾ o s
αδερφωμένοσ	a ð e ɾ f o m e n o s
αδημονούσα	a ð i m o n u s a
αδημονώ	a ð i m o n o
αδιευκρίνιστοσ	a ð i e f k ɾ i n i s t o s
άδικη	a ð i c i
αδικήθηκα	a ð i c i θ i k a
αδίκησα	a ð i c i s a
αδικιέμαι	a ð i c e m e
αδικούμαι	a ð i k u m e
ἀδικοῦμαι	a ð i k u m e
αδικούμε	a ð i k u m e
αδικώ	a ð i k o
ἀδικῶ	a ð i k o
αδρανήσ	a ð ɾ a n i s
αδρανοποιημένοσ	a ð r a n o p i i m e n o s
αδρεναλίνη	a ð ɾ e n a l i n i
αδρόσ	a ð r o s
αδυνατισμένοσ	a ð i n a t i z m e n o s
αδυνατώ	a ð i n a t o
άε	a e
αερίζομαι	a e ɾ i z o m e
αερίζω	a e ɾ i z o
αέρισα	a e ɾ i s a
αερίστηκα	a e ɾ i s t i k a
αεροβίωση	a e ɾ o v i o s i
αεροδρόμιο	a e ɾ o ð ɾ o m i o
αερολιμένασ	a e r o l i m e n a s
αερόμετρο	a e ɾ o m e t ɾ o
αεροπλανοφόρον	a e ɾ o p l a n o f o ɾ o n
αεροφωτογραφήθηκα	a e r o f o t o ɣ r a f i θ i k a
αεροφωτογράφησα	a e ɾ o f o t o ɣ ɾ a f i s a
αεροφωτογραφήσεισ	a e r o f o t o ɣ r a f i s i s
αεροφωτογραφία	a e r o f o t o ɣ r a f i a
αεροφωτογραφίζομαι	a e r o f o t o ɣ r a f i z o m e
αεροφωτογραφίζομε	a e r o f o t o ɣ r a f i z o m e
αεροφωτογραφίζουμε	a e r o f o t o ɣ r a f i z u m e
αεροφωτογραφίζω	a e r o f o t o ɣ r a f i z o
αεροφωτογράφισα	a e r o f o t o ɣ r a f i s a
αεροφωτογραφίσεισ	a e r o f o t o ɣ r a f i s i s
αεροφωτογραφίστηκα	a e r o f o t o ɣ r a f i s t i k a
αεροφωτογραφούμαι	a e r o f o t o ɣ r a f u m e
αεροφωτογραφούμε	a e r o f o t o ɣ r a f u m e
αεροφωτογραφώ	a e r o f o t o ɣ r a f o
αετιδεύσ	a e t i ð e f s
αηδήσ	a i ð i s
αηδία	a i ð i a
αηδιάζω	a i ð i a z o
αηδιασμένα	a i ð i a z m e n a
αηδιασμένε	a i ð i a z m e n e
αηδιασμένεσ	a i ð i a z m e n e s
αηδιασμένη	a i ð i a z m e n i
αηδιασμένησ	a i ð i a z m e n i s
αηδιασμένο	a i ð i a z m e n o
αηδιασμένοι	a i ð i a z m e n i
αηδιασμένοσ	a i ð i a z m e n o s
αηδιασμένου	a i ð i a z m e n u
αηδιασμένουσ	a i ð i a z m e n u s
αηδιασμένων	a i ð i a z m e n o n
αηδιαστικά	a i ð ʝ a s t i k a
αηδιαστική	a i ð ʝ a s t i c i
αηδιαστικοί	a i ð ʝ a s t i c i
αηδιαστικόσ	a i ð ʝ a s t i k o s
αηδώσ	a i ð o s
αήθησ	a i θ i s
άηχοσ	a i x o s
αθανασάκειοσ	a θ a n a s a c i o s
άθαφτοσ	a θ a f t o s
αθεϊσμέ	a θ e i z m e
αθεϊσμό	a θ e i z m o
αθεϊσμοί	a θ e i z m i
αθεϊσμόσ	a θ e i z m o s
αθεϊσμού	a θ e i z m u
αθεϊσμούσ	a θ e i z m u s