aapasse	ɑː p ɑ s ə
bröötle	b r œː t l ə
bärn	p æ̞ː r n
chranket	x r ɑ ŋ k x ə t
chuchi	x u x i
droogehändler	d r oː ɡ ə h æ n d l ə r
ee	e ə
gli	ɡ l i
go	ɡ o
go	ɡ ɔ
go	ɡ oː
go	ɡ ɔː
ich	ɪː x
liib	l iː b
liibli	l iː b l i
morge	m o r ɡ ə
mues	m u ə s
müese	m y ə s ə
müesli	m y ə s l i
nää	n ɛː
ruusche	r uː ʃː ə
schaffe	ʃ a f ə
sou	z o ʊ
tüür	t ʏː r
wiiss	v iː sː
ziil	t s ɪː l
öppis	ø pː i s
