aach	ɔː x
aadler	ɔː t l ɐ
aam	ɔː m
aan	ɔː n
aananner	ɔː n a n ɐ
aanannerbappe	ɔː n a n ɐ p a p ə
aanannerbinne	ɔː n a n ɐ p i n ə
aanannergehn	ɔː n a n ɐ k eː n
aanbacke	ɔː n p a k ə
aanbappe	ɔː n p a p ə
aanbasse	ɔː n p a s ə
aanbiede	ɔː n p iː r ə
aanfang	ɔː n f a ŋ
aanfank	aː n f a ŋ k
aanfenger	ɔː n f ɛ ŋ ɐ
aanstreiche	ɔː n ʃ t r a ɪ̯ ç ə
aanstrengung	ɔː n ʃ t r ɛ ŋ u ŋ
aanung	ɔː n u ŋ
aanzugh	ɔː n t͡s uː ç
aapehoer	ɔː p ə h oː ɐ
aarem	ɔː r m̩
aarmel	ɔː r m l̩
aarmut	ɔː r m uː t
aarsch	ɔː ʃ
aarschback	ɔː ʃ p a k
aarschdaarem	ɔː ʃ t ɔː r m̩
aarschdäärem	ɔː ʃ t ɛː r m̩
aarschloch	ɔː ʃ l o x
aart	ɔː t
aarvet	ɔː r v ə t
aarveter	ɔː r v ə t ɐ
abakaschi	a p a k a ʃ i
abakatt	a p a k a t
abakattebaam	a p a k a t ə p ɔː m
acht	a x t
achtzen	a x͡t s n̩
aff	a f
arschentina	a r ʃ n̩ t iː n a
astre	a ʃ t r ə
au	a ʊ̯
aue	a ʊ̯ ə
aussihn	a ʊ̯ s s iː n
australje	a ʊ̯ ʃ t r a l j ə
auto	a ʊ̯ t o
aviong	a v i ɔ ŋ
awer	a v ə ɾ
awer	a w ɐ
baad	p ɔː t
baade	p ɔː r ə
baadezimmer	p ɔː r ə͡t s i m ɐ
baam	p ɔː m
baart	p ɔː t
banann	p a n a n
beeder	p eː r ɐ
been	p eː n
beer	p eː ɐ
beise	p a ɪ̯ s ə
belche	p e l ç ə
benutze	p ə n u͡t s ə
berrich	p ɛ r i ç
blaat	p l ɔː t
blau	p l a ʊ̯
bleive	p l a ɪ̯ v ə
blumm	p l u m
boddem	p o r m̩
bohn	p oː n
bolasch	p o l a ʃ
boot	p oː t
bopp	p o p
brasil	p r a s i l
braun	p r a ʊ̯ n
brenne	p r ɛ n ə
brick	p r i l
brieh	b r iː
brille	p r i l ə
brod	p r oː t
bruch	p r u x
brumme	p r u m ə
brunne	p r u n ə
brust	p r u ʃ t
bub	p uː p
buch	p u x
buger	p uː k ɐ
butter	p u t ɐ
bäer	p ɛː ɐ
bërinschela	p e r i n ʃ e l a
casal	k a s a l
china	ʃ iː n a
daa	t ɔː
daab	t ɔː p
daabheet	t ɔː p h eː t
daabheit	t ɔː p h a ɪ̯ t
daaf	t ɔː f
daafe	t ɔː f ə
daafel	t ɔː f l̩
daagh	t ɔː x
daaghs	t ɔː x s
daal	t ɔː l
daarem	t ɔː r m̩
dach	t a x
dachs	t a k s
damm	t a m
damp	t a m p
dank	t a ŋ k
danke	t a ŋ k ə
dann	t a n
das	t a s
daume	t a ʊ̯ m ə
de	t ə
deer	t eː ɐ
dein	t a ɪ̯ n
deitsch	t a ɪ̯͡t ʃ
deitschland	t a ɪ̯͡t ʃ l a n t
deivel	t a ɪ̯ v l̩
denne	t ɛ n ə
der	t ɐ
dich	t i ç
die	t iː
dier	t iː ɐ
disch	t i ʃ
do	t oː
dod	t oː t
dorrich	t ɔ ɾ ɪ ç
draum	t r a ʊ̯ m
dreen	t r eː n
drehe	t r eː ə
drei	t r a ɪ̯
dreive	t r a ɪ̯ v ə
dreizen	t r a ɪ̯͡t s n̩
drinke	t r i ŋ k ə
drock	t r o k
du	t uː
du	t ə
dulle	t u l ə
dun	t oː n
dun	t uː n
där	t ɛː
eel	eː l
een	eː n
eer	eː ɐ
eesterreich	eː ʃ t ə r a i ç
eher	eː ɐ
eherlich	eː ɐ l i ç
eherlichkeet	eː ɐ l i ç kʰ eː t
eherlichkeit	eː ɐ l i ç kʰ a ɪ̯ t
eich	a ɪ̯ ç
ellef	e l ə f
en	eː n
en	n̩
enn	ɛ n
ennre	ɛ n r ə
enstatt	n̩ ʃ t a t
eppel	e p l̩
er	ɛ ɐ
erreb	ɛ r ə p
es	ə s , e s
esse	e s ə
faan	f ɔː n
faare	f ɔː r ə
faarichsjoher	f ɔː r i ç s j oː ɐ
fabrick	f a p r i k
fatter	f a t ɐ
faul	f a ʊ̯ l
faust	f a ʊ̯ ʃ t
fayer	f a j ə ɾ
februa	f eː p r u aː
feier	f a ɪ̯ ɐ
feilche	f a ɪ̯ l ç ə
feind	f a ɪ̯ n t
fenster	f ɛ n ʃ t ɐ
ferbasse	f ɐ p a s ə
ferzen	f ɛ͡t s n̩
fest	f e ʃ t
fier	f iː ɐ
finger	f i ŋ ɐ
finnef	f i n ə f
finnefzen	f i n ə f͡t s n̩
fisch	f i ʃ
fluss	f l u s
foghel	f oː x l̩
forreb	f ɔ r ə b
fraa	f r ɔː
frankreich	f r a ŋ k r a ɪ̯ ç
franzeesisch	f r a n͡t s eː s i ʃ
freind	f r a ɪ̯ n t
fresse	f r e s ə
frihling	f r iː l i ŋ
froh	f r oː
frohe	f r oː ə
froynt	f ɾ ɔ j n t
fufzen	f u f͡t s n̩
fusball	f uː s p a l
gaarte	k ɔː t ə
gaul	k a ʊ̯ l
gedrenk	k ə t r ɛ ŋ k
geel	k eː l
gehn	k eː n
geld	k e l t
gelechenheet	k ə l e ç n̩ h eː t
gelleb	k e l ə p
gellebrieb	k e l ə p r iː p
gemies	k ə m iː s
gern	k ɛ n
gescherr	k ə ʃ ɛ r
gesetzlich	k ə s e t͡s l i ç
gesicht	k ə s i ç t
gester	k e ʃ t ɐ
gesund	k ə s u n t
gesundheet	k ə s u n t h eː t
gesundheit	k ə s u n t h a ɪ̯ t
gift	k i f t
glaas	k l ɔː s
glaave	k l ɔː v ə
glick	k l i k
glicklich	k l i k l i ç
goiaab	k o j aː p
goiaab	k o j ɔː p
gold	k o l t
gott	k ɔ t
graas	k r ɔː s
grau	k r a ʊ̯
griecheland	k r iː ç ə l a n d
grien	k r iː n
gros	k r oː s
grummbeer	k r u m p eː ɐ
grund	k r u n t
haan	h ɔː n
hand	h a n t
hauptstatt	h a u p t ʃ t a t
haus	h a ʊ̯ s
haut	h a ʊ̯ t
hehl	h eː l
heilich	h a ɪ̯ l i ç
heit	h a ɪ̯ t
hellblau	h ɛ l p l a ʊ̯
hellfe	h e l f ə
hellgrien	h e l k r iː n
hemm	h ɛ m
herr	h ɛ r
herrebst	h ɛ r ə p ʃ t
herz	h ɛ͡t s
hesslich	h e s l i ç
hex	h e k s
hexenacht	h e k s ə n a x t
hie	h iː
hier	h iː ɐ
himd	h i m t
himmel	h i m l̩
hochtsayt	h ɔ x t s a j t
hon	h ɔ n
hoss	h o s
hund	h u n t
hunsrickisch	h u n s r i k i ʃ
ich	i ç
ihm	iː m
ihn	iː n
ihns	iː n s
immer	i m ɐ
insel	i n s l̩
internet	i n t ɐ n e t
italje	i t a l j ə
januar	j aː n u aː
joher	j oː ɐ
johreszeid	j oː r ə s͡t s a ɪ̯ t
kamiong	k h a m i ɔ ŋ
kamm	kʰ a m
kamp	kʰ a m p
kanal	kʰ a n a l
kanale	kʰ a n a l ə
kanon	kʰ a n oː n
kanone	kʰ a n oː n ə
kapital	kʰ a p i t aː l
kapitel	kʰ a p i t l̩
kapsel	kʰ a p s l̩
kapsle	kʰ a p s l ə
karette	kʰ a r e t ə
karre	kʰ a r ə
kartoffel	kʰ a t o f l̩
kaste	kʰ a ʃ t ə
katz	kʰ a͡t s
katze	kʰ a t͡s ə
kaue	kʰ a ʊ̯ ə
kaul	k a ʊ̯ l
kech	k e x
keefer	kʰ eː f ɐ
keen	kʰ eː n
keenich	kʰ eː n i ç
keenichin	kʰ eː n i ç i n
kees	kʰ eː s
keim	kʰ a ɪ̯ m
keime	kʰ a ɪ̯ m ə
keller	kʰ e l ɐ
kellich	kʰ e l i ç
kelt	kʰ e l t
kemme	kʰ ɛ m ə
kenne	kʰ ɛ n ə
kepp	kʰ e p
kerl	kʰ ɛ l
kerle	kʰ ɛ l ə
kern	kʰ ɛ n
kerne	kʰ ɛ n ə
kerner	kʰ ɛ n ɐ
kerrich	kʰ ɛ r i ç
kerze	kʰ ɛ t͡s ə
kessel	kʰ e s l̩
kessle	kʰ e s l ə
kett	kʰ e t
kette	kʰ e t ə
kich	kʰ i ç
kiche	kʰ i ç ə
kiel	kʰ iː l
kiele	kʰ iː l ə
kih	kʰ iː
kilogramm	kʰ i l o k r a m
kilometer	kʰ i l o m eː t ɐ
kind	kʰ i n t
kinn	kʰ i n
kinner	kʰ i n ɐ
kiss	kʰ i s
kisse	kʰ i s ə
kist	kʰ i ʃ t
kiste	kʰ i ʃ t ə
kittel	kʰ i t l̩
kitzle	kʰ i t͡s l ə
klamm	k l a m
klamme	k l a m ə
klang	k l a ŋ
klappre	k l a p r ə
klarinett	k l a r i n e t
klarinette	k l a r i n e t ə
klass	k l a s
klasse	k l a s ə
klatsche	k l a t͡ʃ ə
kleen	k l eː n
kleiderschrank	k l a ɪ̯ r ɐ ʃ r a ŋ k
klemme	k l ɛ m ə
kleng	k l e ŋ
kles	k l eː s
klettre	k l e t r ə
klingel	k l i ŋ l̩
kloppe	k l o p ə
klos	k l oː s
knall	k n a l
knapp	k n a p
knaps	k n a p s
knecht	k n e ç t
knepp	k n e p
kneppe	k n e p ə
knie	k n iː
knipp	kʰ n i p
knippe	k n i p ə
knoche	k n o x ə
knopp	k n o p
knupp	kʰ n u p
koch	k o x
koche	kʰ o x ə
koffer	kʰ o f ɐ
kohl	kʰ oː l
kohle	kʰ oː l ə
kokes	kʰ oː k ə s
kolonie	kʰ o l o n iː
komisch	kʰ oː m i ʃ
komme	kʰ ɔ m ə
kommunion	kʰ o m u n i̯ oː n
kommunione	kʰ o m u n i̯ oː n ə
komputatoer	k o m p u t a t oː ɐ
konferenz	kʰ o n f ə r ɛ n t͡s
konferenze	kʰ o n f ə r ɛ n t͡s ə
konfus	k o n f uː s
konkurrenz	kʰ o ŋ k u r ɛ n t͡s
konkurrenze	kʰ o ŋ k u r ɛ n t͡s ə
konsumiere	kʰ o n s u m iː r ə
kontinent	kʰ o n t i n ɛ n t
kontinente	kʰ o n t i n ɛ n t ə
konto	kʰ o n t o
kopp	kʰ o p
korn	kʰ ɔ n
korreb	kʰ ɔ r ə p
korst	kʰ ɔ ʃ t
korste	kʰ ɔ ʃ t ə
korz	kʰ ɔ t͡s
koste	kʰ o ʃ t ə
kot	k ɔ t
kotze	kʰ o t͡s ə
kraan	k r ɔː n
krach	k r a x
krache	k r a x ə
kraft	k r a f t
krall	k r a l
kralle	k r a l ə
kramm	k r a m
krank	k r a ŋ k
kranz	k r a n s
kranz	k r a n t͡s
kratze	k r a t͡s ə
kraule	k r a ʊ̯ l ə
kraut	k r a ʊ̯ t
kravatt	k r a v a t
krebs	k r e p s
krech	k r e x
krees	k r eː s
kreft	k r e f t
kreh	k r eː
kreische	k r a ɪ̯ ʃ ə
krem	k r eː m
kreme	k r eː m ə
kremp	k r ɛ m p
krempe	k r ɛ m p ə
krepp	k r e p
kress	k r e s
kresse	k r e s ə
kriegh	k r iː ç
kriich	k ɾ iː x
kripp	k r i p
krippe	k r i p ə
krist	k r i ʃ t
kristall	k r i ʃ t a l
kristalle	k r i ʃ t a l ə
kritisch	k r iː t i ʃ
kritisiere	k r i t i s iː r ə
krokodill	k ɾ o k o t i l
kron	k r oː n
krone	k r oː n ə
kropp	k r o p
kuh	kʰ uː
kuhmist	kʰ uː m i ʃ t
kuhstall	kʰ uː ʃ t a l
kulture	kʰ u l t uː r ə
kump	kʰ u m p
kumplett	kʰ u m p l e t
kunst	kʰ u n ʃ t
kupper	kʰ u p ɐ
kurve	kʰ u r v ə
kuss	kʰ u s
kuvert	kʰ u v ɛ t
laab	l ɔː p
laade	l ɔː r ə
laafe	l ɔː f ə
laam	l ɔː m
lache	l a x ə
lamm	l a m
lamp	l a m p
lampe	l a m p ə
land	l a n t
lande	l a n t ə
landkaart	l a n t kʰ ɔː t
lang	l a ŋ
lanz	l a n s
lanz	l a n t͡s
lasse	l a s ə
latein	l a t a ɪ̯ n
lateinisch	l a t a ɪ̯ n i ʃ
laterne	l a t ɛ n ə
laus	l a ʊ̯ s
laut	l a ʊ̯ t
lecher	l e x ɐ
lechle	l e ç l ə
lecke	l e k ə
leeb	l eː p
leed	l eː t
leef	l eː f
leefer	l eː f ɐ
leen	l eː n
leer	l eː ɐ
leere	l eː r ə
leerer	l eː r ɐ
leffel	l e f l̩
lehe	l eː ə
lehm	l eː m
lehn	l eː n
lehne	l eː n ə
leib	l a ɪ̯ p
leicht	l a ɪ̯ ç t
leide	l a ɪ̯ r ə
leider	l a ɪ̯ t ɐ
leie	l a ɪ̯ ə
lein	l a ɪ̯ n
leine	l a ɪ̯ n ə
leis	l a ɪ̯ s
leist	l a ɪ̯ ʃ t
leiste	l a ɪ̯ ʃ t ə
leit	l a ɪ̯ t
leng	l ɛ ŋ
lenge	l ɛ ŋ ə
lengst	l ɛ ŋ ʃ t
lenke	l ɛ ŋ k ə
lenner	l e n ɐ
lerne	l ɛ n ə
lese	l eː s ə
leser	l eː s ɐ
letter	l e t ɐ
leve	l eː v ə
levendich	l eː v n̩ t i ç
lewer	l e v ɐ
licht	l i ç t
licht	l ɪ x t
lichter	l i ç t ɐ
lieb	l iː b
lied	l iː d
lieh	l iː
liehe	l iː ə
lieve	l iː v ə
lift	l i f t
lilje	l i l j ə
linje	l i n j ə
lins	l i n s
linse	l i n s ə
lipp	l i p
lippe	l i p ə
list	l i ʃ t
liste	l i ʃ t ə
litter	l i t ɐ
loch	l o x
lockre	l o k r ə
lohn	l oː n
lohne	l oː n ə
loja	l oː ʃ a
lojas	l oː ʃ a s
losse	l o s ə
lotterie	l o t e r iː
love	l oː v ə
luchs	l u k s
luft	l u f t
luftschiff	l u f t ʃ i f
lumpe	l u m p ə
lung	l u ŋ
lunge	l u ŋ ə
lupp	l u p
lust	l u ʃ t
lutsche	l u t͡ʃ ə
lutscher	l u t͡ʃ ɐ
luxemborrich	l u k s m̩ p ɔ r i ç
lämmer	l ɛ m ɐ
maai	m ɔː i
maale	m ɔː l ə
mache	m a x ə
macher	m a x ɐ
malaria	m a l aː r i a
malve	m a l v ə
mamma	m a m a
manga	m a ŋ k a
maniok	m a n i oː k
mann	m a n
mantel	m a n t l̩
margarin	m a r k a r iː n
masch	m a ʃ
maschin	m a ʃ iː n
maschine	m a ʃ iː n ə
mask	m a ʃ k
maske	m a ʃ k ə
mass	m a s
masse	m a s ə
massiv	m a s iː f
matematik	m a t e m a t iː k
material	m a t e r i aː l
materiale	m a t e r i aː l ə
matratze	m a t r a t͡s ə
matriculas	m a t r i k u l a s
matsch	m a t͡ʃ
matt	m a t
matte	m a t ə
mauer	m a ʊ̯ ɐ
maul	m a ʊ̯ l
maure	m a ʊ̯ r ə
maurer	m a ʊ̯ r ɐ
maus	m a ʊ̯ s
med	m eː t
mede	m eː r ə
medizin	m e t i t͡s iː n
meel	m eː l
meen	m eː n
meer	m eː ɐ
meergrien	m eː ɐ k r iː n
meiler	m a ɪ̯ l ɐ
mein	m a ɪ̯ n
meis	m a ɪ̯ s
meister	m a ɪ̯ ʃ t ɐ
melke	m e l k ə
menner	m ɛ n ɐ
mennlich	m æ n l i ç
mensch	m ɛ n ʃ
menschlich	m ɛ n ʃ l i ç
mentel	m e n t l̩
menz	m ɛ n s
menz	m ɛ n t͡s
mer	m ɐ
merz	m ɛ͡t s
messdiener	m e s t iː n a
messe	m e s ə
messer	m e s ɐ
meter	m eː t ɐ
mich	m ɪ ç
mick	m i k
micke	m i k ə
mied	m iː t
miete	m iː t ə
mih	m iː
mihe	m iː ə
mihl	m iː l
mikrofon	m i k r o f oː n
milje	m i l j ə
miller	m i l ɐ
millich	m i l i ç
millichflasch	m i l i ç f l a ʃ
millimeter	m i l i m eː t ɐ
million	m i l i̯ oː n
millione	m i l i̯ oː n ə
mils	m i l s
milse	m i l s ə
mineral	m i n ə r aː l
mineralwasser	m i n ə r aː l v a s ɐ
minister	m i n i ʃ t ɐ
minutt	m i n u t
misse	m i s ə
mission	m i s i̯ oː n
missione	m i s i̯ oː n ə
mist	m i ʃ t
mit	m i t
mitbringe	m i t p ɾ i ŋ ə
mitglied	m i t k l iː t
mitkomme	m i t kʰ ɔ m ə
mitmache	m i t m a x ə
mitsinge	m i t s i ŋ ə
mitspiele	m i t ʃ p iː l ə
mittach	m i t a x
mitte	m i t ə
mittelfinger	m i t l̩ f i ŋ ɐ
mitter	m i t ɐ
mittwoch	m i t v o x
mitz	m i t͡s
modern	m o t ɛ n
moie	m o ɪ̯ ə
mol	m oː
mol	m oː l
momente	m o m ɛ n t ə
monarkie	m o n a r k iː
monat	m oː n a t
monate	m oː n a t ə
monatlich	m oː n a t l i ç
mond	m oː n t
monde	m oː n t ə
mone	m oː n ə
montach	m oː n t a x
moos	m oː s
mos	m oː s
mote	m oː t ə
motze	m o t͡s ə
moviment	m o v i m ɛ n t
mul	m uː l
mund	m u n t
munde	m u n t ə
munizipp	m u n i t͡s i p
munizippal	m u n i t͡s i p aː l
munter	m u n t ɐ
muschel	m u ʃ l̩
muskel	m u ʃ k l̩
muskitt	m u ʃ k i t
muster	m u ʃ t ɐ
mut	m uː t
mutter	m u t ɐ
mëtall	m e t a l
naacht	n aː x t
naaghel	n ɔː x l̩
naame	n ɔː m e
naas	n ɔː s
naast	n ɔː ʃ t
nacht	n a x t
nackich	n a k i ç
nass	n a s
nativ	n a t iː f
natuer	n a tʰ uː ɐ
naus	n a ʊ̯ s
nawel	n a ʊ̯ l̩
nazi	n a ː͡t s i
nazion	n a t͡s i̯ oː n
nazione	n a t͡s i̯ oː n ə
nazisdisch	n a͡t s i s t i ʃ
nazismus	n a͡t s i s m u s
necht	n e ç t
ned	n eː t
nedich	n eː r i ç
nee	n eː
neere	n eː r ə
neh	n eː
nehe	n eː ə
neher	n eː ɐ
nei	n a ɪ̯
neid	n a ɪ̯ t
nein	n a ɪ̯ n
neint	n a ɪ̯ n t
neinzen	n a ɪ̯ n͡t s n̩
neinzich	n a ɪ̯ n t͡s i ç
nemme	n ɛ m ə
nenne	n ɛ n ə
neongrien	n eː ɔ n k r iː n
nest	n e ʃ t
net	n e t
netz	n e t͡s
newel	n e v l̩
nichter	n i ç t ɐ
nickel	n i k l̩
nie	n iː
nier	n iː ɐ
niere	n iː r ə
niese	n iː s ə
nin	n i n
niss	n i s
nist	n i ʃ t
nister	n i ʃ t ɐ
nitter	n i t ɐ
nitterlande	n i t ɐ l a n t ə
noch	n o x
nochber	n o x p a
nod	n oː t
nodwennich	n oː t v ɛ n i ç
nommol	n ɔ m oː
nommol	n ɔ m oː l
norde	n ɔ t ə
nore	n oː r ə
normal	n o r m aː l
not	n oː t
note	n oː t ə
notel	n oː t l̩
nuff	n u f
null	n u l
nummer	n u m ɐ
nunner	n u n ɐ
nuss	n u s
nutel	n uː t l̩
nutze	n u t͡s ə
obwohl	oː p v oː l
ochs	o k s
ochse	o k s ə
odder	o r ɐ
oder	oː r ɐ
oft	o f t
ohne	oː n ə
ohre	oː r ə
omelett	o m e l e t
onkel	ɔ ŋ k l̩
onnibus	ɔ n i p u s
ool	oː l
oostre	oː ʃ t r ə
ooze	oː t͡s ə
opfer	o p f ɐ
opfre	o p f r ə
orde	ɔ t ə
ordne	ɔ t n ə
ordnung	ɔ t n u ŋ
oste	o ʃ t ə
ove	oː v ə
ovend	oː m t
ovend	oː v n̩ t
paar	pʰ ɔː
packe	pʰ a k ə
paliasse	pʰ a l i̯ a s ə
palme	pʰ a l m ə
pann	pʰ a n
panne	pʰ a n ə
panz	pʰ a n s
panz	pʰ a n t͡s
papier	pʰ a p iː ɐ
papiere	pʰ a p iː r ə
parent	pʰ a r ɛ n t
parente	pʰ a r ɛ n t ə
partikular	pʰ a t i k u l aː r
patent	pʰ a t ɛ n t
patente	pʰ a t ɛ n t ə
patt	pʰ a t
pausa	pʰ a ʊ̯ s a
pause	pʰ a ʊ̯ s ə
peck	pʰ e k
peepst	pʰ eː p ʃ t
peffer	pʰ e f ɐ
peffermenz	pʰ e f ɐ m ɛ n s
peffermenz	pʰ e f ɐ m ɛ n t͡s
peif	pʰ a ɪ̯ f
peil	pʰ a ɪ̯ l
peiler	pʰ a ɪ̯ l ɐ
pein	pʰ a ɪ̯ n
peine	pʰ a ɪ̯ n ə
perl	pʰ ɛ l
perle	pʰ ɛ l ə
persche	pʰ ɛ ʃ ə
person	pʰ ɛ s oː n
persone	pʰ ɛ s oː n ə
pest	pʰ e ʃ t
petze	pʰ e t͡s ə
piano	pʰ i aː n o
pianos	pʰ i aː n o s
picke	pʰ i k ə
piff	pʰ i f
pihl	pʰ iː l
pill	pʰ i l
pille	pʰ i l ə
pisin	pʰ i s iː n
piss	pʰ i s
pisse	pʰ i s ə
pitsch	pʰ i t͡ʃ
pizza	p i t͡s a
pizzas	p i t͡s a s
planet	p l a n eː t
planete	p l a n eː t ə
planz	p l a n s
planz	p l a n t͡s
platt	p l a t
platte	p l a t ə
platz	p l a t͡s
platze	p l a t͡s ə
pnëu	p n e ʊ̯
polack	pʰ o l a k
polacke	pʰ o l a k ə
pole	pʰ oː l ə
polente	pʰ o l ɛ n t ə
poliere	pʰ o l iː r ə
politik	pʰ o l i t iː k
politiker	pʰ o l iː t i k ɐ
politisch	pʰ o l iː t i ʃ
polnisch	pʰ o l n i ʃ
pomata	pʰ o m aː t a
portugal	pʰ o r t u k aː l
portugiesisch	pʰ o r t u k iː s i ʃ
poste	pʰ o ʃ t ə
praia	p r a ɪ̯ a
praias	p r a ɪ̯ a s
praktisch	p r a k t i ʃ
praut	p ɾ a ʊ̯ t
preis	p r a ɪ̯ s
priester	p r iː ʃ t ɐ
prim	p r iː m
prime	p r iː m ə
prinz	p r i n s
prinz	p r i n t͡s
prinzessin	p r i n t͡s e s i n
prisong	p r i s ɔ ŋ
problem	p r o p l eː m
problematisch	p r o p l ə m aː t i ʃ
profeet	p r o f eː t
pronome	p r o n oː m ə
prozent	p r o t͡s ɛ n t
prozess	p r o t͡s e s
puer	pʰ uː ɐ
puffe	pʰ u f ə
puhl	pʰ uː l
pulisse	p u l i s ə
pulver	pʰ u l v ɐ
pumpe	pʰ u m p e
pumpe	pʰ u m p ə
punkt	pʰ u ŋ k t
putsch	pʰ u t͡ʃ
putting	pʰ u t i ŋ
quarz	k w a t͡s
quatsche	k w a t͡ʃ ə
quele	k w eː l ə
quelle	k w e l ə
radio	r aː t i̯ o
radios	r aː t i̯ o s
rand	r a n t
rang	r a ŋ
range	r a ŋ ə
rangle	r a ŋ l ə
ransch	r a n ʃ
ranschegelleb	r a n ʃ ə k e l ə p
rappe	r a p ə
rass	r a s
rasse	r a s ə
ratt	r a t
ratte	r a t ə
rau	r a ʊ̯
raub	r a ʊ̯ p
rauche	r a ʊ̯ x ə
raucher	r a ʊ̯ x ɐ
raum	r a ʊ̯ m
raume	r a ʊ̯ m ə
rausche	r a ʊ̯ ʃ ə
rechne	r e ç n ə
rechnung	r e ç n u ŋ
recht	r e ç t
rechts	r e ç t͡s
reck	r e k
rees	r eː s
reese	r eː s ə
reffe	r e f ə
reh	r eː
rehn	r eː n
rehne	r eː n ə
rei	r a ɪ̯
reiche	r a ɪ̯ ç ə
reichre	r a ɪ̯ ç r ə
reif	r a ɪ̯ f
reife	r a ɪ̯ f ə
reim	r a ɪ̯ m
reis	r a ɪ̯ s
reise	r a ɪ̯ s ə
reive	r a ɪ̯ v ə
renne	r ɛ n ə
renner	r e n ɐ
repple	r e p l ə
rest	r e ʃ t
rester	r e ʃ t ɐ
rette	r e t ə
retter	r e t ɐ
rettung	r e t u ŋ
richte	r i ç t ə
richter	r i ç t ɐ
richtung	r i ç t u ŋ
ricke	r i k ə
rieche	r iː ç ə
rind	r i n t
rindfleisch	r i n t f l a ɪ̯ ʃ
ring	r i ŋ
ringfinger	r i ŋ f i ŋ ɐ
rinner	r i n ɐ
rio	r iː o
rios	r iː o s
ripp	r i p
rippe	r i p ə
riss	r i s
ritz	r i t͡s
ritze	r i t͡s ə
riwle	r i v l ə
rock	r o k
rod	r oː t
rode	r oː r ə
roh	r oː
roll	r o l
rolle	r o l ə
romantik	r o m a n t i k
roppe	r o p ə
ros	r oː s
rosch	r o ʃ
rose	r oː s ə
roserod	r oː z ə r oː t
ross	r o s
rosse	r o s ə
rost	r o ʃ t
rotz	r o t͡s
ruf	r uː f
rufe	r uː f ə
ruh	r uː
ruhe	r uː ə
russ	r u s
russe	r u s ə
russisch	r u s i ʃ
russland	r u s l a n t
rut	r uː t
rute	r uː t ə
rëghiere	r e ç iː r ə
rëghierung	r e ç iː r u ŋ
rëghion	r e ç i oː n
rëlighion	r e l i ç i̯ o n
rëmorss	r e m ɔ s
saan	s ɔː n
sach	s a x
sache	s a x ə
sack	s a k
sacolas	s a k o l a s
sakrament	s a k r a m ɛ n t
sals	s a l s
salse	s a l s e
salsich	s a l s i ç
sammle	s a m l ə
sammlung	s a m l u ŋ
sand	s a n t
sandfloh	s a n t f l oː
sardin	s a t iː n
sardine	s a t iː n ə
satellit	s a t ə l iː t
satellite	s a t ə l iː t ə
sattel	s a t l̩
satz	s a t͡s
sau	s a ʊ̯
sauer	s a ʊ̯ ɐ
saufe	s a ʊ̯ f ə
saure	s a ʊ̯ r ə
sauver	s a ʊ̯ v ɐ
scha	ʃ aː
schaal	ʃ ɔː l
schaam	ʃ ɔː m
schach	ʃ a x
schachtel	ʃ a x t l̩
schaffe	ʃ a f ə
schall	ʃ a l
schalle	ʃ a l ə
schapong	ʃ a p ɔ ŋ
schatte	ʃ a t ə
schatz	ʃ a t͡s
schaum	ʃ a ʊ̯ m
scheed	ʃ eː t
scheele	ʃ eː l ə
scheen	ʃ eː n
schein	ʃ a ɪ̯ n
scheine	ʃ a ɪ̯ n ə
schell	ʃ e l
schelle	ʃ e l ə
scheme	ʃ eː m ə
schenker	ʃ ɛ ŋ k ɐ
scherz	ʃ ɛ t͡s
scherze	ʃ ɛ t͡s ə
schetz	ʃ e t͡s
schicht	ʃ i ç t
schichte	ʃ i ç t ə
schicke	ʃ i k ə
schiff	ʃ i f
schild	ʃ i l t
schiller	ʃ i l ɐ
schipp	ʃ i p
schippe	ʃ i p ə
schiss	ʃ i s
schissel	ʃ i s l̩
schisser	ʃ i s ɐ
schissle	ʃ i s l ə
schlaa	ʃ l ɔː
schlachte	ʃ l a x t ə
schlachtung	ʃ l a x t u ŋ
schlang	ʃ l a ŋ
schlange	ʃ l a ŋ ə
schlank	ʃ l a ŋ k
schlapp	ʃ l a p
schlappe	ʃ l a p ə
schlau	ʃ l a ʊ̯
schlecht	ʃ l e ç t
schleier	ʃ l a ɪ̯ ɐ
schleim	ʃ l a ɪ̯ m
schlepp	ʃ l e p
schleppe	ʃ l e p ə
schlesser	ʃ l e s ɐ
schlick	ʃ l i k
schlicke	ʃ l i k ə
schliese	ʃ l iː s ə
schlitz	ʃ l i t͡s
schlitze	ʃ l i t͡s ə
schlof	ʃ l oː f
schlofe	ʃ l oː f ə
schloss	ʃ l o s
schlott	ʃ l o t
schluck	ʃ l u k
schmaal	ʃ m ɔː l
schmecke	ʃ m e k ə
schmelze	ʃ m e l t͡s ə
schmetterling	ʃ m e t ɐ l i ŋ
schmier	ʃ m iː ɐ
schmitt	ʃ m i t
schmuck	ʃ m u k
schmutz	ʃ m u͡t s
schnall	ʃ n a l
schnalle	ʃ n a l ə
schnaps	ʃ n a p s
schneck	ʃ n e k
schnecke	ʃ n e k ə
schnee	ʃ n eː
schneemann	ʃ n eː m a n
schnees	ʃ n eː s
schneid	ʃ n a ɪ̯ t
schneide	ʃ n a ɪ̯ r ə
schneider	ʃ n a ɪ̯ r ɐ
schnell	ʃ n e l
schnips	ʃ n i p s
schnitt	ʃ n i t
schnuer	ʃ n uː ɐ
schnuffle	ʃ n u f l ə
schnuppe	ʃ n u p ə
schnut	ʃ n uː t
schnute	ʃ n uː t ə
schof	ʃ oː f
schone	ʃ oː n ə
schopp	ʃ o p
schoppe	ʃ o p ə
schos	ʃ oː s
schot	ʃ oː t
schote	ʃ oː t ə
schrank	ʃ r a ŋ k
schrappe	ʃ r a p ə
schraub	ʃ r a ʊ̯ p
schreck	ʃ r e k
schrecke	ʃ r e k ə
schrecklich	ʃ r e k l i ç
schrift	ʃ r i f t
schritt	ʃ r i t
schritte	ʃ r i t ə
schuh	ʃ uː
schul	ʃ uː l
schuld	ʃ u l t
schule	ʃ uː l ə
schun	ʃ u n
schuppe	ʃ u p ə
schuss	ʃ u s
schuster	ʃ u ʃ t ɐ
schutz	ʃ u t͡s
schutze	ʃ u t͡s ə
schutzengel	ʃ u t͡s ɛ ŋ l̩
schwaart	ʃ v ɔː t
schwach	ʃ v a x
schwamm	ʃ v a m
schwanger	ʃ v a ŋ ɐ
schwanz	ʃ v a n s
schwanz	ʃ v a n t͡s
schwarz	ʃ v a t͡s
schwarz	ʃ v a͡t s
schwarzbier	ʃ v a t͡s p iː ɐ
schwarzbier	ʃ v a ʁ t͡s b iː ɐ̯
schwefel	ʃ v eː f l̩
schwein	ʃ v a ɪ̯ n
schweinerei	ʃ v a ɪ̯ n ə r a ɪ̯
schweiz	ʃ v a ɪ̯͡t s
schweizer	ʃ v a ɪ̯ t͡s ɐ
schwelle	ʃ v e l ə
schwellung	ʃ v e l u ŋ
schwimme	ʃ v i m ə
schwimmer	ʃ v i m ɐ
schwitz	ʃ v i t͡s
schwitze	ʃ v i t͡s ə
schwäer	ʃ v ɛː ɐ
sechs	s e k s
sechseck	s e k s e k
sechzen	s e ç͡t s n̩
sechzich	s e ç t͡s i ç
seck	s e k
seckel	s e k l̩
see	s eː
seel	s eː l
seele	s eː l ə
seh	s eː
sehe	s eː ə
sehn	s eː n
sei	s a ɪ̯
seid	s a ɪ̯ t
seie	s a ɪ̯ ə
seif	s a ɪ̯ f
seife	s a ɪ̯ f ə
sein	s a ɪ̯ n
seit	s a ɪ̯ t
seite	s a ɪ̯ t ə
sekund	s e k u n t
send	s e n t
senger	s ɛ ŋ ɐ
september	s eː p t ɛ m p ɐ
setz	s e t͡s
setze	s e t͡s ə
sibzen	s i p t͡s n̩
sichel	s i ç l̩
sicher	s i ç ɐ
sicherlich	s i ç ɐ l i ç
sicht	s i ç t
sichte	s i ç t ə
sie	s iː
siegh	s iː ç
sies	s iː s
siete	s iː t ə
sieve	s iː v ə
siffer	s i f ɐ
sihn	s iː n
silver	s i l v ɐ
simbol	s i m p o l
simp	s i m p
sin	s i n
sind	s i n t
sinfonie	s i n f o n iː
sinfonisch	s i n f oː n i ʃ
singe	s i ŋ ə
sinke	s i ŋ k ə
sinne	s i n ə
sinner	s i n ɐ
sinonim	s i n oː n i m
sistem	s i s t eː m
sitze	s i t͡s ə
skelett	ʃ k e l e t
skorpion	ʃ k o r p i oː n
soda	s oː t a
sofa	s o f aː
sofas	s o f aː s
sohl	s oː l
sohle	s oː l ə
sohn	s oː n
soje	s oː ʃ ə
soldaat	s o l t ɔː t
solle	s o l ə
some	s oː m ə
sommer	s ɔ m ɐ
soot	s oː t
sorte	s ɔ t ə
sos	s oː s
sose	s oː s ə
spaad	ʃ p ɔː t
spaan	ʃ p ɔː n
spanje	ʃ p a n j ə
spanne	ʃ p a n ə
sparre	ʃ p a r ə
spass	ʃ p a s
spatze	ʃ p a t͡s ə
speck	ʃ p e k
sped	ʃ p e t
speen	ʃ p eː n
speicher	ʃ p a ɪ̯ ç ɐ
sperre	ʃ p ɛ r ə
spess	ʃ p e s
spiel	ʃ p iː l
spiele	ʃ p iː l ə
spieler	ʃ p iː l ɐ
spinn	ʃ p i n
spinne	ʃ p i n ə
spiss	ʃ p i s
spitz	ʃ p i t͡s
spitze	ʃ p i t͡s ə
spoer	ʃ p oː ɐ
spott	ʃ p o t
spreche	ʃ p r e ç ə
sprecher	ʃ p r e ç ɐ
sprecherei	ʃ p r e ç ə r a ɪ̯
sprich	ʃ p r i x
spring	ʃ p r i ŋ
springe	ʃ p r i ŋ ə
spritz	ʃ p r i t͡s
spritze	ʃ p r i t͡s ə
sproch	ʃ p r o x
spruch	ʃ p r u x
sprung	ʃ p r u ŋ
spuck	ʃ p u k
spucke	ʃ p u k ə
spul	ʃ p uː l
spule	ʃ p uː l ə
staab	ʃ t ɔː p
staal	ʃ t ɔː l
staat	ʃ t ɔː t
staate	ʃ t ɔː t ə
stachel	ʃ t a x l̩
stall	ʃ t a l
stamm	ʃ t a m
stampe	ʃ t a m p ə
stamper	ʃ t a m p ɐ
stang	ʃ t a ŋ
stange	ʃ t a ŋ ə
stanze	ʃ t a n t͡s ə
statt	ʃ t a t
statts	ʃ t a͡t s
steche	ʃ t e ç ə
steck	ʃ t e k
stecke	ʃ t e k ə
steel	ʃ t eː l
steen	ʃ t eː n
steenich	ʃ t eː n i ç
steere	ʃ t eː r ə
stehle	ʃ t eː l ə
stehn	ʃ t eː n
steie	ʃ t a ɪ̯ ə
steier	ʃ t a ɪ̯ ɐ
steif	ʃ t a ɪ̯ f
stell	ʃ t e l
stelle	ʃ t e l ə
stempel	ʃ t ɛ m p l̩
stengel	ʃ t ɛ ŋ l̩
stern	ʃ t ɛ n
sterne	ʃ t ɛ n ə
sterrve	ʃ t ɛ r v ə
sterz	ʃ t ɛ t͡s
sterze	ʃ t ɛ t͡s ə
stett	ʃ t e t
stetter	ʃ t e t ɐ
stich	ʃ t i ç
stick	ʃ t i k
sticke	ʃ t i k ə
sticker	ʃ t i k ɐ
stiefbruder	ʃ t iː f p r uː r ɐ
stiefkind	ʃ t iː f kʰ i n t
stiefmutter	ʃ t iː f m u t ɐ
stiefsohn	ʃ t iː f s oː n
stiel	ʃ t iː l
stier	ʃ t iː ɐ
stift	ʃ t i f t
stihl	ʃ t iː l
still	ʃ t i l
stimme	ʃ t i m ə
stinkdier	ʃ t i ŋ k t iː ɐ
stinke	ʃ t i ŋ k ə
stock	ʃ t o k
stolper	ʃ t o l p ɐ
stolpre	ʃ t o l p r ə
stols	ʃ t o l s
stoppe	ʃ t o p ə
storz	ʃ t ɔ t͡s
strauch	ʃ t r a ʊ̯ ç
straus	ʃ t r a ʊ̯ s
streck	ʃ t r e k
strecke	ʃ t r e k ə
streiche	ʃ t r a ɪ̯ ç ə
streicher	ʃ t r a ɪ̯ ç ɐ
streichle	ʃ t r a ɪ̯ ç l ə
streife	ʃ t r a ɪ̯ f ə
strem	ʃ t r eː m
strich	ʃ t r i ç
strick	ʃ t r i k
stricke	ʃ t r i k ə
strimp	ʃ t r i m p
strof	ʃ t r oː f
strofe	ʃ t r o f ə
stroh	ʃ t r oː
strom	ʃ t r oː m
strome	ʃ t r oː m ə
stros	ʃ t r oː s
stross	ʃ t r o s
strump	ʃ t r u m p
struz	ʃ t r uː t͡s
studente	ʃ t u t ɛ n t ə
stuhl	ʃ t uː l
stumm	ʃ t u m
stump	ʃ t u m p
suche	s u x ə
suckle	s u k l ə
sump	s u m p
supp	s u p
suppe	s u p ə
suttle	s u t l ə
sërviere	s e r v iː r ə
taach	t aː x
talent	tʰ a l ɛ n t
tamburin	tʰ a m p u r iː n
tanke	t a ŋ k ə
tante	tʰ a n t ə
tappes	tʰ a p ə s
tasch	tʰ a ʃ
tasche	tʰ a ʃ ə
tass	tʰ a s
tasse	tʰ a s ə
tausend	tʰ a ʊ̯ s n̩ t
taxi	tʰ a k s i
taxis	tʰ a k s i s
tee	tʰ eː
teekann	tʰ eː kʰ a n
teekanne	tʰ eː kʰ a n ə
tema	tʰ eː m a
teme	tʰ eː m ə
tempel	tʰ ɛ m p l̩
terrenos	tʰ e r eː n o s
text	tʰ e k s t
texte	tʰ e k s t ə
tint	tʰ i n t
tinte	tʰ i n t ə
tirolisch	tʰ i r oː l i ʃ
tomatt	tʰ o m a t
torte	tʰ ɔ t ə
toych	t ɔ j x
traire	t r a iː r ə
trample	t r a m p l ə
traub	t r a ʊ̯ p
traue	t r a ʊ̯ ə
trede	t r eː r ə
treffe	t r e f ə
trenne	t r ɛ n ə
treppe	t r e p ə
trieb	t r iː p
trieve	t r iː v ə
tritt	t r i t
troost	t r oː ʃ t
trupp	t r u p
truppe	t r u p ə
tumor	tʰ u m oː r
tunke	tʰ u ŋ k ə
tunkelheet	t u ŋ k ə l h eː t
tëlevisong	t h e l ə v i s ɔ ŋ
uersach	uː ɐ s a x
uerwald	uː ɐ v a l t
uff	u f
uffem	u f m̩
uffs	u f s
uher	uː ɐ
uherzeid	uː ɐ t͡s a ɪ̯ t
um	u m
umsonst	u m s ɔ n ʃ t
un	u n
unbekannt	u n p ə kʰ a n t
unfall	u n f a l
ungesund	u n k ə s u n t
unglick	u n k l i c k
uns	u n s
unschuld	u n ʃ u l t
unsicher	u n s i ç ɐ
unzufried	u n t͡s u f r iː t
urin	u r iː n
vaas	v ɔː s
vasos	v aː s o s
violin	v i o l iː n
violine	v i o l iː n ə
waal	v ɔː l
waan	v ɔː n
waar	v ɔː
wach	v a x
wache	v a x ə
wachs	v a k s
wachse	v a k s ə
wackle	v a k l ə
waff	v a f
waffe	v a f ə
waffle	v a f l ə
walse	v a l s ə
wand	v a n t
was	v a s
waser	v a s ə ɾ
wasser	v a s ɐ
watt	v a t
watte	v a t ə
wech	v e ç
weche	v e ç ə
wechsle	v e k s l ə
weck	v e k
wecker	v e k ɐ
weele	v eː l ə
ween	v eː n
weert	v eː ɐ t
weh	v eː
weib	v a ɪ̯ p
weiblich	v a ɪ̯ p l i ç
weid	v a ɪ̯ t
weider	v a ɪ̯ r ɐ
weie	v a ɪ̯ ə
wein	v a ɪ̯ n
weine	v a ɪ̯ n ə
weinflasche	v a ɪ̯ n f l a ʃ ə
weis	v a ɪ̯ s
weisbrod	v a ɪ̯ s p r oː t
weise	v a ɪ̯ s ə
weize	v a ɪ̯ t͡s ə
well	v e l
welle	v e l ə
wellef	v e l ə f
welt	v e l t
welte	v e l t ə
wend	v e n t
wer	v ɛ ɐ̯
werklich	v ɛ r k l i ç
werklichkeet	v e r k l i ç kʰ eː t
werre	v ɛ r ə
werst	v ɛ ʃ t
werter	v ɛ t ɐ
wesch	v e ʃ
wesche	v e ʃ ə
wespe	v e ʃ p ə
weste	v e ʃ t ə
wette	v e t ə
wetter	v e t ɐ
weve	v eː v ə
wever	v eː v ɐ
wichs	v i k s
wichse	v i k s ə
wichtich	v i ç t i ç
wicke	v i k ə
wickle	v i k l ə
wiest	v iː ʃ t
wild	v i l t
wille	v i l ə
wimper	v i m p ɐ
wind	v i n t
windmihl	v i n t m iː l
winsche	v i n ʃ ə
winter	v i n t ɐ
wische	v i ʃ ə
wisse	v i s ə
witz	v i t͡s
wo	v oː
woche	v o x ə
wochenn	v o x ɛ n
woher	v oː ɐ
woherheet	v oː ɐ h eː t
woherheit	v oː ɐ h a ɪ̯ t
wohne	v oː n ə
woll	v o l
wolle	v o l ə
wollef	v o l ə f
wollek	v o l k
worst	v ɔ ʃ t
wort	v ɔ t
worte	v ɔ t ə
wortschatz	v ɔ t ʃ a t͡s
wuchs	v u k s
wund	v u n t
wunner	v u n ɐ
wunsch	v u n ʃ
wut	v uː t
wutz	v u t͡s
wutze	v u t͡s ə
xloych	ʃ l ɔ j x
xtayn	ʃ t a j n
zaal	t͡s ɔː l
zaam	t͡s ɔː m
zaan	͡t s ɔː n
zaart	t͡s ɔː t
zang	t͡s a ŋ
zange	t͡s a ŋ ə
zanke	t͡s a ŋ k ə
zaum	t͡s a ʊ̯ m
zaun	t͡s a ʊ̯ n
zebra	t͡s eː p r a
zebras	t͡s eː p r a s
zeche	t͡s e ç ə
zecke	t͡s e k ə
zeen	t͡s eː n
zeh	t͡s eː
zehe	t͡s eː ə
zehn	t͡s eː n
zeich	t͡s a ɪ̯ ç
zeichne	t͡s a ɪ̯ ç n ə
zeichnung	t͡s a ɪ̯ ç n u ŋ
zeid	t͡s a ɪ̯ t
zeidich	͡t s a ɪ̯ r i ç
zein	t͡s a ɪ̯ n
zentraal	t͡s n̩ t r ɔː l
zentrum	t͡s ɛ n t r u m
zepp	t͡s e p
zettel	t͡s e t l̩
ziehe	t͡s iː ə
ziel	t͡s iː l
zimmer	t͡s i m ɐ
zimmermann	t͡s i m ɐ m a n
zimmet	t͡s i m ə t
zink	t͡s i ŋ k
zinn	t͡s i n
zins	t͡s i n s
zinse	t͡s i n s ə
zipp	t͡s i p
zippe	t͡s i p ə
zitron	t͡s i t r oː n
zitrone	t͡s i t r oː n ə
zittre	t͡s i t r ə
zopp	t͡s o p
zucker	t͡s u k ɐ
zuckre	t͡s u k r ɐ
zufried	t͡s u f r iː t
zumache	t͡s uː m a x ə
zung	t͡s u ŋ
zunge	t͡s u ŋ ə
zwanzich	͡t s v a n͡t s i ç
zweck	t͡s v e k
zweifel	t͡s v a ɪ̯ f l̩
zweifle	t͡s v a ɪ̯ f l ə
zwellef	t͡s v e l ə f
zwern	t͡s v ɛ n
zwett	t͡s v e t
zweu	t͡s v ɔ ɪ̯
zwieback	t͡s v iː p a k
zwilling	t͡s v i l i ŋ
zwinge	t͡s v i ŋ ə
zwiwel	t͡s v i v l̩
äerd	ɛː ɐ t
äerdbeer	ɛː ɐ t p eː ɐ
äärem	ɛː r m̩
äärsch	ɛː ʃ
