ᄀᆞᄁᆞᆺ	k ɒ k͈ ɒ t̚
ᄀᆞᆨ다기	k ɒ k̚ t͈ a̠ ɡ i
ᄀᆞᆫ장	k ɒ ɲ d͡ʑ a̠ ŋ
ᄀᆞᆮ다	k ɒ t̚ t͈ a
ᄀᆞᆯ개비	k ɒ ɭ ɡ ɛ b i
ᄀᆞᆺ바위	k ɒ t̚ p͈ a̠ w i
ᄀᆞᆺ사	k ɒ t̚ s͈ a̠
ᄀᆞ끔	k ɒ k͈ ɨ m
ᄀᆞ득	k ɒ d ɨ k̚
ᄀᆞ득다	k ɒ d ɨ k̚ t͈ a̠
ᄀᆞ로쓰기	k ɒ ɾ o̞ s͈ ɨ ɡ i
ᄀᆞ르	k ɒ ɾ ɨ
ᄀᆞ를	k ɒ ɾ ɨ ɭ
ᄀᆞ리	k ɒ ɾ i
ᄀᆞ맹이	k ɒ m ɛ ŋ i
ᄀᆞ새	k ɒ s æ
ᄀᆞ을	k ɒ ɨ ɭ
ᄀᆞ져들이다	k ɒ d͡ʑ j ə d ɨ ɾ i d a̠
ᄀᆞ찌	k ɒ t͡ɕ͈ i
ᄁᆞ늘다	k ɒ n ɨ ɭ d a̠
ᄁᆞ늘다	k͈ ɒ n ɨ ɭ d a̠
ᄁᆞ장	k͈ ɒ d͡ʑ a̠ ŋ
ᄂᆞᄆᆞᆯ	n ɒ m ɒ ɭ
ᄂᆞᄆᆞᆯ국	n ɒ m ɒ ɭ ɡ u k̚
ᄂᆞᆷ삐	n ɒ m p͈ i
ᄂᆞᆺ빗	n ɒ t̚ p͈ i t̚
ᄂᆞ시	n ɒ ʃ i
ᄂᆞ실다	n ɒ ʃ i ɭ d a̠
ᄂᆞ잡다	n ɒ d͡ʑ a̠ p̚ t͈ a̠
ᄃᆞᆨ	t ɒ k̚
ᄃᆞᆫ물장의	t ɒː n m u ʎ d͡ʑ a̠ ŋ ɰ i
ᄃᆞᆯ	t ɒ ɭ
ᄃᆞᆯ뱅이	t ɒ ɭ b æ ŋ i
ᄃᆞᆺᄃᆞᆺᄒᆞ다	t ɒ t̚ t͈ ɒ tʰ ɒ d a̠
ᄃᆞᆼ그다	t ɒ ŋ ɡ ɨ d a̠
ᄃᆞ람지	t ɒː ɾ a̠ m d͡ʑ i
ᄃᆞ스다	t ɒ s ɨ d a̠
ᄄᆞᆯ	t͈ ɒ ɭ
ᄄᆞᆷ	t͈ ɒ m
ᄄᆞ뜻ᄒᆞ다	t͈ ɒ t͈ ɨ tʰ ɒ d a̠
ᄆᆞᆫ딱	m ɒ n t͈ a̠ k̚
ᄆᆞᆯ	m ɒ ɭ
ᄆᆞᆯ랑ᄆᆞᆯ랑ᄒᆞ다	m ɒ ɭ ɭ a̠ ŋ m ɒ ɭ ɭ a̠ ŋ h ɒ d a̠
ᄆᆞ르다	m ɒ ɾ ɨ d a̠
ᄆᆞ슬	m ɒ sʰ ɨ ɭ
ᄆᆞ슴	m ɒ s ɨ m
ᄆᆞ실	m ɒ ɕʰ i ɭ
ᄆᆞ츰내	m ɒ t͡ɕʰ ɨ m n ɛ
ᄇᆞᆮ	p ɒ t̚
ᄇᆞᆯ끈	p ɒ ɭ k͈ ɨ n
ᄇᆞᆯ써	p ɒ ɭ s͈ ə
ᄇᆞᆰ다	p ɒ k̚ t͈ a̠
ᄇᆞ레다	p ɒ ɾ e̞ d a̠
ᄇᆞ름	p ɒ ɾ ɨ m
ᄈᆞᆯ다	p͈ ɒ ɭ d a̠
ᄈᆞᆯ레ᄒᆞ다	p͈ ɒ ɭ ɭ e̞ h ɒ d a̠
ᄈᆞᆯ르다	p͈ ɒ ɭ ɭ ɨ d a̠
ᄉᆞ	s ɒ
ᄉᆞᆯ루다	sʰ ɒː ɭ ɭ u d a̠
ᄉᆞᆯ므다	sʰ ɒː ɭ m ɨ d a̠
ᄉᆞᆼ키	s ɒ ŋ kʰ i
ᄉᆞ랑	sʰ ɒ ɾ a̠ ŋ
ᄉᆞ수매	s ɒ s u m æ
ᄉᆞ시	sʰ ɒ ʃ i
ᄉᆞ실	sʰ ɒː ɕʰ i ɭ
ᄉᆞ십	s ɒ ʃ i p̚
ᄉᆞ용ᄒᆞ다	s ɒ j o̞ ŋ ɦ ɒ d a̠
ᄉᆞ을	sʰ ɒː ɨ ɭ
ᄉᆞ이	sʰ ɒ i
ᄉᆞ춘	s ɒ t͡ɕʰ u n
ᄉᆞ투리	s ɒ tʰ u ɾ i
ᄉᆞ훼	sʰ ɒ h w e̞
ᄊᆞᆯ	s͈ ɒ ɭ
ᄊᆞᆯ칩	s͈ ɒ ʎ t͡ɕʰ i p̚
ᄊᆞᆱ다	s͈ ɒ m d a̠
ᄋᆞᆼ진ᄋᆞᆼ진	ɒ ŋ d͡ʑ i n ɒ ŋ d͡ʑ i n
ᄋᆞ동	ɒ d o̞ ŋ
ᄋᆞ요	ɒ j o̞
ᄋᆢᄃᆞᆸ	j ɒ d ɒ p̚
ᄋᆢᄉᆞᆺ	j ɒ s ɒ t̚
ᄋᆢᆯ매	j ɒ ɭ m æ
ᄋᆢᆺ	j ɒ t̚
ᄋᆢᆺ쉐	j ɒ s s͈ w e̞
ᄋᆢᇁ	j ɒ p̚
ᄋᆢ드레	j ɒ d ɨ ɾ e̞
ᄋᆢ든	j ɒ d ɨ n
ᄋᆢ라	j ɒ ɾ a̠
ᄋᆢ라분	j ɒ ɾ a̠ b u n
ᄋᆢ름	j ɒ ɾ ɨ m
ᄌᆞᄉᆞᆨ	t͡ɕ ɒ s ɒ k̚
ᄌᆞᆷ자다	t͡ɕ ɒ m d͡ʑ a̠ d a̠
ᄌᆞᆺ	t͡ɕ ɒ t̚
ᄌᆞ게움타다	t͡ɕ ɒ ɡ e̞ u m tʰ a̠ d a̠
ᄌᆞ미	t͡ɕ ɒ m i
ᄌᆞ미지다	t͡ɕ ɒ m i d͡ʑ i d a̠
ᄌᆞ봄	t͡ɕ ɒ b o̞ m
ᄌᆞ손	t͡ɕ ɒ sʰ o̞ n
ᄌᆞ심히	t͡ɕ ɒ ɕʰ i m h i
ᄌᆞ영거	t͡ɕ ɒ j ə ŋ ɡ ə
ᄌᆞ오침	t͡ɕ ɒ o̞ t͡ɕʰ i m
ᄌᆞ주	t͡ɕ ɒ d͡ʑ u
ᄎᆞᄎᆞ	t͡ɕʰ ɒ t͡ɕʰ ɒ
ᄎᆞᆷ	t͡ɕʰ ɒ m
ᄎᆞᆷ웨	t͡ɕʰ ɒ m w e̞
ᄎᆞᆷ지름	t͡ɕʰ ɒ m d͡ʑ i ɾ ɨ m
ᄎᆞ츰ᄎᆞ츰	t͡ɕʰ ɒ t͡ɕʰ ɨ m t͡ɕʰ ɒ t͡ɕʰ ɨ m
ᄏᆞᄏᆞᆯ	kʰ ɒ kʰ ɒ ɭ
ᄏᆞᆷᄏᆞᆷᄒᆞ다	kʰ ɒ m kʰ ɒ m h ɒ d a̠
ᄐᆞᆸ	tʰ ɒ p̚
ᄑᆞᆯ	pʰ ɒ ɭ
ᄑᆞᆯ둑거리	pʰ ɒ ɭ d u k̚ k͈ ə ɾ i
ᄑᆞᆯ뚝	pʰ ɒ ɭ t͈ u k̚
ᄑᆞᆺ	pʰ ɒ t̚
ᄒᆞᄊᆞᆯ	h ɒ s͈ʰ ɒ ɭ
ᄒᆞᆨ게	h ɒ k̚ k͈ e̞
ᄒᆞᆨ교	h ɒ k̚ k͈ j o
ᄒᆞᆨ교마당	h ɒ k̚ k͈ j o m a d a ŋ
ᄒᆞᆫ	h ɒ n
ᄒᆞᆫ저	h ɒ n d͡ʑ ə
ᄒᆞᆫ저옵서예	h ɒ n d͡ʑ ə o̞ p̚ s͈ ə j e̞
ᄒᆞᆫ펜	h ɒ n pʰ e̞ n
ᄒᆞᆷ치	h ɒ m t͡ɕʰ i
ᄒᆞ고	h ɒ ɡ o̞
ᄒᆞ곡	h ɒ ɡ o̞ k̚
ᄒᆞ꼼	h ɒ k͈ o̞ m
ᄒᆞ나	h ɒ n a
ᄒᆞ다	h ɒ d a
ᄒᆞ를	h ɒ ɾ ɨ ɭ
ᄒᆞ를밤	h ɒ ɾ ɨ ɭ b a̠ m
ᆢ	j ɒ
ᆯ디	ɭ d i
ㅂ네다	m n e̞ d a̠
ㅂ서	p s͈ ə
ㅂ주	p̚ t͡ɕ͈ u
ㅅ	s
ㅢ	i
ㅢ	ɨ
ㅢ	ɰ i
ㆍ	ɒ
가	k a̠
가끄다	k a̠ k͈ ɨ d a̠
가달	k a̠ d a̠ ɭ
가름	k a̠ ɾ ɨ m
가리	k a̠ ɾ i
가림	k a̠ ɾ i m
가메	k a̠ m e̞
가문잔치	k a̠ m u n d͡ʑ a̠ n t͡ɕʰ i
가벱다	k a̠ b e̞ p̚ t͈ a̠
가부간	k a̠ b u ɡ a̠ n
가사	k a̠ sʰ a̠
가스승ᄒᆞ다	k a̠ sʰ ɨ sʰ ɨ ŋ ɦ ɒ d a̠
가시아방	k a̠ ʃ i a̠ b a̠ ŋ
가싸	k a̠ s͈ a̠
가온데	k a̠ o̞ n d e̞
가웃	k a̠ u t̚
가의	k a̠ i
가이	k a̠ i
가재이	k a d͡ʑ æ i
가죽감티	k a̠ d͡ʑ u k̚ k͈ a̠ m tʰ i
가차이	k a̠ t͡ɕʰ a̠ i
가풀	k a̠ pʰ u ɭ
각시	k a̠ k̚ ʃ͈ i
간ᄊᆞᆷ	k a̠ n s͈ ɒ m
간상부리다	k a̠ n s a̠ ŋ b u ɾ i d a̠
감저	k a̠ː m d͡ʑ ə
갑실	k a̠ p ʃ͈ i ɭ
갑옷	k a̠ b o̞ t̚
갓	k a̠ t̚
강	k a̠ ŋ
강낭대죽	k a̠ː ŋ n a̠ ŋ d ɛ d͡ʑ u k̚
강생이	k a̠ ŋ sʰ æ ŋ i
강월동	k a̠ ŋ w ə ɭ d o̞ ŋ
개ᄀᆞᆺ	k ɛ ɡ ɒ t̚
갱규	k æ ŋ ɡ j u
갱규부리다	k æ ŋ ɡ j u b u ɾ i d a̠
거끄다	k ə k͈ ɨ d a̠
거리	k ə ɾ i
거무룽ᄒᆞ다	k ə m u ɾ u ŋ ɦ ɒ d a̠
거북	k ə b u k̚
거여미	k ə j ə m i
거의	k ə ɰ i
거짓거	k əː d͡ʑ i t̚ k͈ ə
검다	k ə m d a̠
검질	k ə m t͡ɕ i ɭ
겁자	k ə p̚ t͡ɕ͈ a̠
것멕이다	k ə n m e̞ ɡ i d a̠
게	k e̞
게게ᄒᆞ다	k e̞ ɡ e̞ ɦ ɒ d a̠
게메	k e̞ m e̞
게메게	k e̞ m e̞ ɡ e̞
게시다	k e̞ ʃ i d a̠
겡	k e̞ ŋ
겨을	k j ə ɨ ɭ
격납고	k j ə ŋ n a̠ p̚ k͈ o̞
결국	k j ə ɭ ɡ u k̚
경	k j ə ŋ
경ᄒᆞ다	k j ə ŋ h ɒ d a̠
계메	k j e̞ m e̞
계훽	k j e̞ ɦ w e̞ k̚
고고리	k o̞ ɡ o̞ ɾ i
고나	k o̞ n a̠
고낭귀국	k o̞ n a̠ ŋ ɡ w i ɡ u k̚
고냉이	k o̞ n æ ŋ i
고당	k o̞ d a̠ ŋ
고랑챙이	k o̞ ɾ a̠ ŋ t͡ɕʰ ɛ ŋ i
고레사니	k o̞ ɾ e̞ sʰ a̠ n i
고맙다	k o̞ m a̠ p̚ t͈ a̠
고맙수다	k o̞ m a̠ p s͈ u d a̠
고망	k o̞ m a̠ ŋ
고소리술	k o̞ sʰ o̞ ɾ i sʰ u ɭ
고와리	k o̞ w a̠ ɾ i
고장	k o̞ d͡ʑ a̠ ŋ
고쩌	k o̞ t͈ ɕ ə
곡지	k o̞ k̚ t͡ɕ͈ i
골히	k o̞ ɾ ɦ i
공거리	k o̞ ŋ ɡ ə ɾ i
공고리	k o̞ ŋ ɡ o̞ ɾ i
공븨ᄒᆞ다	k o̞ ŋ b i ɦ ɒ d a̠
공장	k o̞ ŋ d͡ʑ a̠ ŋ
공주	k o̞ ŋ d͡ʑ u
공쥥이	k o̞ ŋ d͡ʑ w i ŋ i
과랑과랑	k w a̠ ɾ a̠ ŋ ɡ w a̠ ɾ a̠ ŋ
관광객	k w a̠ n ɡ w a̠ ŋ ɡ æ k̚
괄락괄락	k w a̠ ɭ ɭ a̠ k̚ k͈ w a̠ ɭ ɭ a̠ k̚
광	k w a̠ ŋ
괙괙	k w ɛ k̚ k͈ w ɛ k̚
구경꾼	k uː ɡ j ə ŋ k͈ u n
구덕	k u d ə k̚
구둘	k u d u ɭ
구들	k u d u ɭ
구수매	k u s u m æ
구쟁이	k u d͡ʑ æ ŋ i
국쉬	k u k̚ ɕ͈ʰ w i
군ᄉᆞ	k u n sʰ ɒ
굴래꽝이	k u ɭ ɭ ɛ k͈ w a̠ ŋ i
굴레	k u ɭ ɭ e̞
굴메	k u ɭ m e̞
굴묵낭	k u n m u ŋ n a ŋ
굼기	k u m ɡ i
굼부리	k u m b u ɾ i
굽	k u p̚
굽다	k u p̚ t͈ a̠
굿	k u t̚
궂다	k u t̚ t͈ a̠
궂어라ᄒᆞ다	k u d͡ʑ ə ɾ a̠ h ɒ t a̠
권작	k w ə ɲ d͡ʑ a̠ k̚
궤기	k w e̞ ɡ i
궤다	k w e̞ː d a̠
궤팡	k w e̞ pʰ a̠ ŋ
궨당	k w e̞ n d a̠ ŋ
궵다	k w e̞ p̚ t͈ a̠
귀정	k y t͡ɕ ə ŋ
귓자락	k y t̚ t͡ɕ͈ a̠ ɾ a̠ k̚
그	k ɨ
그깽이	k ɨ k͈ æ ŋ i
그디	k ɨ d i
그르후제	k ɨ ɾ ɨ h u d͡ʑ e̞
그슬	k ɨ s ɨ ɭ
그지게	k ɨ d͡ʑ i ɡ e̞
그척	k ɨ t͡ɕʰ ə k̚
글ᄌᆞ	k ɨ ʎ t͡ɕ͈ ɒ
금	k ɨ m
금승	k ɨ m s ɨ ŋ
금승매	k ɨ m s ɨ ŋ m æ
기	k i
기ᄑᆞᆷ	k i pʰ ɒ m
기곙이	k i ɡ j e̞ i
기념관	k i ɲ j ə m ɡ w a̠ n
기렵다	k i ɾ j ə p̚ t͈ a̠
기실	k i ɕʰ i ɭ
기여이	k i j ə i
기영	k i j ə ŋ
김뀌	k i m k͈ w i
김끼	k i m k͈ i
깅이	k i ŋ i
까닥	k͈ a̠ d a̠ k̚
까망ᄒᆞ다	k͈ a̠ m a̠ ŋ h ɒ d a̠
깍	k͈ a̠ k̚
깍녹	k͈ a̠ ŋ n o̞ k̚
깝	k͈ a̠ p̚
깨격	k͈ ɛ ɡ j ə k̚
깨붑다	k͈ ɛ b u p̚ t͈ a̠
꺼멍ᄒᆞ다	k͈ ə m ə ŋ h ɒ d a̠
께다	k͈ e̞ d a̠
꼿	k͈ o̞ t̚
꼿밧	k͈ o̞ t̚ p͈ a̠ t̚
꽈	k͈ w a̠
꽝	k͈ w a̠ ŋ
끌르다	k͈ ɨ ɭ ɭ ɨ d a̠
나	n a̠
나끄다	n a̠ k͈ ɨ d a̠
나놔다	n a̠ n w a̠ d a̠
나단	n a̠ d a̠ n
나데읏다	n a̠ d e̞ ɨ t̚ t͈ a̠
나록	n a̠ ɾ o̞ k̚
나시다	n a̠ ɕʰ i d a̠
나이	n a̠ i
나흘	n a̠ ɦ ɨ ɭ
난	n a̠ n
날ᄍᆞ	n a̠ ʎ t͡ɕ͈ ɒ
날날이	n a̠ ɭ ɭ a̠ ɾ i
날씨	n a̠ ɭ ʃ͈ i
날쿠시	n a̠ ɭ kʰ u ʃ i
남녜	n a̠ m ɲ j e̞
남비	n a̠ m b i
남인가장	n a̠ m i n ɡ a̠ d͡ʑ a̠ ŋ
낫	n a̠ t̚
낭	n a̠ ŋ
낮후제	n a t͡ɕʰ u d͡ʑ e̞
내낭	n ɛː n a̠ ŋ
내치다	n æ t͡ɕʰ i d a̠
냄편	n ɛ m pʰ j ə n
냉장고	n ɛː ŋ d͡ʑ a̠ ŋ ɡ o̞
너내	n ə n æ
넙다	n ə p̚ t͈ a̠
넛하르방	n ə tʰ a̠ ɾ ɨ b a̠ ŋ
네	n e̞
넷	n e̞ t̚
넹기다	n e̞ ŋ ɡ i d a̠
노끄다	n o̞ k͈ ɨ d a̠
노대	n o̞ d ɛ
노랑ᄒᆞ다	n o̞ ɾ a ŋ h ɒ d a
노렴	n o̞ː ɾ j ə m
노릿노릿ᄒᆞ다	n o̞ ɾ i nː o̞ ɾ i t̚ h ɒ d a
노프다	n o̞ pʰ ɨ d a̠
노피	n o̞ pʰ i
녹대	n o̞ k̚ t͈ æ
놀	n o̞ ɭ
놀다	n o̞ː ɭ d a̠
놀래	n o̞ ɭ ɭ æ
놀레	n o̞ ɭ ɭ e̞
놀이개	n o̞ ɾ i ɡ æ
놋쒜	n o̞ s s͈ w e̞
누게	n u ɡ e̞
누의	n u ɰ i
눌레기땅	n u ɭ ɭ e̞ ɡ i t͈ a̠ ŋ
느	n ɨ
느릇	n ɨ ɾ ɨ t̚
느리다	n ɨ ɾ i d a̠
늣	n ɨ t̚
늬	n i
늬귀	n iː ɡ w i
늿	n i t̚
니께미	n i k͈ e̞ m i
니향	n i ʝ j a̠ ŋ
님금	n i m ɡ ɨ m
다	t a̠
다ᄉᆞᆺ	t a s ɒ t̚
다간	t a̠ ɡ a̠ n
다니다	t a̠ n i d a̠
다리웨	t a̠ ɾ i w e̞
다믄	t a̠ m ɨ n
다히다	t a̠ ɦ i d a̠
닥닥	t a̠ k̚ t͈ a̠ k̚
단	t a̠ n
닷	d a t̚
닷세	t a̠ s s͈ e̞
당신	t a̠ ŋ ʃ i n
당신덜	t a̠ ŋ ʃ i n d ə ɭ
대국	t æ ɡ u k̚
대비	t æ b i
대오리	t ɛː o̞ ɾ i
대풍	t ɛ pʰ u ŋ
더듸다	t ə d ɰ i d a̠
더레	t ə ɾ e̞
덜	t ə ɭ
덜기	t əː ɭ ɡ i
덥다	t ə p̚ t͈ a̠
덩드렁마께	t ə ŋ d ɨ ɾ ə ŋ m a̠ k͈ e̞
도	t o̞
도곰	t o̞ ɡ o̞ m
도새기	t o̞ sʰ æ ɡ i
도왜다	t o̞ w æ d a̠
독ᄆᆞᄅᆞᆸ	t o̞ ŋ m ɒ ɾ ɒ p̚
돔베	t o̞ m b e̞
돗	t o̞ t̚
동고리	t o̞ ŋ ɡ o̞ ɾ i
동골동골	t o̞ ŋ ɡ o̞ ɭ d o̞ ŋ ɡ o̞ ɭ
동공ᄄᆞᆯ	t o̞ ŋ ɡ o̞ ŋ t͈ ɒ ɭ
동공아ᄃᆞᆯ	t o̞ ŋ ɡ o̞ ŋ a d ɒ ɭ
동공아덜	t o̞ ŋ ɡ o̞ ŋ a d ə ɭ
동모	t o̞ ŋ m o̞
동산	t o̞ ŋ sʰ a̠ n
동셍	t o̞ ŋ s e̞ ŋ
두	t uː
두게	t u ɡ e
두께	t u k͈ e̞
두덥다	t ə d ə p̚ t͈ a
두루붕이	t u ɾ u b u ŋ i
두리다	t u ɾ i d a̠
둘	t u ɭ
둠비	t u m b i
뒹글다	t w i ŋ ɡ ɨ ɭ d a̠
드르	t ɨ ɾ ɨ
드르쓰다	t ɨ ɾ ɨ s͈ ɨ d a
들랑들랑	t ɨ ɭ ɭ a̠ ŋ d ɨ ɭ ɭ a̠ ŋ
들렁놕들렁놕ᄒᆞ다	t ɨ ɭ ɭ ə ŋ n w a̠ k̚ t͈ ɨ ɭ ɭ ə ŋ n w a̠ kʰ ɒ t a̠
들르다	t ɨ ɭ ɭ ɨ d a̠
디	t i
디아	t i a̠
따	t͈ a̠
때	t͈ æ
떨다	t͈ əː ɭ d a̠
떼역	t͈ e̞ j ə k̚
또	t͈ o̞
또까또까	t͈ o̞ k͈ a̠ t͈ o̞ k͈ a̠
똥	t͈ o̞ ŋ
똥버렝이	t͈ o̞ b ə ɾ e̞ ŋ i
뜨다	t͈ ɨ d a̠
뜰리다	t͈ ɨ ʎ ʎ i d a̠
라	ɾ a̠
레	ɾ e̞
마ᄇᆞ름	m a̠ b ɒ ɾ ɨ ɭ
마눌	m a̠ n u ɭ
마당	m a̠ d a̠ ŋ
마시다	m a̠ ɕʰ i d a̠
마씀	m a̠ s͈ ɨ m
마씨	m a̠ ɕ͈ i
마씸	m a̠ ɕ͈ i m
마은	m a̠ ɨ n
마트다	m a̠ tʰ ɨ d a̠
만뒤떡	m a̠ n d w i t͈ ə k̚
만들다	m a̠ n d ɨ ɭ d a̠
만이	m a̠ n i
말	m a̠ ɭ
말매이	m a̠ ɭ m ɛ i
맛싯다	m a̠ ɕ ɕ͈ʰ i t̚ t͈ a̠
맛엇다	m a̠ d ə t̚ t͈ a̠
맞다	m a̠ t̚ t͈ a̠
매비	m æ b i
머력	m ə ɾ j ə k
먹다	m ə k̚ t͈ a̠
멋싯다	m ə ɕ ɕ͈ i t̚ t͈ a̠
멍	m ə ŋ
메께라	m e̞ k͈ e̞ ɾ a̠
메날	m e̞ː n a̠ ɭ
메누리	m e̞ n u ɾ i
메역바당	m e̞ j ə k̚ p͈ a̠ d a̠ ŋ
메웁다	m e̞ u p̚ t͈ a̠
메치	m e̞ t͡ɕʰ i
멕이다	m e̞ ɡ i d a̠
멘헤	m e̞ n ɦ e̞
멩령	m e̞ː ŋ n j ə ŋ
멩질	m e̞ː ŋ d͡ʑ i ɭ
모도	m o̞ d o̞
모살	m o̞ sʰ a̠ ɭ
모시딱	t o̞ ɕʰ i t͈ a̠ k̚
목솜	m o̞ k s͈ o̞ m
목수권	m o̞ k s͈ u ɡ w ə n
몰레	m o̞ ɭ ɭ e̞
몸짐	m o̞ m d͡ʑ i m
무끄다	m u k͈ ɨ d a̠
무사	m u sʰ a̠
무스것	m u sʰ ɨ ɡ ə t̚
무시다	m u ɕʰ i d a̠
무신거	m u ʃ i n ɡ ə
문세	m u n sʰ e̞
묻다	m u t̚ t͈ a̠
물	m u ɭ
물궤기	m u ɭ k͈ w e̞ ɡ i
물알	m u ɾ a̠ ɭ
믄	m ɨ n
미	m i
미깡	m i k͈ a̠ ŋ
미녕실	m i n j ə ŋ ɕ͈ i
미리	m i ɾ i
미리내	m i ɾ i n æ
미리헤치	m i ɾ i ɦ e̞ t͡ɕʰ i
미여이ᄒᆞ다	m i j ə i h ɒ d a̠
미워ᄒᆞ다	m i w ə h ɒ d a̠
밀ᄏᆞ를	m i ɭ kʰ ɒ ɾ ɨ ɭ
바ᄅᆞᆺ구덕	p a̠ ɾ ɒ t̚ k͈ u d ə k̚
바꼇	p a̠ k͈ j ə t̚
바당	p a d a ŋ
바당ᄇᆞ름	p a̠ d a̠ ŋ b ɒ ɾ ɨ m
바를	p aː ɾ ɨ ɭ
바툼	p a̠ tʰ u m
박긔	p a̠ k̚ k͈ ɰ i
박화	p a̠ kʰ w a̠
반ᄃᆞᆯ	p a̠ n d ɒ ɭ
반갑다	p a̠ n ɡ a̠ p̚ t͈ a̠
반착	p a̠ ɲ t͡ɕʰ a̠ k̚
발강ᄒᆞ다	p͈ a ɭ ɡ a ŋ h ɒ d a
발락	p a̠ ɭ ɭ a̠ k̚
밤낫	p a̠ m n a̠ t̚
밥ᄒᆞ다	p a pʰ ɒ d a̠
밥체시	p a̠ p̚ t͡ɕʰ e̞ ʃ i
밧	p a̠ t̚
방	p a̠ ŋ
방둥이	p a̠ ŋ d u ŋ i
버데가다	p ə d e̞ ɡ a̠ d a̠
버렝이	p ə ɾ e̞ ŋ i
버뤵이	p ə ɾ w e̞ ŋ i
버부와리	p ə p u w a̠ ɾ i
버염	p ə j ə m
번짜	p ə ɲ t͡ɕ͈ a̠
베	p e̞
베고프다	p e̞ ɡ o̞ pʰ ɨ d a̠
베낭	p e̞ n a̠ ŋ
베염	p e̞ j ə m
베와주다	p e̞ w a̠ d͡ʑ u d a̠
베조개	p e̞ d͡ʑ o̞ ɡ ɛ
베치	p e̞ː t͡ɕʰ i
벡	p e̞ k̚
벤소	p e̞ n sʰ o̞
벨	p e̞ː ɭ
벨멩	p e̞ ɭ m e̞ ŋ
벨장게	p e̞ ʎ d͡ʑ a̠ ŋ ɡ e̞
벵	p e̞ ŋ
벵완	p e̞ ŋ w a̠ n
보곰지	p o̞ ɡ o̞ m d͡ʑ i
보뎅이	p o̞ d e̞ ŋ i
보드랍다	p o̞ d ɨ ɾ a̠ p̚ t͈ a̠
보롬날	p o̞ ɾ o̞ m n a̠ ɭ
보리클	p o̞ ɾ i kʰ ɨ ɭ
복성게	p o̞ k̚ s͈ ə ŋ ɡ e̞
복송	p o̞ k s͈ o̞ ŋ
봄	p o̞ m
봅서	p o̞ p s͈ ə
봉그다	p o̞ ŋ ɡ ɨ d a̠
부떰	p u t͈ ə m
부루	p u ɾ u
부름씨	p u ɾ ɨ m ʃ͈ i
부름씨ᄒᆞ다	p u ɾ ɨ m ɕ͈ʰ i h ɒ d a̠
부름씨꾼	p u ɾ ɨ m ʃ͈ i k͈ u n
부섭	p u s ə p̚
북	p u k̚
불껑	p u ɭ k͈ ə ŋ
불초다	p u ʎ t͡ɕʰ o̞ d a̠
불환디	p u ɾ h w a̠ n d i
붉은알	p u ɭ ɡ ɨ n a̠ ɭ
브랜드	p ɨ ɾ æ n d ɨ
비낌	p i k͈ i m
비들귀	p i d ɨ ɭ ɡ w i
비르	p i ɾ ɨ
비바리	p i b a̠ ɾ i
비치다	p i t͡ɕʰ i d a̠
비헹기	p i h e ŋ ɡ i
빈내	p i n n æ
빗	p i t̚
빚채	p iː t̚ t͡ɕʰ æ
빠쓰	p͈ a̠ s͈ ɨ
빨강ᄒᆞ다	p͈ a ɭ ɡ a ŋ h ɒ d a
뺑이	p͈ ɛ ŋ i
뽕	p͈ o̞ ŋ
뽕끄랑ᄒᆞ다	p͈ o̞ ŋ k͈ ɨ ɾ a̠ ŋ h ɒ d a̠
뿔새위	p͈ u ɭ s͈ ɛ y
뿕다	p͈ u k̚ t͈ a
삐얌	p͈ i j a̠ m
사ᄅᆞᆷ	s a̠ ɾ ɒ m
사과	sʰ a̠ ɡ w a̠
사귀	sʰ a̠ ɡ w i
사농개	sʰ a̠ n o̞ ŋ ɡ æ
사름	s a̠ ɾ ɨ m
사름수질	sʰ a̠ ɾ ɨ m sʰ u d͡ʑ i ɭ
사위	s a̠ w i
사진끼	s a̠ d͡ʑ i n k͈ i
사포	s a̠ pʰ o̞
사흘	sʰ a̠ ɦ ɨ ɭ
산	s a̠ n
산뒈야지	sʰ a̠ n d w e̞ j a̠ d͡ʑ i
산물	s a̠ n m u ɭ
삼	sʰ a̠ m
삼돌	sʰ a̠ m d o̞ ɭ
삼수매	s a̠ m s u m æ
삼쉬매	s a̠ m ʃ w i m æ
삼십	sʰ a m ɕʰ i p̚
상군	sʰ a̠ ŋ ɡ u n
상이	sʰ a̠ ŋ i
새각시	sʰ æ ɡ a̠ k ʃ͈ i
새끼손가랑	sʰ ɛ k͈ i sʰ o̞ n ɡ a̠ ɾ a̠ ŋ
새베	sʰ æ b e̞
새벡	sʰ ɛ b e̞ k̚
새위	sʰ æ w i
새헤	sʰ ɛ h e̞
색깔	sʰ æ k̚ k͈ a̠ ɭ
생물권	sʰ æ ŋ m u ɭ ɡ w ə n
생이	sʰ æ ŋ i
서늉	sʰ ə ɲ j u ŋ
서답ᄒᆞ다	sʰ ə d a̠ pʰ ɒ d a̠
서답비누	sʰ ə d a̠ p̚ p͈ i n u
서울	s ə u ɭ
서월	s ə w ə ɭ
서을	sʰ ə ɨ ɭ
석유지름	sʰ ə ɡ j u d͡ʑ i ɾ ɨ m
선승	sʰ ə n sʰ ɨ ŋ
선싕	sʰ ə n ʃʰ i ŋ
선풍기	sʰ ə n pʰ u ŋ ɡ i
설룬	sʰ ə ɭ ɭ ɨ n
섬	s ə m
섭	sʰ ə p̚
성	s ə ŋ
성님	sʰ ə ŋ n i m
성아시	s ə ŋ a̠ ʃ i
성제	s ə ŋ d͡ʑ e̞
성하르방	sʰ ə ŋ h a̠ ɾ ɨ b a̠ ŋ
세	s e
세경넙은드르	sʰ e̞ ɡ j ə ŋ n ə b ɨ n d ɨ ɾ ɨ
세상	sʰ e̞ː sʰ a̠ ŋ
세염	sʰ e̞ː j ə m
세파랑ᄒᆞ다	sʰ e̞ pʰ a̠ ɾ a̠ ŋ ɦ ɒ d a̠
셋	sʰ e̞ː t̚
셍	s e̞ ŋ
셍ᄉᆞ	s e̞ ŋ s ɒ
셍강	sʰ e̞ ŋ ɡ a̠ ŋ
셍일날	sʰ e̞ ŋ i ɭ ɭ a̠ ɭ
소곱	sʰ o̞ ɡ o̞ p̚
소나이	s o̞ n a̠ i
소리	s o̞ ɾ i
소왕벌	sʰ o̞ w a̠ ŋ b ə ɭ
손지	s o̞ n d͡ʑ i
솟	sʰ o̞ t̚
송키	sʰ o̞ ŋ kʰ i
수구룩ᄒᆞ다	sʰ u ɡ u ɾ u kʰ ɒ d a̠
수물	sʰ u m u ɭ
수웨	sʰ u w e̞
순	sʰ u n
순네	sʰ u n n e̞
술칩	sʰ u ʎ t͡ɕʰ i p̚
술펭	sʰ u ɭ pʰ e̞ ŋ
쉐	ɕʰ w e̞
쉐멍에	ɕʰ w e̞ m ə ŋ e̞
쉣ᄇᆞ름	ɕʰ w e̞ t̚ p͈ ɒ ɾ ɨ m
쉬다	ɕʰ w i d a̠
쉬염	ɕʰ w i j ə m
쉰	ʃ w i n
스믈스믈	s ɨ m ɨ ɭ s ɨ m ɨ ɭ
시갠	ɕʰ i ɡ æ n
시금초	ʃ i ɡ ɨ m t͡ɕʰ o̞
시께테물	ʃ i k͈ e̞ tʰ e̞ m u ɭ
시다	ʃ i d a̠
시리	ʃ i ɾ i
시물	ɕʰ i m u ɭ
시믈	ɕ i m ɨ ɭ
시상	ʃ iː sʰ a̠ ŋ
시시리실피	ʃ i ʃ i ɾ i ʃ i ɭ pʰ i
시왕맞이	ʃ i w a̠ ŋ m a̠ d͡ʑ i
시절	ɕʰ i d͡ʑ ə ɭ
시철	ɕʰ i t͡ɕʰ ə ɭ
식게	ɕʰ i k̚ k͈ e̞
신디	ɕʰ i n d i
실	ɕʰ iː ɭ
실기ᄒᆞ다	ʃ i ɭ ɡ i ɦ ɒ d a̠
실피	ɕʰ i ɭ pʰ i
심	ʃ i m
심다	ʃ i m d a̠
심바람ᄒᆞ다	ʃ i m b a̠ ɾ a̠ m ɦ ɒ d a̠
심방	ʃ i m b a̠ ŋ
십관	ʃ i p̚ k͈ w a̠ n
십수매	ʃ i p̚ s͈ u m æ
싯	ɕʰ i t̚
싯다	ʃ i t̚ t͈ a̠
싱각	ɕʰ i ŋ ɡ a̠ k̚
싱싱ᄒᆞ다	ʃ i ŋ ʃ i ŋ ɦ ɒ d a̠
싸무랍다	s͈ a̠ m u ɾ a̠ p̚ t͈ a̠
싸분	s͈ a̠ b u n
쎄다	s͈ʰ e̞ː d a̠
쏨씨	s͈ o̞ m ɕ͈ i
쏭쏭쏭쏭	s͈ o̞ ŋ s͈ o̞ ŋ s͈ o̞ ŋ s͈ o̞ ŋ
쒜	ʃ͈ w e̞
쒜낙마	ɕ͈ʰ w e̞ n a̠ k m a̠
쒜우다	s͈ w e̞ː u d a̠
씨동승	ɕ͈ʰ i d o̞ ŋ sʰ ɨ ŋ
씨롬	ɕ͈ i ɾ o̞ m
씨아방	ɕ͈ʰ i a̠ b a̠ ŋ
씨아주방	ɕ͈ʰ i a̠ d͡ʑ u b a̠ ŋ
씨어멍	ɕ͈ʰ i ə m ə ŋ
아ᇝ	a m
아귀ᄐᆞᆨ	a̠ ɡ w i tʰ ɒ k̚
아깝다	a̠ k͈ a̠ p̚ t͈ a̠
아끼다	a̠ k͈ i d a̠
아덜	a̠ d ɨ ɭ
아루미	a̠ ɾ u m i
아명ᄒᆞ다	a̠ m j ə ŋ ɦ ɒ d a̠
아방	a̠ b a̠ ŋ
아벰	a̠ b e̞ m
아시예	a̠ ɕʰ i j e̞
아옵	a o̞ p̚
아옹	a̠ o̞ ŋ
아은	a ɨ n
아의	a̠ ɰ i
아이다	a̠ i d a̠
아장	a̠ d͡ʑ a̠ ŋ
아접씨	a̠ d͡ʑ ə p̚ ʃ͈ i
아주방	a d͡ʑ u b a ŋ
아피	a̠ pʰ i
아홉	a ɦ o̞ p̚
아흐레	a̠ ɦ ɨ ɾ e̞
악귀	a̠ k̚ k͈ w i
악매	a̠ ŋ m æ
안침	a̠ː ɲ t͡ɕʰ i m
알	a̠ ɭ
알칭	a̠ ʎ t͡ɕʰ i ŋ
암컷	a̠ m kʰ ə t̚
앗	a̠ t̚
앙	a̠ ŋ
앞	a̠ p̚
애옥	ɛ o̞ k̚
야단치다	j a̠ d a̠ ɲ t͡ɕ i d a̠
야이	j a̠ i
야적	j a̠ d͡ʑ ə k̚
야칸	j a̠ː kʰ a̠ n
약방	j a̠ k̚ b a̠ ŋ
얄룹다	j a̠ ɭ ɭ u p̚ t͈ a̠
양	j a̠ ŋ
양착	j a̠ ŋ t͡ɕʰ a̠ k̚
얘펜	j ɛ pʰ e̞ n
어ᄀᆞ라	ə ɡ ɒ ɾ a̠
어ᇝ	ə m
어그네	ə ɡ ɨ n e̞
어껭이	ə k͈ e̞ ŋ i
어느제	ə n ɨ d͡ʑ e
어덕	ə d ə k̚
어드	ə d ɨ
어러러	ə ɾ ə ɾ ə
어멍	ə m ə ŋ
어멤	ə m e̞ m
어사	ə sʰ a̠
어스럼새벨	ə sʰ ɨ ɾ ɨ m sʰ ɛ b e̞ ɭ
어시	ə ʃ i
어시닮다	ə ʃ i d a̠ m t͈ a̠
언	ə n
얼금심금	ə ɭ ɡ ɨ m ɕʰ i m ɡ ɨ m
얼다	ə ɭ d a
얼망얼망	ə ɭ m a̠ ŋ ə ɭ m a̠ ŋ
엄벙덤벙	ə m b ə ŋ d ə m b ə ŋ
엇	ə t̚
엇다	əː t̚ t͈ a̠
에비ᄄᆞᆯ	e̞ b i t͈ ɒ ɭ
에비아ᄃᆞᆯ	e̞ b i a̠ d ɒ ɭ
에어컨	e̞ ə kʰ ə n
엔	e̞ n
엥그리다	e̞ ŋ ɡ ɨ ɾ i d a̠
여시	j ə ʃ i
여이다	j ə i d a̠
여재	j ə d͡ʑ æ
여조케	j ə d͡ʑ o̞ kʰ e̞
여헹	j ə ɦ e̞ ŋ
역세	j ə k s͈ e̞
연기	j ə n ɡ i
열	j ə ɭ
열흘	j ə ɾ ɦ ɨ ɭ
영	j ə ŋ
영등ᄃᆞᆯ	j ə ŋ d ɨ ŋ w o̞ ɭ
예관	j e̞ ɡ w a̠ n
예다	j e̞ d a̠
예숙제낄락	j e̞ sʰ u k̚ t͡ɕ͈ e̞ k͈ i ɭ ɭ a̠ k̚
예순	j e̞ sʰ u n
예쉰	j e̞ sʰ y n
예점	j e̞ d͡ʑ ə m
예점	j e̞ː d͡ʑ ə m
예펜	j e̞ pʰ e̞ n
옛날	j e̞ː n n a̠ ɭ
오널	o̞ n ɨ ɭ
오라방	o̞ ɾ a̠ b a̠ ŋ
오름	o̞ ɾ ɨ m
오메기술	o̞ m e̞ ɡ i sʰ u ɭ
오수매	o̞ s u m æ
오족	o d͡ʑ o k̚
온앵	o̞ n æ ŋ
올흐다	o̞ ɾ h ɨ d a̠
올히	o̞ ɾ h i
옳다	o̞ ɭ tʰ a̠
옺	o̞ t̚
와	w a̠
와당	w a̠ d a̠ ŋ
왁왁ᄒᆞ다	w a̠ ɡ w a̠ kʰ ɒ d a̠
왕상개염지	w a̠ ŋ s a̠ ŋ ɡ æ j ə m d͡ʑ i
왕할망	w a̠ ŋ ɦ a̠ ɭ m a̠ ŋ
왜ᄀᆞᆫ장	w ɛ ɡ ɒ ɲ d͡ʑ a̠ ŋ
왜국	w ɛ ɡ u k̚
왜얏	w ɛ j a̠ t̚
요왕	j o̞ w a̠ ŋ
요자기	j o d͡ʑ a̠ ɡ i
우게	u ɡ e̞
우꿰	u k͈ w e̞
우다	u d a̠
우리	u ɾ i
우리나라	u ɾ i n a̠ ɾ a̠
우투	u tʰ u
울	u ɭ
웃드르	u t̚ t͈ ɨ ɾ ɨ
워립	w ə ɾ i p̚
원셍이	w əː n sʰ e̞ ŋ i
웡웡	w ə ŋ w ə ŋ
웨곳ᄊᆞᆯ	w e̞ ɡ o̞ s s͈ ɒ ɭ
웨국	w e̞ ɡ u k̚
웨다	w e̞ d a̠
웨하르방	w e̞ h a̠ ɾ ɨ b a̠ ŋ
웲기다	w e̞ː m ɡ i d a̠
웽이	w e̞ ŋ i
위염	w i j ə m
유ᄒᆞᆨ	j u h ɒ k̚
육수매	j u k̚ s͈ u m æ
육지	j u k̚ t͡ɕ͈ i
으남지다	ɨ n a̠ m d͡ʑ i d a̠
으라	ɨ ɾ a̠
으룬	ɨ ɾ u n
으멍	ɨ m ə ŋ
으민	ɨ m i n
으쿠다	ɨ kʰ u d a̠
을	ɨ ɭ
음막ᄒᆞ다	ɨ m m a̠ kʰ ɒ d a̠
음묵	ɨ m m u k̚
읏다	ɨ t̚ t͈ a̠
의염의염	ɰ i j ə m ɰ i j ə m
이	i
이ᄉᆞ	i sʰ ɒ
이ᄉᆞᆺ밥	i sʰ ɒ t̚ p͈ a̠ p̚
이까	i k͈ a̠
이녁	i ɲ j ə k̚
이디	i d i
이디저디	i d i d͡ʑ ə d i
이땅	i t͈ a̠ ŋ
이로후제	i ɾ o̞ h u d͡ʑ e̞
이멩이	i m e̞ ŋ i
이서	i sʰ ə
이수매	i s u m æ
이시다	i ɕʰ i d a̠
이왁	i w a̠ k̚
이틀	i tʰ ɨ ɭ
인ᄉᆞᆷ	i n s ɒ m
인간	i n ɡ a̠ n
인측	i ɲ t͡ɕʰ ɨ k̚
인칙이	i ɲ t͡ɕʰ i ɡ i
일	i ɭ
일곱	i ɭ ɡ o p̚
일끔	i ɭ k͈ ɯ m
일롬	i ɭ ɭ o̞ m
일뤠	i ɭ ɭ w e̞
일르다	i ɭ ɭ ɨ d a̠
일본	i ɭ b o̞ n
일월	i ɾ w ə ɭ
일천	i ʎ t͡ɕʰ ə n
일홈	i ɾ h o̞ m
일흔	i ɾ h ɨ n
임	i m
입중	i p̚ t͡ɕ͈ u ŋ
자륜거	t͡ɕ a ɾ j u n ɡ ə
자리	t͡ɕ a̠ ɾ i
자의	t͡ɕ a̠ i
자이	t͡ɕ a̠ i
자치	t͡ɕ a̠ t͡ɕʰ i
작반	t͡ɕ a̠ k̚ p͈ a̠ n
잔치	t͡ɕ a̠ n t͡ɕʰ i
잣	t͡ɕ a̠ t̚
장게	t͡ɕ a̠ ŋ ɡ e̞
장게들다	t͡ɕ a̠ ŋ ɡ e̞ d ɨ ɭ d a̠
장그르헤	t͡ɕ a̠ ŋ ɡ ɨ ɾ ɨ h e̞
저	t͡ɕ ə
저디	t͡ɕ ə ɡ i
저을	t͡ɕ ə ɨ ɭ
전상	t͡ɕ ə n sʰ a̠ ŋ
절	t͡ɕ ə ɭ
절코	t͡ɕ ə ɭ kʰ o̞
절혼	t͡ɕ ə ɾ h o̞ n
젊다	t͡ɕ əː m t͈ a̠
정	t͡ɕ ə ŋ
정싕	t͡ɕ əː ŋ ʃ i ŋ
정월	t͡ɕ ə ŋ w ə ɭ
정지	t͡ɕ ə ŋ d͡ʑ i
제벱	t͡ɕ e̞ b e̞ p̚
제비생이	t͡ɕ e̞ b i sʰ æ ŋ i
제우	t͡ɕ e̞ u
제주도	t͡ɕ e d͡ʑ u d o̞
제주말	t͡ɕ e̞ d͡ʑ u m a̠ ɭ
제주사름	t͡ɕ e̞ d͡ʑ u s a ɾ ɨ m
제집	t͡ɕ e̞ d͡ʑ i p̚
젯	t͡ɕ e̞ t̚
젯가락	t͡ɕ e̞ t̚ k͈ a̠ ɾ a̠ k̚
졍찰	t͡ɕ j əː ŋ t͡ɕʰ a
조고만ᄒᆞ다	t͡ɕ o̞ ɡ o̞ m a̠ n h ɒ d a̠
조랑내	t͡ɕ o̞ ɾ a̠ ŋ n æ
조선	t͡ɕ o̞ s ə n
조선ᄀᆞᆫ장	t͡ɕ o̞ sʰ ə n ɡ ɒ ɲ d͡ʑ a̠ ŋ
조선시대	t͡ɕ o̞ s ə n ʃ i d æ
조용ᄒᆞ다	t͡ɕ o̞ j o ŋ h ɒ d a̠
조쟁이	t͡ɕ o̞ d͡ʑ æ ŋ i
족다	t͡ɕ o̞ k̚ t͈ a
족은아방	t͡ɕ o̞ ɡ ɨ n a̠ b a̠ ŋ
족은어멍	t͡ɕ o̞ ɡ ɨ n ə m ə ŋ
졸바로	t͡ɕ o̞ ɭ p͈ a̠ ɾ o̞
종이	t͡ɕ o̞ ŋ i
좋다	t͡ɕ o̞ tʰ a̠
좋아ᄒᆞ다	t͡ɕ o̞ː a̠ h ɒ d a̠
주만	t͡ɕ u m a̠ n
주시	t͡ɕ u ʃ i
주연	t͡ɕ u j ə n
주인공	t͡ɕ u i n ɡ o̞ ŋ
줄ᄃᆞᆼ길락	t͡ɕ u ɭ d ɒ ŋ ɡ i ɭ ɭ a̠ k̚
줌칫	t͡ɕ u m t͡ɕʰ i t̚
줏다	t͡ɕ u t̚ t͈ a̠
줴께	t͡ɕ w e̞ k͈ e̞
쥉이	t͡ɕ w e̞ ŋ i
쥉이헤치	t͡ɕ w e̞ ŋ i ɦ e̞ t͡ɕʰ i
쥬	t͡ɕ j u
지	t͡ɕ i
지갑	t͡ɕ i ɡ a̠ p̚
지둥	t͡ɕ i d u ŋ
지드리다	t͡ɕ i d ɨ ɾ i d a̠
지름	t͡ɕ i ɾ ɨ m
지쁘다	t͡ɕ i p͈ ɨ d a̠
지슬	t͡ɕ i s ɨ ɭ
지주	t͡ɕ iː d͡ʑ u
지집	t͡ɕ i d͡ʑ i p̚
지집아의	t͡ɕ i d͡ʑ i b a̠ i
지침	t͡ɕ i t͡ɕʰ i m
지프다	t͡ɕ i pʰ ɨ d a̠
지피	t͡ɕ i pʰ i
질겁다	t͡ɕ i ɭ ɡ ə p̚ t͈ a̠
질다	t͡ɕ iː ɭ d a
질헤늙다	t͡ɕ i ɾ ɦ e̞ n ɨ k̚ d a̠
짐셍	t͡ɕ i m sʰ e̞ ŋ
짐승	t͡ɕ i m sʰ ɨ ŋ
집	t͡ɕ i p̚
집가제	t͡ɕ i p̚ k͈ a̠ d͡ʑ e̞
짜르다	t͡ɕ͈ a ɾ ɨ d a
찝	t͈ ɕ i p̚
찰락찰락	t͡ɕʰ a̠ ɭ ɭ a̠ k̚ t͡ɕ͈ʰ a̠ ɭ ɭ a̠ k̚
참웨	t͡ɕʰ a̠ m w e̞
채	t͡ɕʰ æ
처왐	t͡ɕʰ ə w a̠ m
천ᄌᆞ국	t͡ɕʰ ə n d͡ʑ ɒ ɡ u k̚
천지만지	t͡ɕʰ ə ɲ d͡ʑ i m a̠ ɲ d͡ʑ i
천징	t͡ɕʰ ə ɲ d͡ʑ i ŋ
체	t͡ɕʰ e̞
체소	t͡ɕʰ e̞ː sʰ o̞
첵	t͡ɕʰ e k̚
쳇	t͡ɕʰ e̞ t̚
초싱ᄃᆞᆯ	t͡ɕʰ o̞ ɕʰ i ŋ t͈ ɒ ɭ
총뽀롱이	t͡ɕʰ o̞ ŋ p͈ o̞ ɾ o̞ ŋ i
축하헴수다	t͡ɕʰ u kʰ a̠ ɦ e̞ m s u d a̠
췌	t͡ɕʰ w e̞
치다	t͡ɕ i d a̠
칙간	t͡ɕʰ i k̚ k͈ a̠ n
친귀	t͡ɕʰ i n ɡ y
칠뤌	t͡ɕʰ i ɭ ɭ w ə ɭ
칠수매	t͡ɕʰ i ɭ s u m æ
칭계	t͡ɕʰ i ŋ ɡ j e̞
콘도	kʰ o̞ n d o̞
콩ᄑᆞᆺ	kʰ o̞ ŋ pʰ ɒ t̚
쿠세	kʰ u sʰ e̞
쿨	kʰ u ɭ
퀘끼리	kʰ w e̞ k͈ i ɾ i
퀴다	kʰ w i d a̠
크라	kʰ ɨ ɾ a̠
큰아방	kʰ ɨ n a̠ b a̠ ŋ
큰어멍	kʰ ɨ n ə m ə ŋ
키로	k i ɾ o̞
키여	kʰ i j ə
타글락타글락	tʰ a̠ ɡ ɨ ɭ ɭ a̠ k̚ tʰ a̠ ɡ ɨ ɭ ɭ a̠ k̚
탐라	tʰ a̠ m n a̠
탐라국	tʰ a̠ m n a̠ ɡ u k̚
텔레비전	tʰ e̞ ɭ ɭ e̞ b i d͡ʑ ə n
통쒜	tʰ o̞ ŋ s͈ w e̞
퉤꼐	tʰ w e̞ k͈ j e̞
퉤끼	tʰ w e̞ k͈ i
튼나다	tʰ ɨ n n a̠ d a̠
튼봉ᄉᆞ	tʰ ɨ n b o̞ ŋ sʰ ɒ
팔수매	pʰ a̠ ɭ s u m æ
퍼렁ᄒᆞ다	pʰ ə ɾ ə ŋ h ɒ d a̠
펀	pʰ ə n
펜안ᄒᆞ다	pʰ e̞ n a̠ n ɦ ɒ d a̠
펜안ᄒᆞ우꽈	pʰ e̞ n a̠ n ɦ ɒ u k͈ w a̠
펜지	pʰ e̞ː ɲ d͡ʑ i
펭승	pʰ e̞ ŋ sʰ ɨ ŋ
펭지	pʰ e̞ ŋ d͡ʑ i
푼체	pʰ u ɲ t͡ɕʰ e̞
풍력단지	pʰ u ŋ n j ə k̚ t͈ a̠ n d͡ʑ i
하늘님	h a̠ n ɨ ɭ ɭ i m
하니ᄇᆞ름	h a̠ n i b ɒ ɾ ɨ m
하다	h a̠ d a̠
하르바님	h a̠ ɾ ɨ b a̠ n i m
하르방	h a ɾ ɨ b a ŋ
하를	h a̠ ɾ ɨ ɭ
하시	h a̠ ʃ i
하위염ᄒᆞ다	h a̠ w i j ə m h ɒ d a̠
한ᄌᆞ	h a n d͡ʑ ɒ
한국	h a̠ n ɡ u k̚
한국말	h a̠ n ɡ u ŋ m a̠ ɭ
한국사름	h a̠ n ɡ u k s͈ a̠ ɾ ɨ m
한라산	h a̠ ɭ ɭ a̠ sʰ a̠ n
할망	h a̠ ɭ m a̠ ŋ
할이	h a̠ ɾ i
함박눈	h a̠ m b a̠ ŋ n u n
항고지	h a̠ ŋ ɡ o̞ d͡ʑ i
해섬	h æː sʰ ə m
햇빗	h ɛ t̚ p͈ i t̚
헙개미	h ə p̚ k͈ ɛ m i
헤양ᄒᆞ다	h e̞ː j a̠ ŋ h ɒ d a̠
헤치	h e̞ t͡ɕʰ i
호나	h o̞ n a
호렝이	h o̞ ɾ e̞ ŋ i
홀아방	h o̞ ɭ ɭ a̠ b a̠ ŋ
홀어멍	h o̞ ɭ ɭ ə m ə ŋ
홍압	h o̞ ŋ a̠ p̚
환재	h w a̠ː ɲ d͡ʑ ɛ
활동사진	h w a̠ ɭ d o̞ ŋ s a̠ d͡ʑ i n
황고지	h w a̠ ŋ ɡ o̞ d͡ʑ i
훍다	h uː k̚ t͈ a̠
훤씬	h w ə n ɕ͈ i n
흑	h ɨ k̚
흑벡	h ɨ k p͈ e̞ k̚
흘르다	h ɨ ɭ ɭ ɨ d a̠
히망	h i m a̠ ŋ
히엄	h i ə m
