a	ɑ
ab	ɑ b
abb	ɑ b
algid	ɑ l ɡ i d
algõ	ɑ l ɡ ə
algõd	ɑ l ɡ ə d
algõm	ɑ l ɡ ə m
alli	ɑ lː i
allitas	ɑ lː i t ɑ s
alumīnij	ɑ l u m iː n i j
alā	ɑ l ɑː
amērik	ɑ m eː r i k
analīz	ɑ n ɑ l iː z
analōg	ɑ n ɑ l oː ɡ
analōgij	ɑ n ɑ l oː ɡ i j
and	ɑ n d
april	ɑ p r i l
atrāita	ɑ t r ɑː i t ɑ
atrāitanai	ɑ t r ɑː i t ɑ n ɑ i
austrij	ɑ u s t r i j
azūmsõnā	ɑ z uː m s ɯ n ɑː
aššõ	ɑ ʃː ə
ažāsõnā	ɑ ʒ ɑː s ɯ n ɑː
b	b
bakbord	b ɑ k b o r d
belgij	b e l ɡ i j
beļgij	b e ʎ ɡ i j
blēḑ	b l eː ɟ
bosnij	b o s n i j
boŗ	b o rʲ
brissõl	b r i sː ə l
brēḑig	b r eː ɟ i ɡ
brīõz	b r iː ə z
brūokst	b r uː o k s t̪
bulgārij	b u l ɡ ɑː r i j
bäzmõr	b æ z m ə r
bōr	b oː r
d	d̪
dattõd	d ɑ tː ə d
detsembõr	d e t s e m b ə r
drūošõ	d r uː o ʃ ə
dēņmō	d eː ɲ m ɒː
dūoņig	d uː o ɲ i ɡ
e	e
eirōp	e i r oː p
englišmō	e ŋ ɡ l i ʃ m ɒː
engõlmō	e ŋ ɡ ə l m ɒː
eļļõ	e ʎː ə
ežmi	e ʒ m i
ežžõmpǟva	e ʒː ə m p æː v ɑ
f	f
februar	f e b r u ɑ r
februār	f e b r u ɑː r
frantsij	f r ɑ n t s i j
g	ɡ
gipk	ɡ i p k
grēkõmō	ɡ r eː k ə m ɒː
grīekmō	ɡ r iː e k m ɒː
h	x
holand	h o l ɑ n d
horvātij	h o r v ɑː t i j
ibbi	i bː i
ikšlug	i k ʃ l u ɡ
ikštuoistõn	i k ʃ t u o i s t ə n
informātsij	i n f o r m ɑː t s i j
irē	i r eː
island	i s l ɑ n d
itālij	i t ɑː l i j
itāļmō	i t ɑː ʎ m ɒː
iz	i z
izrael	i z r ɑ e l
izraēl	i z r ɑ eː l
izt	i z t
izā	i z ɑː
j	j
janvār	j ɑ n v ɑː r
jeimer	j e i m e r
jellõ	j e lː ə
jelāmi	j e l ɑː m i
jemā	j e m ɑː
jo	j o
joutõmläpš	j o u t ə m l æ p ʃ
juo	j u o
jālga	j ɑː l ɡ ɑ
jālgab	j ɑː l ɡ ɑ b
jūdõmō	j uː d ə m ɒː
jūlij	j uː l i j
jūnij	j uː n i j
jūoji	j uː o j i
k	k
kakštuoistõn	k ɑ k ʃ t u o i s t ə n
kalā	k ɑ l ɑː
kalāmīez	k ɑ l ɑː m iː e z
kanā	k ɑ n ɑː
kanād	k ɑ n ɑː d
kaš	k ɑ ʃ
kež	k e ʒ
kievādkū	k i e v ɑː d k uː
kimdõ	k i m d ə
kimdõz	k i m d ə z
kinō	k i n oː
knaš	k n ɑ ʃː
krīevmō	k r iː e v m ɒː
krīevõmō	k r iː e v ə m ɒː
kuddõ	k u d̪ː ə
kuldīg	k u l d iː ɡ
kuod	k u o d
kuolm	k u o l m
kuolmtuoistõn	k u o l m t u o i s t ə n
kuolmõndpǟva	k u o l m ə n d p æː v ɑ
kuoštrõg	k u o ʃ t r ə ɡ
kuoț	k u o c
kurmō	k u r m ɒː
kurāmō	k u r ɑː m ɒː
kõzzi	k ɯ zː i
kāndab	k ɑː n d ɑ b
kēratiji	k eː r ɑ t̪ i j i
kēratēḑ	k eː r ɑ t eː ɟ
kēļ	k eː ʎ
kīlmakū	k iː l m ɑ k uː
kīnõmō	k iː n ə m ɒː
kīņtš	k iː ɲ t͡ʃ
kīņḑõļkū	k iː ɲ ɟ ə ʎ k uː
kōdõkskimdõz	k oː d ə k s k i m d ə z
kōdõkstuoistõn	k oː d ə k s t u o i s t ə n
kōrand	k ɒː r ɑ n d̪
kōŗa	k ɒː rʲ ɑ
kū	k uː
kūlõ	k uː l ə
kūolka	k uː o l k ɑ
kūora	k uː o r ɑ
kūž	k uː ʒ
kūžtuoistõn	k uː ʒ t u o i s t ə n
kȭļimkū	k ɯː ʎ i m k uː
l	l
lapsvȱidaji	l ɑ p s v ɤː i d ɑ j i
leišmō	l e i ʃ m ɒː
leišõmō	l e i ʃ ə m ɒː
lešk	l e ʃ k
lešknai	l e ʃ k n ɑ i
lețmō	l e c m ɒː
likkõ	l i kː ə
lugsõnā	l u ɡ s ɯ n ɑː
läpš	l æ p ʃ
lēḑkū	l eː ɟ k uː
līdõ	l iː d ə
līvõmō	l iː v ə m ɒː
lōja	l ɒː j ɑ
lōlami	l oː l ɑ m i
lūž	l uː ʒ
lǟdõ	l æː d ə
m	m
maij	m ɑ i j
minā	m i n ɑː
mitskimdõ	m i t s k i m d ə
moskov	m o s k o v
moskov	m o s k o w
munādkuoț	m u n ɑː d k u o c
mustānum	m u s t ɑː n u m
märts	m æ r t s
mõtlõ	m ɯ t̪ l ə
mēg	m eː ɡ
mīez	m iː e z
mō	m ɒː
mōmīez	m ɒː m iː e z
mǟdlõ	m æː d l ə
mȭka	m ɯː k ɑ
n	n
ne	n e
neitški	n e i t͡ʃ k i
neļļõndpǟva	n e ʎː ə n d p æː v ɑ
nimsõnā	n i m s ɯ n ɑː
norvēgij	n o r v eː ɡ i j
norvēgmō	n o r v eː ɡ m ɒː
novembõr	n o v e m b ə r
nädīļ	n æ d iː ʎ
nēļatuoistõn	n eː ʎ ɑ t u o i s t ə n
nēḑi	n eː ɟ i
nūoŗ	n uː o rʲ
nūoŗkazām	n uː o rʲ k ɑ z ɑː m
nūoŗkū	n uː o rʲ k uː
nūoŗmīez	n uː o rʲ m iː e z
nūoŗpōr	n uː o rʲ p ɒː r
nūoŗpōŗ	n uː o rʲ p ɒː rʲ
nǟdõ	n æː d ə
o	o
oktōbõr	o k t oː b ə r
opātiji	o p ɑː t̪ i j i
ougust	o u ɡ u s t
p	p
partikõl	p ɑ r t̪ i k ə l
pațīkmō	p ɑ c iː k m ɒː
pitrõg	p i t r ə ɡ
pivāpǟva	p i v ɑː p æː v ɑ
pizā	p i z ɑː
piņ	p i ɲ
polākõz	p o l ɑː k ə z
portugal	p o r t u ɡ ɑ l
portugāl	p o r t u ɡ ɑː l
prantsūzmō	p r ɑ n t s uː z m ɒː
prantšmō	p r ɑ n t ʃ m ɒː
prepozītsij	p r e p o z iː t s i j
prepozītsijõ	p r e p o z iː t̪ s i j ə
pärsōn	p æ r s oː n
pānda	p ɑː n d ə
pōr	p ɒː r
pōrkimdõ	p ɒː r k i m d ə
pōŗ	p ɒː rʲ
pōŗkimdõ	p ɒː rʲ k i m d ə
pū	p uː
pūoga	p uː o ɡ ɑ
pūojmer	p uː o j m e r
pūolpǟva	p uː o l p æː v ɑ
pūoļmō	p uː o ʎ m ɒː
pūošt	p uː o ʃ t̪
pǟ	p æː
pǟgiņlug	p æː ɡ i ɲ l u ɡ
pǟrnov	p æː r n o v
pǟrnov	p æː r n o w
pǟva	p æː v ɑ
pǟvaīe	p æː v ɑ iː e
pȯis	p ɤ i s
pȯiški	p ɤ i ʃ k i
r	r
rištīng	r i ʃ t iː ŋ ɡ
rumāņmō	r u m ɑː ɲ m ɒː
rumēnij	r u m eː n i j
rõkāndiji	r ɯ k ɑː n d̪ i j i
rõkāndõ	r ɯ k ɑː n d̪ ə
rānda	r ɑː n d̪ ɑ
rīgõ	r iː ɡ ə
rō	r ɒːˀ
rōntõz	r oː n t ə z
rūnõ	r uː n ə
rūnõmō	r uː n ə m ɒː
rūoj	r uː o j
rūotšmō	r uː o t ʃ m ɒː
s	s
saksāmō	s ɑ k s ɑː m ɒː
salāts	s ɑ l ɑː t s
seistuoistõn	s e i s t u o i s t ə n
septembõr	s e p t e m b ə r
serbij	s e r b i j
setkimdõ	s e t k i m d ə
sibīrij	s i b iː r i j
sigā	s i ɡ ɑː
sigžkū	s i ɡ ʒ k uː
sinā	s i n ɑː
siḑīmsõnā	s i ɟ iː m s ɯ n ɑː
slovēnij	s l o v eː n i j
spāņ	s p ɑː ɲ
spāņmō	s p ɑː ɲ m ɒː
statsij	s t ɑ t s i j
sukā	s u k ɑː
sõnā	s ɯ n ɑː
sõnārōntõz	s ɯ n ɑː r oː n t̪ ə z
sīemi	s iː e m i
sīkrõg	s iː k r ə ɡ
sīlma	s iː l m ɑ
sōrmō	s oː r m ɒː
sūo	s uː o
sūomli	s uː o m l i
sūomõmō	s uː o m ə m ɒː
sǟnag	s æː n ɑ ɡ
t	t̪
tint	t i n t
tirkmō	t i r k m ɒː
tsukkõr	t̪ s u kː ə r
tsībõrmō	t s iː b ə r m ɒː
tukāmō	t u k ɑː m ɒː
tuoistõn	t u o i s t ə n
tuoistõnz	t u o i s t ə n z
tämā	t æ m ɑː
tēg	t̪ eː ɡ
tēriņtš	t̪ eː r i ɲ t̪ ʃ
tēḑ	t̪ eː ʔ ɟ
tīemizsõnā	t iː e m i z s ɯ n ɑː
tīepǟva	t iː e p æː v ɑ
tōvaz	t oː v ɑ z
tūlda	t uː l d ə
tūoiznapǟva	t u o i z n ɑ p æː v ɑ
u	u
um	u m
ummitsõnā	u mː i t s ɯ n ɑː
ungārmō	u ŋ ɡ ɑː r m ɒː
v	v
vaid	v ɑ i d
vanā	v ɑ n ɑː
vel	v e l
veļ	v e ʎ
vež	v e ʒ
vidumō	v i d u m ɒː
vidūmō	v i d uː m ɒː
vigā	v i ɡ ɑː
värb	v æ r b
vāldakrīevmō	v ɑː l d ɑ k r iː e v m ɒː
vāldamer	v ɑː l d ɑ m e r
vēna	v eː n ɑ
vīmkū	v iː m k uː
vīļakū	v iː ʎ ɑ k uː
vīžtuoistõn	v iː ʒ t u o i s t ə n
vīțsõnā	v iː c s ɯ n ɑː
vǟnta	v æː n t ɑ
vȯl	v ɤ l
vȯlmsõnā	v ɤ l m s ɯ n ɑː
vȯņ	v ɤ ɲː
vȱlda	v ɤː l d ɑ
vȱntsa	v ɤː n t s ɑ
z	z
ä	æ
äb	æ b
äbknaš	æ b k n ɑ ʃ
äd	æ d
äl	æ lː
äm	æ m
ämār	æ m ɑː r
ät	æ t
õ	ə
õ	ɯ
ā	ɑː
āigast	ɑː i ɡ ɑ s t̪
āinakū	ɑː i n ɑ k uː
ē	eː
ēstimō	eː s t i m ɒː
ī	iː
īdõkssadā	iː d ə k s s ɑ d ɑː
īdõkstuoistõn	iː d ə k s t u o i s t ə n
īdõkstuoistõnz	iː d ə k s t u o i s t ə n z
īevad	iː e v ɑ d̪
īra	iː r ɑ
īrõmō	iː r ə m ɒː
īsland	iː s l ɑ n d
ļ	ʎ
ņ	ɲ
ō	oː
ōj	ɒː j
ŗ	rʲ
š	ʃ
šveits	ʃ v e i t s
ū	uː
ūomõg	uː o m ə ɡ
ūžkilā	uː ʃ k i l ɑː
ž	ʒ
ǟ	æː
ǟma	æː m ɑ
ț	c
ȭ	ə
ȭ	ɯː
ȭdõg	ɯː d ə ɡ
ȯ	ɤ
ȱ	ɤː
ḑ	ɟ
