a	aː
aachtel	aː χ t ə l
aalbes	aː l b ə s
aangel	aː ŋ ə l
aarbecht	aː ʀ b ə ɕ t
aarbechter	aː ʀ b ə ɕ t ɐ
aarbechtsamt	aː ʀ b ə ʑ d z ɑ m p t
aarbechtslos	aː b ə ɕ t s l oː s
aarmséileg	aː ʀ m z ɜ ɪ̯ l ə ɕ
aart	aː t
aart	aː χ t
aartlech	aː t l ə ɕ
aaschbak	aː ʒ b aː k
abeezen	ɑ b eː t͡s ə n
abenteuerlech	aː b e n t o ɪ̯ ɐ l ə ɕ
aberuffen	ɑ b ə ʀ u f ə n
aberuffung	ɑ b ə ʀ u f u ŋ
abezuelen	ɑ b ə t͡s u ə̯ l ə n
abgascht	aː b ɡ ɑ ʃ t
abilden	ɑ b i l d ə n
abiméieren	ɑ b i m ɜ ɪ̯ ə ʀ ə n
ablécklech	ɑ b l e k l ə ɕ
abonnement	ɑ b o n ə m ɑ̃ː
abrëll	ɑ b ʀ ə l
abseits	ɑ b z ɑ ɪ̯ t͡s
absence	ɑ p s ɑ̃ː s
absichtlech	ɑ b z i ɕ t l ə ɕ
absurd	ɑ b z u χ t
abuddelen	ɑ b u d ə l ə n
abus	ɑ b yː
abéissen	ɑ b ɜ ɪ̯ s ə n
accabléiert	ɑ k ɑ b l ɜ ɪ̯ ɐ t
acceleratioun	ɑ k s ə l ə ʀ ɑ t s j ə ʊ̯ n
achs	ɑ k s
achzeg	ɑ χ t͡s ə ɕ
adder	ɑ d ɐ
adjektiv	ɑ d ʒ æ k t iː f
adler	aː d l ɐ
administrativ	ɑ d m i n i s t ʀ ɑ t iː f
adresse	ɑ d ʀ æ s
advent	ɑ d v æ n t
adverb	ɑ t v æ χ p
aen	aː ə n
aendeckel	aː ə n d æ k ə l
aenzeien	aː ə n t͡s ɑ ɪ̯ ə n
afaassen	ɑ f aː s ə n
afalen	ɑ f aː l ə n
afen	aː f ə n
afennoss	aː f ə n o s
afetten	ɑ f æ t ə n
affekot	ɑ f ə k oː t
affer	ɑ f ɐ
afferen	ɑ f ə ʀ ə n
afferstack	ɑ f ɐ ʃ t ɑ k
affiche	ɑ f i ʃ
affront	ɑ f ʀ õː
afloss	ɑ f l o s
agang	ɑ ɡ ɑ ŋ
agank	ɑ ɡ ɑ ŋ k
agemaachtes	ɑ ɡ ə m aː χ t ə s
ageriicht	ɑ ɡ ə ʀ iː ɕ t
aggressiv	ɑ ɡ ʀ æ s iː f
agäng	aː ɡ æ ŋ
ahnen	aː n ə n
akademie	ɑ k ɑ d ə m iː
akaul	aː k ɑ ʊ̯ l
aker	aː k ɐ
akerbau	aː k ɐ b ɑ ʊ̯
akribesch	ɑ k ʁ iː b ə ʃ
akrobatik	ɑ k ʀ o b aː t i k
akt	ɑ k t
aktuell	ɑ k t u æ l
akupunktur	ɑ k u p u ŋ k t uː ɐ
albanien	ɑ l b aː n j ə n
aleeën	ɑ l eː ə n
alkohol	ɑ l k o h oː l
alkoholismus	ɑ l k o h o l i z m u s
all	ɑ l
alldag	ɑ l d aː χ
allee	ɑ l eː
allerhellegen	ɑ l ɐ h æ l ə j ə n
allerséilen	ɑ l ɐ z ɜ ɪ̯ l ə n
alles	ɑ l ə s
allmächteg	ɑ l m æ ɕ t ə ɕ
aloggen	ɑ l o ɡ ə n
alpdram	ɑ l b d ʀ aː m
als	ɑ l t s
also	ɑ l z o
alt	ɑ l t
alter	ɑ l t ɐ
alzem	ɑ l t͡s ə m
ameis	aː m ɑ ɪ̯ s
amplaz	ɑ m p l aː t͡s
an	ɑ n
ananas	ɑ n ɑ n ɑ s
anchecken	ɑ n t ʃ æ k ə n
anchois	ɑ̃ ʃ w aː
andecken	ɑ n d æ k ə n
andeelen	ɑ n d eː l ə n
andeelung	ɑ n d eː l u ŋ
andeems	ɑ n d eː m p s
andreiwen	ɑ n d ʀ ɑ ɪ̯ v ə n
androen	ɑ n d ʀ oː ə n
andéif	ɑ n d ɜ ɪ̯ f
aner	aː n ɐ
anescht	aː n ə ʃ t
angscht	ɑ ŋ k ʃ t
animatioun	ɑ n i m ɑ t s j ə ʊ̯ n
antigel	ɑ n t i ʒ æ l
apaart	ɑ p aː t
apaart	ɑ p aː χ t
apdikt	ɑ b d i k t
apel	aː p ə l
apelbatz	aː p ə l b ɑ t͡s
aper	aː p ɐ
aperhoer	aː p ɐ h oː ɐ
aplaz	ɑ p l aː t͡s
apostroph	a p o s t ʀ o f
appartement	ɑ p aː χ t ə m ɑ̃ː
appartement	ɑ p ɑ χ t ə m ɑ̃ː
appell	ɑ p æ l
aprikos	ɑ p ʀ i k oː s
ar	aː χ
arithmetik	ɑ ʀ i d m eː t i k
arroganz	ɑ ʀ o ɡ ɑ n t s
artichaut	ɑ χ t i ʃ oː
artillerie	ɑ χ t i l ə ʀ iː
aschléissen	ɑ ʃ l ɜ ɪ̯ s ə n
aschätzen	ɑ ʃ æ t͡s ə n
asetzen	ɑ z æ t͡s ə n
assurance	ɑ s y ʀ ɑ̃ː s
astrologie	ɑ s t ʀ o l o ʒ iː
aubergine	o b æ ʀ ʒ i n
aubergine	o b ɐ ʒ i n
auder	ɑ ʊ̯ d ɐ
auer	ɑ ʊ̯ ɐ
auermécher	ɑ ʊ̯ ɐ m ə ɕ ɐ
august	ɑ ʊ̯ ɡ u s t
aus	æˑ ʊ̯ s
ausbriechen	æˑ ʊ̯ s b ʀ i ə̯ ɕ ə n
ausdoen	æˑ ʊ̯ s d oː e n
ausdroen	æˑ ʊ̯ s d ʀ oː ə n
ausgab	æˑ ʊ̯ s ɡ aː p
ausginn	æˑ ʊ̯ s ɡ i n
auskommen	æˑ ʊ s k o m ə n
ausleeën	æˑ ʊ̯ s l eː ə n
ausloggen	æˑ ʊ̯ s l o ɡ ə n
ausmaachen	æˑ ʊ̯ s m aː χ ə n
ausruffzeechen	æˑ ʊ̯ z ʀ u f t͡s eː ɕ ə n
ausschléissen	æˑ ʊ̯ s ʃ l ɜ ɪ̯ s ə n
ausschwätzen	æˑ ʊ̯ s ʃ w æ t͡s ə n
aussetzen	æˑ ʊ̯ s z æ t͡s ə n
aussetzen	æˑ ʊ̯ s æ t͡s ə n
auteur	o t øː ɐ
auto	ɑ ʊ̯ t o
autorisatioun	o t o ʀ i z ɑ t͡s j ə ʊ̯ n
autoscourse	ɑ ʊ̯ t o s k u χ s
aviatioun	ɑ v j ɑ t s j ə ʊ̯ n
avion	ɑ v j o ŋ
avion	ɑ v j õː
awanderen	ɑ v ɑ n d ə ʀ ə n
awanderung	ɑ v ɑ n d ə ʀ u ŋ
awar	ɑ v aː
awar	ɑ v aː χ
awer	aː v ɐ
awunner	ɑ v u n ɐ
baachnénga	b aː ʁ n e ŋ a
baarf	b aː f
baarf	b aː χ f
baarmhäerzegkeet	b aː ʀ m h ɛ ə̯ t͡s ə ɕ k eː t
baart	b aː t
baart	b aː χ t
baatsch	b aː t͡ʃ
badminton	b æ d m i n t ə n
baken	b aː k ə n
ball	b ɑ l
bampiipsert	b aː m p iː p s ɐ t
banann	b ɑ n ɑ n
band	b ɑ n t
bandscheif	b ɑ n t͡ʃ ɑ ɪ̯ f
bank	b ɑ ŋ k
bankrott	b ɑ ŋ k ʀ o t
bann	b ɑ n
bannen	b ɑ n ə n
bascht	b ɑ ʃ t
basketball	b aː s k ə d b ɑ l
bass	b ɑ s
batter	b ɑ t ɐ
batz	b ɑ t͡s
bau	b æˑ ʊ̯
bauch	b æˑ ʊ̯ χ
bauchspeicheldrüs	b æˑ ʊ̯ χ ʃ p ɑ ɪ̯ ɕ ə l d ʀ yː s
bauen	b ɑ ʊ̯ ə n
bauer	b ɑ ʊ̯ ɐ
bauerenhaff	b ɑ ʊ̯ ə ʀ ə n h ɑ f
baussen	b æˑ ʊ̯ s ə n
baussent	b æˑ ʊ̯ s ə n t
beamten	b ə ɑ m t ə n
becher	b æ ɕ ɐ
bedeckt	b ə d æ k t
bedeelegung	b ə d eː l ə ʑ u ŋ
bedeiten	b ə d ɑ ɪ̯ t ə n
bedeitung	b ə d ɑ ɪ̯ t u ŋ
bedruch	b ə d ʀ u χ
bedrécken	b ə d ʀ e k ə n
beezen	b eː t͡s ə n
befielen	b ə f i ə̯ l ə n
begieren	b ə ɡ i ə̯ ʀ ə n
begierlech	b ə ɡ iː ɐ l ə ɕ
begierlechkeet	b ə ɡ iː ɐ l ə ɕ k eː t
begleeden	b ə ɡ l eː d ə n
begräifen	b ə ɡ ʀ æˑ ɪ̯ f ə n
begréissen	b ə ɡ ʀ ɜ ɪ̯ s ə n
begrëff	b ə ɡ ʀ ə f
begrënnen	b ə ɡ ʀ ə n ə n
begéinen	b ə ɡ ɜ ɪ̯ n ə n
behaapten	b ə h aː p t ə n
behuelen	b ə h u ə̯ l ə n
behälter	b ə h æ l t ɐ
bei	b ɑ ɪ
bei	b ɑ ɪ̯
beicht	b ɑ ɪ̯ ɕ t
beichtstull	b ɑ ɪ̯ ɕ t ʃ t u l
beidel	b ɑ ɪ̯ d ə l
beim	b ɑ ɪ̯ m
beispill	b ɑ ɪ̯ ʃ p i l
bekassinn	b e k ɑ s i n
beleedegen	b ə l eː d ə ʑ ə n
beleeën	b ə l eː ə n
beleidegen	b ə l ɑ ɪ̯ d ə ʑ ə n
belsch	b æ l t ʃ
belschen	b æ l ʃ ə n
beléift	b ə l ɜ ɪ̯ f t
bemierken	b ə m i ə̯ k ə n
bemierkung	b ə m i ə̯ k u ŋ
beobachten	b ə oː b ɑ χ t ə n
bereien	b ə ʀ ɑ ɪ̯ ə n
beriichten	b ə ʀ iː ɕ t ə n
beruff	b ə ʀ u f
beréieren	b ə ʀ ɜ ɪ̯ ə ʀ ə n
beréierung	b ə ʀ ɜ ɪ̯ ə ʀ u ŋ
beschléissen	b ə ʃ l ɜ ɪ̯ s ə n
beschreiwen	b ə ʃ ʀ ɑ ɪ̯ v ə n
beschränken	b ə ʃ ʀ æ ŋ k ə n
beschwéiert	b ə ʃ w ɜ ɪ̯ ɐ t
besetzen	b ə z æ t s ə n
besonnesch	b ə z o n ə ʃ
bespriechen	b ə ʃ p ʀ i ə̯ ɕ ə n
besserung	b æ s ə ʀ u ŋ
bestanddeel	b ə ʃ t ɑ n d d eː l
bestellen	b ə ʃ t æ l ə n
bestiits	b ə ʃ t iː t s
bestit	b ə ʃ t iː t
bestrofen	b ə ʃ t ʀ oː f ə n
bestueden	b ə ʃ t u ə̯ d ə n
bestuet	b ə ʃ t u ə̯ t
besuch	b ə z u χ
betounen	b ə t ə ʊ̯ n ə n
bettseechesch	b æ d z eː ɕ ə ʃ
beuechten	b ə u ə̯ ɕ t ə n
bevëlkerung	b ə f ə l k ə ʀ u ŋ
bewonnerung	b ə v o n ə ʀ u ŋ
bewäis	b ə v æˑ ɪ̯ s
bezeechnen	b ə t͡s eː ɕ n ə n
bezeechnung	b ə t͡s eː ɕ n u ŋ
bezeien	b ə t͡s ɑ ɪ̯ ə n
bezuch	b ə t͡s u χ
bezuelen	b ə t͡s u ə̯ l ə n
bezweiwelen	b ə t͡s w ɑ ɪ̯ v ə l ə n
bibel	b iː b ə l
biber	b iː b ɐ
bich	b i ɕ
bichelchen	b i ɕ ə l ɕ ə n
bicherbuttek	b i ɕ ɐ b u t e k
bicherwuerm	b i ɕ ɐ v u ə̯ m
bidden	b i d ə n
bidet	b i d eː
bieden	b i ə̯ d ə n
bier	b i ə̯
bier	b iː ɐ
bierg	b i ə̯ ɕ
biergen	b i ə̯ ʑ ə n
bierger	b i ə̯ ʑ ɐ
biergof	b i ə̯ ʑ oː f
biergop	b i ə̯ ʑ o p
bierk	b i ə̯ k
biesem	b i ə̯ z ə m
biewen	b i ə̯ v ə n
bifdeck	b i v d æ k
bigel	b i ʑ ə l
biichten	b iː ɕ t ə n
bijoutier	b i ʒ u t j eː
bilden	b i l d ə n
bildschierm	b i l t͡ʃ i ə̯ m
billard	b i l j aː χ
billen	b i l ə n
bindestréch	b i n d ə ʃ t ʀ ə ɕ
biologie	b i o l o ʒ iː
bir	b i ə̯
bir	b iː ɐ
bitzen	b i t s ə n
biz	b iː t͡s
blann	b l ɑ n
blatlaus	b l aː d l æˑ ʊ̯ s
blatz	b l ɑ t͡s
blatzeg	b l ɑ t͡s ə ɕ
bleech	b l eː ɕ
bleechen	b l eː ɕ ə n
bleiwen	b l ɑ ɪ̯ v ə n
blennen	b l æ n ə n
blessur	b l æ s y ə̯
blessur	b l æ s yː ɐ
blesséieren	b l æ s ɜ ɪ̯ ə ʀ ə n
blietchen	b l i ə̯ t ɕ ə n
blo	b l oː
blobrëschtchen	b l oː b ʁ ə ʃ t ɕ ə n
bloder	b l oː d ɐ
blosen	b l oː z ə n
blouss	b l ə ʊ̯ s
bludden	b l u d ə n
bluttdrock	b l u d d ʀ o k
bluttjonk	b l u d j o ŋ k
bluttrout	b l u d ʀ ə ʊ̯ t
bläi	b l æˑ ɪ̯
bläien	b l æˑ ɪ̯ ə n
bläistëft	b l æˑ ɪ̯ ʃ t ə f t
bléck	b l e k
bléi	b l ɜ ɪ̯
bléien	b l ɜ ɪ̯ ə n
bléis	b l ɜ ɪ̯ s
bléist	b l ɜ ɪ̯ s t
bléit	b l ɜ ɪ̯ t
blénken	b l e ŋ k ə n
blëtz	b l ə t͡s
blëtzen	b l ə t͡s ə n
boma	b oː m aː
bommel	b o m ə l
bord	b oː ɐ
botanesch	b o t aː n ə ʃ
bottel	b o t ə l
botter	b o t ɐ
bottermëllech	b o t ɐ m ə l ə ɕ
botzen	b o t͡s ə n
bou	b ə ʊ̯
bouf	b ə ʊ̯ f
bouillon	b u j õː
boun	b ə ʊ̯ n
bouneschlupp	b ə ʊ̯ n ə ʃ l u p
bouss	b ə ʊ̯ s
brach	b ʀ ɑ χ
braconnéieren	b ʀ ɑ k o n ɜ ɪ̯ ə ʀ ə n
brand	b ʀ ɑ n t
branntewäin	b ʀ ɑ n t ə v æˑ ɪ̯ n
brauchen	b ʀ æˑ ʊ̯ χ ə n
brauen	b ʀ ɑ ʊ̯ ə n
braut	b ʀ æˑ ʊ̯ t
brautrank	b ʀ æˑ ʊ̯ d ʀ ɑ ŋ k
bremsspur	b ʀ æ m p s ʃ p uː ɐ
brennen	b ʀ æ n ə n
brennes	b ʀ æ n ə s
bretzel	b ʀ æ t͡s ə l
bretzen	b ʀ æ t͡s ə n
bridder	b ʀ i d ɐ
briech	b ʀ i ə̯ ɕ
briecheisen	b ʀ i ə̯ ʑ ɑ ɪ̯ z ə n
briechen	b ʀ i ə̯ ɕ ə n
briecht	b ʀ i ə̯ ɕ t
briet	b ʀ i ə̯ t
brigang	b ʀ i ɡ ɑ ŋ
brittesch	b ʀ i t ə ʃ
broden	b ʀ oː d ə n
brodéieren	b ʀ o d ɜ ɪ̯ ə ʀ ə n
brongbrëschtchen	b ʀ o ŋ b ʀ ə ʃ t ɕ ə n
bronkeg	b ʀ o ŋ k ə ɕ
brout	b ʀ ə ʊ̯ t
brudder	b ʀ u d ɐ
bräi	b ʀ æˑ ɪ̯
bräit	b ʀ æˑ ɪ̯ t
bréch	b ʀ ə ɕ
bréchs	b ʀ ə ɕ s
brécht	b ʀ ə ɕ t
bréck	b ʀ e k
bréien	b ʀ ɜ ɪ̯ ə n
bréif	b ʀ ɜ ɪ̯ f
bréifkëscht	b ʀ ɜ ɪ̯ f k ə ʃ t
bréissel	b ʀ ɜ ɪ̯ s ə l
bréit	b ʀ ɜ ɪ̯ t
bréits	b ʀ ɜ ɪ̯ t͡s
bréngen	b ʀ e ŋ ə n
brëll	b ʀ ə l
brëllen	b ʀ ə l ə n
brëtsch	b ʀ ə t͡ʃ
buchen	b u χ ə n
buddelen	b u d ə l ə n
buedduch	b u ə̯ d d u χ
buedem	b u ə̯ d ə m
bueden	b u ə̯ d ə n
buedzëmmer	b u ə̯ t t͡s ə m ɐ
buer	b u ə̯
buer	b uː ɐ
bueren	b u ə̯ ʀ ə n
buerg	b u ə̯ ɕ
buet	b u ə̯ t
bugger	b u ɡ ɐ
busgare	b u z ɡ aː χ
buttek	b u t e k
bäcker	b æ k ɐ
bäckeschdosen	b æ k ə ʒ d oː z ə n
bäikommen	b æˑ ɪ̯ k o m ə n
bäileed	b æˑ ɪ̯ l eː t
bäileeën	b æˑ ɪ̯ l eː ə n
bäisetzen	b æˑ ɪ̯ z æ t͡s ə n
bäiss	b æˑ ɪ̯ s
bäissen	b æˑ ɪ̯ s ə n
bäisst	b æˑ ɪ̯ s t
béchs	b e k s
bécken	b e k ə n
béi	b ɜ ɪ̯
béid	b ɜ ɪ̯ t
béiden	b ɜ ɪ̯ d ə n
béien	b ɜ ɪ̯ ə n
béier	b ɜ ɪ̯ ɐ
béifchen	b ɜ ɪ̯ f ɕ ə n
béis	b ɜ ɪ̯ s
béissen	b ɜ ɪ̯ s ə n
bëbee	b ə b e
bëlleg	b ə l ə ɕ
bënns	b ə n t s
bënnt	b ə n t
bësch	b ə ʃ
bëschof	b ə ʃ oː f
bëselen	b ə z ə l ə n
bëss	b ə s
bëtong	b ə t o ŋ
cabillaud	k ɑ b i j oː
cale	k ɑ l
capabel	k ɑ p aː b ə l
capot	k ɑ p oː
catchen	k ɑ t͡ʃ ə n
chamber	ʃ ɑ̃ː b ɐ
champignon	ʃ ɑ̃ː p i n j õː
chancëgläichheet	ʃ ɑ̃ː s ə ɡ l æˑ ɪ̯ ɕ h eː t
changéieren	ʃ ɑ̃ ʒ ɜ ɪ̯ ə ʀ ə n
chantage	ʃ ɑ̃ː t aː ʃ
charakter	k ɑ ʀ ɑ k t ɐ
chauffer	ʃ oː f ɐ
chauffersflucht	ʃ oː f ɐ s f l u χ t
chauffeur	ʃ oː f øː ɐ
chaufféieren	ʃ o f ɛ ɪ̯ ə ʀ ə n
chimie	ʃ i m iː
choufleur	ʃ uː f l øː ɐ
chrëscht	k ʀ ə ʃ t
chrëschtbeemchen	k ʀ ə ʃ t b eː m ɕ ə n
chrëschtdag	k ʀ ə ʒ d aː χ
chrëschtentum	k ʀ ə ʃ t ə n t uː m
chrëschtlech	k ʀ ə ʃ t l ə ɕ
collaboratioun	k o l ɑ b o ʀ ɑ t s j ə ʊ̯ n
comptoir	k õː t w aː χ
computer	k o m p j uː t ɐ
confirméieren	k o n f i ʁ m ɜ ɪ̯ ə ʀ ə n
constitutioun	k o n s t i t u t s j ə ʊ̯ n
couragéiert	k u ʁ aː ʒ ɜ ɪ̯ ɐ t
cricket	k ʀ i k ə t
da	d aː
daachdecker	d aː ʁ d æ k ɐ
daachen	d aː χ ə n
daachliicht	d aː ʁ l iː ɕ t
dach	d ɑ χ
dachs	d ɑ k s
dacks	d ɑ k s
daimchen	d ɑ ɪ̯ m ɕ ə n
dall	d ɑ l
damm	d ɑ m
damp	d ɑ m p
dangen	d ɑ ŋ ə n
danken	d ɑ ŋ k ə n
dann	d ɑ n
danz	d ɑ n t s
danzen	d ɑ n t s ə n
daper	d aː p ɐ
dapp	d ɑ p
dar	d aː χ
dass	d ɑ s
dat	d ɑ t
datt	d ɑ t
dattel	d ɑ t ə l
datz	d ɑ t s
dauchen	d æˑ ʊ̯ χ ə n
dauer	d ɑ ʊ̯ ɐ
daueren	d ɑ ʊ̯ ə ʀ ə n
dauf	d ɑ ʊ̯ f
daum	d ɑ ʊ̯ m
dausend	d ɑ ʊ̯ z ə n t
de	d ə
dech	d ə ɕ
deckel	d æ k ə l
deckelsmouk	d æ k ə l d z m ə ʊ̯ k
decken	d æ k ə n
deefen	d eː f ə n
deeg	d eː ɕ
deeglech	d eː ʑ l ə ɕ
deelen	d eː l ə n
deemno	d eː m n oː
deemools	d eː m oː l t s
degustéieren	d eː ɡ y s t ɜ ɪ̯ ə ʀ ə n
dehnen	d eː n ə n
deier	d ɑ ɪ̯ ɐ
deiten	d ɑ ɪ t ə n
dem	d ə m
den	d ə n
deng	d e ŋ
dengem	d e ŋ ə m
dengen	d e ŋ ə n
denger	d e ŋ ɐ
denken	d æ ŋ k ə n
der	d ɐ
derhanner	d ɐ h ɑ n ɐ
dezember	d ə t͡s æ m b ɐ
diamant	d i ɑ m ɑ n t
dicht	d i ɕ t
dichteg	d i ɕ t ə ɕ
dichter	d i ɕ t ɐ
dictionnaire	d i k s j o n ɛ ə̯
diddeleng	d i d ə l e ŋ
dier	d i ə̯
dier	d iː ɐ
digel	d i ʑ ə l
dikrech	d i k ʀ ə ɕ
diktéieren	d i k t ɜ ɪ̯ ə ʀ ə n
dillen	d i l ə n
dimmer	d i m ɐ
dir	d i ə̯
dir	d iː ɐ
diskutéieren	d i s k u t ɜ ɪ̯ ə ʀ ə n
ditzen	d i t͡s ə n
do	d oː
dobannen	d o b ɑ n ə n
dobaussen	d o b æˑ ʊ̯ s ə n
dobäi	d o b æˑ ɪ̯
doduerch	d o d u ə̯ ɕ
doen	d oː ə n
dofir	d o f i ə̯
dofir	d o f iː ɐ
doften	d o f t ə n
dogéint	d o ɡ ɜ ɪ̯ n t
dohannen	d o h ɑ n ə n
dohanner	d o h ɑ n ɐ
dohinner	d o h i n ɐ
dokter	d o k t ɐ
doléiner	d oː l ɜ ɪ̯ n ɐ
domat	d oː m ɑ t
donkel	d o ŋ k ə l
donkelheet	d o ŋ k ə l h eː t
donner	d o n ɐ
donneren	d o n ə ʀ ə n
donneschdeg	d o n ə ʒ d ə ɕ
dono	d o n oː
donst	d o n t s t
doran	d o ʀ ɑ n
doran	d oː ʀ ɑ n
doraus	d o ʀ æˑ ʊ̯ s
doraus	d oː ʀ æˑ ʊ̯ s
doriwwer	d o ʀ i v ɐ
doriwwer	d oː ʀ i v ɐ
dorun	d o ʀ u n
dosen	d oː z ə n
dossier	d o s j e
doud	d ə ʊ̯ t
doudesaffer	d ə ʊ̯ d ə z ɑ f ɐ
doudewon	d ə ʊ̯ d ə v oː n
doum	d ə ʊ̯ m
dout	d ə ʊ̯ t
doutmaachen	d ə ʊ̯ d m aː χ ə n
dovunner	d o f u n ɐ
dovunner	d oː f u n ɐ
dozou	d o t͡s ə ʊ̯
dozou	d oː t͡s ə ʊ̯
draleeën	d ʀ ɑ l eː ə n
dran	d ʀ ɑ n
drauf	d ʀ ɑ ʊ̯ f
drauwejus	d ʀ ɑ ʊ̯ v ə ʒ yː
dreemen	d ʀ eː m ə n
dreeën	d ʀ eː ə n
dreif	d ʀ ɑ ɪ̯ f
dreifs	d ʀ ɑ ɪ̯ f s
dreift	d ʀ ɑ ɪ̯ f t
dreiwen	d ʀ ɑ ɪ̯ v ə n
dreschen	d ʀ æ ʃ ə n
driwwer	d ʀ i v ɐ
dro	d ʀ oː
droen	d ʀ oː ə n
droit	d ʀ w aː
droleg	d ʀ oː l ə ɕ
dräi	d ʀ æˑ ɪ̯
dräifach	d ʀ æˑ ɪ̯ f ɑ χ
dräikinneksdag	d ʀ æˑ ɪ̯ k i n e ɡ z d aː χ
dräimol	d ʀ æˑ ɪ̯ m oː l
dräisprong	d ʀ æˑ ɪ̯ ʃ p ʀ o ŋ
dräizéng	d ʀ æˑ ɪ̯ t͡s e ŋ
dräizéngt	d ʀ æˑ ɪ̯ t͡s e ŋ k t
drängen	d ʀ æ ŋ ə n
dränken	d ʀ æ ŋ k ə n
dréchen	d ʀ ə ɕ ə n
dréchent	d ʀ e ɕ ə n t
dréchnen	d ʀ ə ɕ n ə n
drécken	d ʀ e k ə n
drécker	d ʀ e k ɐ
dréi	d ʀ ɜ ɪ̯
dréibänk	d ʀ ɜ ɪ̯ b æ ŋ k
dréien	d ʀ ɜ ɪ̯ ə n
dréinen	d ʀ ɜ ɪ̯ n ə n
dréis	d ʀ ɜ ɪ̯ s
dréischel	d ʀ ɜ ɪ̯ ʃ ə l
dréit	d ʀ ɜ ɪ̯ t
dréiwen	d ʀ ɜ ɪ̯ v ə n
dréngen	d ʀ e ŋ ə n
drénk	d ʀ e ŋ k
drénken	d ʀ e ŋ k ə n
drénks	d ʀ e ŋ k s
drénkt	d ʀ e ŋ k t
drënner	d ʀ ə n ɐ
drëps	d ʀ ə p s
drësseg	d ʀ ə s ə ɕ
drëtt	d ʀ ə t
du	d uː
ducken	d u k ə n
duddelsak	d u d ə l z aː k
duebel	d u ə̯ b ə l
duechter	d u ə̯ ɕ t ɐ
dueder	d u ə̯ d ɐ
duer	d u ə̯
duer	d uː ɐ
duerch	d u ə̯ ɕ
duercherneen	d u ə̯ ɕ ɐ n eː n
duerchsetzen	d u ə̯ ʑ z æ t͡s ə n
duerf	d u ə̯ f
duerleeën	d u ə̯ l eː ə n
duerleeën	d uː ɐ l eː ə n
duerno	d u ə̯ n oː
dugend	d uː ʁ ə n t
duschen	d u ʃ ə n
däerfen	d ɛ ə̯ f ə n
däich	d æˑ ɪ̯ ɕ
däin	d æˑ ɪ̯ n
däischtert	d æˑ ɪ̯ ʃ t ɐ t
däitlech	d æˑ ɪ̯ d l ə ɕ
däitsch	d æˑ ɪ̯ t͡ʃ
däitschland	d æˑ ɪ̯ t͡ʃ l ɑ n t
däitschsproocheg	d æˑ ɪ̯ t ʃ p ʀ oː χ ə ɕ
däiwel	d æˑ ɪ̯ v ə l
dämpen	d æ m p ə n
dänemark	d ɛː n ə m ɑ χ k
dännemees	d æ n ə m eː s
där	d ɛ ə̯
däreldéier	d ɛː ʀ ə l d ɜ ɪ̯ ɐ
déck	d e k
déckt	d e k t
déi	d i
déi	d ɜ ɪ̯
déier	d ɜ ɪ̯ ɐ
déif	d ɜ ɪ̯ f
déifferdeng	d ɜ ɪ̯ f ɐ d e ŋ
déijéineg	d ɜ ɪ̯ ʒ ɜ ɪ̯ n ə ɕ
déngen	d e ŋ ə n
dénger	d e ŋ ɐ
déngscht	d e ŋ k ʃ t
dëll	d ə l
dëllen	d ə l ə n
dëmpen	d ə m p ə n
dënn	d ə n
dënschdeg	d ə n ʒ d ə ɕ
dëppen	d ə p ə n
dës	d ə s
dësch	d ə ʃ
dëschelduch	d ə ʃ ə l d u χ
dëschtel	d ə ʃ t ə l
dëschtennis	d ə ʃ t æ n i s
dësem	d ə z ə m
dësen	d ə z ə n
dëser	d ə z ɐ
dëst	d ə s t
dösen	d øː z ə n
ech	ə ɕ
eckzant	æ k t͡s ɑ n t
educatioun	eː d y k ɑ t s j ə ʊ̯ n
ee	eː
eech	eː ɕ
eechel	eː ɕ ə l
eechen	eː ɕ ə n
eedem	eː d ə m
eegen	eː ʑ ə n
eegennumm	eː ʑ ə n u m
eegentlech	eː ʑ ə n d l ə ɕ
eegiel	eː ɡ i ə̯ l
eekelen	eː k ə l ə n
eelef	eː l ə f
eeleft	eː l ə f t
eemer	eː m ɐ
eenegen	eː n ə ʑ ə n
eenhar	eː n h aː χ
eenzel	eː n t s ə l
eesäiteg	eː z æˑ ɪ̯ t ə ɕ
eeter	eː t ɐ
eeteren	eː t ə ʀ ə n
eewäiss	eː v æˑ ɪ̯ s
eeër	eː ɐ
eeërschuel	eː ɐ ʃ u ə̯ l
eeërstack	eː ɐ ʃ t ɑ k
effikass	æ f i k ɑ s
eidechs	ɑ ɪ̯ d æ k s
eidel	ɑ ɪ̯ d ə l
eil	ɑ ɪ̯ l
eis	ɑ ɪ̯ s
eisebunn	ɑ ɪ z ə b u n
eisekuch	ɑ ɪ̯ z ə k u χ
eisen	ɑ ɪ̯ z ə n
eist	ɑ ɪ̯ s t
elaboratioun	eː l ɑ b o ʀ ɑ t s j ə ʊ̯ n
elch	æ l ɕ
elefant	ə l ə f ɑ n t
eleng	ə l æ ŋ
elfebeen	æ l f ə b eː n
ellen	æ l ə n
elo	ə l oː
els	æ l t s
elteren	æ l t ə ʀ ə n
elterenhaus	æ l t ə ʀ ə n h æˑ ʊ̯ s
em	ə m
email	eː m ɑ ɪ̯
email	ə m ɑ ɪ̯
emissioun	ə m i s j ə ʊ̯ n
en	ə n
endlech	æ n d l ə ɕ
eneen	ə n eː n
engem	æ ŋ ə m
engen	æ ŋ ə n
enger	æ ŋ ɐ
england	æ ŋ l ɑ n t
englesch	æ ŋ l ə ʃ
englänner	æ ŋ l æ n ɐ
enkel	æ ŋ k ə l
enkelin	æ ŋ k ə l i n
enorm	ə n o ʀ m
enregistréieren	ɑ̃ː ʀ ə ʒ i s t ʀ ɜ ɪ̯ ə ʀ ə n
entbannen	æ n d b ɑ n ə n
entdecken	æ n d d æ k ə n
entfléien	æ n t f l ɜ ɪ̯ ə n
entsat	æ n d͡z aː t
entschlofen	æ n t͡ʃ l oː f ə n
entschloss	æ n t͡ʃ l o s
entschléissen	æ n t͡ʃ l ɜ ɪ̯ s ə n
entschëllegen	æ n t͡ʃ ə l ə ʑ ə n
entschëllegt	æ n t͡ʃ ə l ə ɕ t
entsetzen	æ n d͡z æ t͡s ə n
entspriechen	æ n t ʃ p ʀ i ə̯ ɕ ə n
entweder	æ n d v eː d ɐ
entwéckelen	æ n d v e k ə l ə n
entwécklung	æ n d v e k l u ŋ
entwëschen	æ n d v e ʃ ə n
enveloppe	ɑ̃ v l o p
eppes	æ p ə s
equipe	ə k i p
eraleeën	ə ʀ ɑ l eː ə n
erbaarmen	ɐ b aː ʀ m ə n
erfrëschen	ɐ f ʀ ə ʃ ə n
ergätzen	ɐ ɡ æ t͡s ə n
erhuuschen	ɐ h uː ʃ ə n
erhuuschten	ɐ h uː ʃ t ə n
eriwwer	ə ʀ i v ɐ
erkennen	ɐ k æ n ə n
erlaben	ɐ l aː b ə n
erof	ə ʀ oː f
eroffalen	ə ʀ oː f f aː l ə n
erofsetzen	ə ʀ oː v z æ t͡s ə n
eropsetzen	ə ʀ o b z æ t͡s ə n
ersetzen	ɐ z æ t͡s ə n
erstécken	ɐ ʃ t e k ə n
erwaarden	ɐ v aː ʀ d ə n
erwëschen	ɐ v ə ʃ ə n
erzéien	ɐ t͡s ɜ ɪ̯ ə n
erzéiung	ɐ t͡s ɜ ɪ̯ u ŋ
eréischt	ə ʀ ɜ ɪ̯ ʃ t
erëffnung	ə ʀ ə f n u ŋ
erënneren	ə ʁ ə n ə ʁ ə n
erënnerung	ə ʀ ə n ə ʀ u ŋ
esou	ə z u
esou	ə z ə ʊ̯
esoubal	ə z u b aː l
esouguer	ə z u ɡ uː ɐ
esoulaang	ə z u l aː ŋ
esseg	æ s ə ɕ
estland	æ z d l ɑ n t
et	ə t
etapp	eː t ɑ p
etlech	æ d l ə ɕ
ettelbréck	æ t ə l b ʀ e k
ewech	ə v æ ɕ
ewell	ə v æ l
ewéi	ə v i
ewéi	ə v ɜ ɪ̯
exageréieren	æ ɡ z ɑ ʒ ə ʀ ɜ ɪ̯ ə ʀ ə n
exploitatioun	æ k s p l w ɑ t ɑ t s j ə ʊ̯ n
exteren	æ k s t ə ʀ ə n
faarf	f aː χ f
faart	f aː χ t
faarweblann	f aː ʀ v ə b l ɑ n
faaschten	f aː ʃ t ə n
faaschtenzäit	f aː ʃ t ə n t͡s æˑ ɪ̯ t
faassen	f aː s ə n
fach	f ɑ χ
fahrlehrer	f aː l eː ʁ ɐ
fakel	f aː k ə l
falen	f aː l ə n
fall	f ɑ l
fallek	f ɑ l ə k
falls	f ɑ l t s
famill	f ɑ m i l
fanger	f ɑ ŋ ɐ
fangernol	f ɑ ŋ ɐ n oː l
fangerspëtz	f ɑ ŋ ɐ ʃ p ə t͡s
fann	f ɑ n
fannen	f ɑ n ə n
fannt	f ɑ n t
far	f aː χ
farcéieren	f ɑ ʀ s ɜ ɪ̯ ə ʀ ə n
fascht	f ɑ ʃ t
fassad	f ɑ s aː t
faszinatioun	f ɑ s t͡s i n ɑ t s j ə ʊ̯ n
fatz	f ɑ t͡s
faulen	f ɑ ʊ̯ l ə n
faulenzen	f æˑ ʊ̯ l æ n t͡s ə n
fauscht	f æˑ ʊ̯ ʃ t
februar	f eː b ʀ u aː χ
feelen	f eː l ə n
feeler	f eː l ɐ
feeën	f eː ə n
feier	f ɑ ɪ̯ ɐ
feierblumm	f ɑ ɪ̯ ɐ b l u m
feierdag	f ɑ ɪ̯ ɐ d aː χ
feieren	f ɑ ɪ̯ ə ʀ ə n
feil	f ɑ ɪ̯ l
feind	f ɑ ɪ̯ n t
festsetzen	f æ z d z æ t͡s ə n
feststellen	f æ s t ʃ t æ l ə n
feuter	f øː t ɐ
fichier	f i ʃ j eː
fidderen	f i d ə ʀ ə n
fieder	f i ə̯ d ɐ
fiederball	f i ə̯ d ɐ b ɑ l
fiels	f i ə̯ l t s
fierkel	f i ə̯ k ə l
fierschter	f i ə̯ ʃ t ɐ
fierwen	f i ə̯ v ə n
fies	f i ə̯ s
figebam	f iː ɡ ə b aː m
figur	f i ɡ u ə̯
figur	f i ɡ uː ɐ
fiicht	f iː ɕ t
fiichtegkeet	f iː ɕ t ə ɕ k eː t
fillen	f i l ə n
filz	f i l t s
filzstëft	f i l t s ʃ t ə f t
fir	f i ə̯
fir	f iː ɐ
fir	f ɐ
fir	f ə
fiselen	f i z ə l ə n
fisemreen	f i z ə m ʀ eː n
fixfeier	f i k s f ɑ ɪ̯ ɐ
fixspoun	f i k s ʃ p ə ʊ̯ n
flack	f l ɑ k
fladderen	f l ɑ d ə ʀ ə n
flanell	f l ɑ n æ l
flank	f l ɑ ŋ k
flapp	f l ɑ p
flechten	f l æ ɕ t ə n
fleegeheem	f l eː ʑ ə h eː m
flicht	f l i ɕ t
fliedermaus	f l i ə̯ d ɐ m æˑ ʊ̯ s
fligel	f l i ʑ ə l
fliger	f l iː ʑ ɐ
fliicht	f l iː ɕ t
flirten	f l œː χ t ə n
flitzen	f l i t͡s ə n
flou	f l uː
flou	f l ə ʊ̯
flouer	f l ə ʊ̯ ɐ
flouernumm	f l ə ʊ̯ ɐ n u m
floumaart	f l ə ʊ̯ m aː χ t
fluchgesellschaft	f l u ʁ ɡ ə z æ l ʃ ɑ f t
flued	f l u ə̯ t
fluess	f l u ə̯ s
fluesssom	f l u ə̯ s oː m
fluesssom	f l u ə̯ z z oː m
flutschen	f l u t͡ʃ ə n
fläch	f l æ ɕ
fläiss	f l æˑ ɪ̯ s
fläissen	f l æˑ ɪ̯ s ə n
fléck	f l e k
flécken	f l e k ə n
fléi	f l ɜ ɪ̯
fléien	f l ɜ ɪ̯ ə n
fléimouk	f l ɜ ɪ̯ m ə ʊ̯ k
fléissen	f l ɜ ɪ̯ s ə n
flënt	f l ə n t
fofzeg	f o f t͡s ə ɕ
fofzéng	f o f t͡s e ŋ
fofzéngt	f o f t͡s e ŋ k t
folleg	f o l ə ɕ
follegen	f o l ə ʑ ə n
fooschen	f oː ʃ ə n
force	f o χ s
formatéieren	f o ʀ m ɑ t ɜ ɪ̯ ə ʀ ə n
formidabel	f o ʀ m i d aː b ə l
fou	f ə ʊ̯
fouen	f ə ʊ̯ ə n
fouer	f ə ʊ̯ ɐ
fouss	f ə ʊ̯ s
foussball	f ə ʊ̯ z b ɑ l
foussen	f ə ʊ̯ s ə n
foussgänger	f ə ʊ̯ z ɡ æ ŋ ɐ
foussnout	f ə ʊ̯ z n ə ʊ̯ t
fousssuel	f ə ʊ̯ s u ə̯ l
fousssuel	f ə ʊ̯ z z u ə̯ l
fra	f ʀ aː
frachtschëff	f ʀ ɑ χ t͡ʃ ə f
frack	f ʀ ɑ k
frankräich	f ʀ ɑ ŋ k ʀ æˑ ɪ̯ ɕ
fransous	f ʀ ɑ n z ə ʊ̯ s
franséisch	f ʀ ɑ n z ɜ ɪ̯ ʃ
franséisin	f ʀ ɑ n z ɜ ɪ̯ z i n
frascht	f ʀ ɑ ʃ t
frechheet	f ʀ æ ɕ eː t
frechheet	f ʀ æ ɕ h eː t
freeën	f ʀ eː ə n
freideg	f ʀ ɑ ɪ̯ d ə ɕ
freien	f ʀ ɑ ɪ̯ ə n
fridden	f ʀ i d ə n
friddlech	f ʀ i d l ə ɕ
frieden	f ʀ i ə̯ d ə n
friem	f ʀ i ə̯ m
friess	f ʀ i ə̯ s
friessen	f ʀ i ə̯ s ə n
friesst	f ʀ i ə̯ s t
fritten	f ʀ i t ə n
fro	f ʀ oː
froen	f ʀ oː ə n
frou	f ʀ ə ʊ̯
fräi	f ʀ æˑ ɪ̯
fräistouss	f ʀ æˑ ɪ̯ ʃ t ə ʊ̯ s
fréi	f ʀ ɜ ɪ̯
fréier	f ʀ ɜ ɪ̯ ɐ
fréieren	f ʀ ɜ ɪ̯ ə ʀ ə n
fréijoer	f ʀ ɜ ɪ̯ j oː ɐ
frënd	f ʀ ə n t
frësch	f ʀ ə ʃ
frëss	f ʀ ə s
frësst	f ʀ ə s t
fudder	f u d ɐ
fuedem	f u ə̯ d ə m
fuer	f u ə̯
fuer	f uː ɐ
fueren	f u ə̯ ʀ ə n
fueren	f uː ʀ ə n
fuererflucht	f u ə̯ ʀ ɐ f l u χ t
fuerplang	f u ə̯ p l ɑ ŋ
fuerplang	f uː ɐ p l ɑ ŋ
fuerschen	f u ə̯ ʃ ə n
fuert	f u ə̯ t
fuert	f uː ɐ t
fuerz	f u ə̯ t͡s
fuerzen	f u ə̯ t͡s ə n
fächer	f æ ɕ ɐ
fäeg	f eː ə ɕ
fäeg	f ɛː ə ɕ
fäerdeg	f ɛ ə̯ d ə ɕ
fäerten	f ɛ ə̯ t ə n
fähr	f ɛ ə̯
fäil	f æˑ ɪ̯ l
fäischt	f æˑ ɪ̯ ʃ t
fälleg	f æ l ə ɕ
fälschen	f æ l ʃ ə n
fändel	f æ n d ə l
fänken	f æ ŋ k ə n
fécken	f e k ə n
féieren	f ɜ ɪ̯ ə ʀ ə n
féiss	f ɜ ɪ̯ s
féiwer	f ɜ ɪ̯ v ɐ
fëmmen	f ə m ə n
fënnef	f ə n ə f
fënneft	f ə n ə f t
fënns	f ə n t s
fënnt	f ə n t
fënster	f ə n s t ɐ
fësch	f ə ʃ
fëschen	f ə ʃ ə n
fëscher	f ə ʃ ɐ
gaalgen	ɡ aː l ʑ ə n
gaapsen	ɡ aː p s ə n
gaardeboun	ɡ aː ʀ d ə b ə ʊ̯ n
gaarf	ɡ aː χ f
gaart	ɡ aː χ t
gafel	ɡ aː f ə l
gamm	ɡ ɑ m
gang	ɡ ɑ ŋ
gank	ɡ ɑ ŋ k
ganz	ɡ ɑ n t s
gar	ɡ aː χ
gare	ɡ aː χ
garrelen	ɡ ɑ ʀ ə l ə n
gebai	ɡ ə b ɑ ɪ̯
gebass	ɡ ə b ɑ s
gebeess	ɡ ə b eː s
gebiet	ɡ ə b i ə̯ t
gebitt	ɡ ə b i t
geblitt	ɡ ə b l i t
geblosen	ɡ ə b l oː z ə n
gebonnen	ɡ ə b o n ə n
gebot	ɡ ə b oː t
gebrach	ɡ ə b ʀ ɑ χ
gebrauchen	ɡ ə b ʀ æˑ ʊ̯ χ ə n
gebroden	ɡ ə b ʀ oː d ə n
gebräichlech	ɡ ə b ʀ æˑ ɪ̯ ɕ l ə ɕ
gebueden	ɡ ə b u ə̯ d ə n
gebuert	ɡ ə b u ə̯ t
gebuert	ɡ ə b uː ɐ t
gedanken	ɡ ə d ɑ ŋ k ə n
gediechtnes	ɡ ə d i ə̯ ʑ d n ə s
gedoen	ɡ ə d oː ə n
gedold	ɡ ə d o l t
gedriwwen	ɡ ə d ʀ i v ə n
gedroen	ɡ ə d ʀ oː ə n
gedronk	ɡ ə d ʀ o ŋ k
geeschteg	ɡ eː ʃ t ə ɕ
geeschter	ɡ eː ʃ t ɐ
geeschtlech	ɡ eː ʃ t l ə ɕ
geeschtlechen	ɡ eː ʃ t l ə ɕ ə n
geeschtlechkeet	ɡ eː ʃ t l ə ɕ k eː t
geessebock	ɡ eː s ə b o k
gefaach	ɡ ə f aː χ
gefalen	ɡ ə f aː l ə n
gefier	ɡ ə f i ə̯
gefier	ɡ ə f iː ɐ
gefill	ɡ ə f i l
gefisems	ɡ ə f i z ə m p s
geflass	ɡ ə f l ɑ s
geflunn	ɡ ə f l u n
gefor	ɡ ə f oː ɐ
gefriess	ɡ ə f ʀ i ə̯ s
gefuer	ɡ ə f u ə̯
gefuer	ɡ ə f uː ɐ
gefäll	ɡ ə f æ l
gehacktes	ɡ ə h ɑ k t ə s
gehaen	ɡ ə h aː ə n
gehalen	ɡ ə h aː l ə n
geheechnes	ɡ ə h eː ʑ n ə s
geheien	ɡ ə h ɑ ɪ̯ ə n
geheim	ɡ ə h ɑ ɪ̯ m
geheimnis	ɡ ə h ɑ ɪ̯ m n i s
gehir	ɡ ə h i ə̯
gehir	ɡ ə h iː ɐ
geholl	ɡ ə h o l
gehuewen	ɡ ə h u ə̯ v ə n
gehéiereg	ɡ ə h ɜ ɪ̯ ə ʀ ə ɕ
gehéieren	ɡ ə h ɜ ɪ̯ ə ʀ ə n
gei	ɡ ɑ ɪ̯
gejot	ɡ ə j oː t
geklommen	ɡ ə k l o m ə n
gelaf	ɡ ə l aː f
geleeën	ɡ ə l eː ə n
gelidden	ɡ ə l i d ə n
gellecht	ɡ æ l ə ɕ t
gelooss	ɡ ə l oː s
gelungen	ɡ ə l u ŋ ə n
gelunn	ɡ ə l u n
geléngen	ɡ ə l e ŋ ə n
gemaach	ɡ ə m aː χ
gemeng	ɡ ə m æ ŋ
gemidden	ɡ ə m i d ə n
gemitt	ɡ ə m i t
geméis	ɡ ə m ɜ ɪ̯ s
genee	ɡ ə n eː
genereel	ʒ ə n ə ʀ eː l
generol	ʒ ə n ə ʀ oː l
genie	ʒ ə n iː
genoss	ɡ ə n o s
genuch	ɡ ə n u χ
genéieren	ʒ ə n ɜ ɪ̯ ə ʀ ə n
genéissen	ɡ ə n ɜ ɪ̯ s ə n
gepaakt	ɡ ə p aː k t
gepëspers	ɡ ə p ə s p ɐ s
geraf	ɡ ə ʀ aː f
geraimeg	ɡ ə ʀ ɑ ɪ̯ m ə ɕ
gerass	ɡ ə ʀ ɑ s
gerecht	ɡ ə ʀ æ ɕ t
gerechtegkeet	ɡ ə ʀ æ ɕ t ə ɕ k eː t
gereest	ɡ ə ʀ eː s t
geridden	ɡ ə ʀ i d ə n
geriicht	ɡ ə ʀ iː ɕ t
geriwwen	ɡ ə ʀ i v ə n
germanesch	ɡ ɛ ə̯ m aː n ə ʃ
geroden	ɡ ə ʀ oː d ə n
geräisch	ɡ ə ʀ æˑ ɪ̯ ʃ
geräischer	ɡ ə ʀ æˑ ɪ̯ ʃ ɐ
geréieren	ʒ ə ʀ ɜ ɪ̯ ə ʀ ə n
geschass	ɡ ə ʃ ɑ s
geschicht	ɡ ə ʃ i ɕ t
geschitt	ɡ ə ʃ i t
geschlass	ɡ ə ʃ l ɑ s
geschlechtsflësseg	ɡ ə ʃ l æ ɕ t͡s f l ə s ə ɕ
geschlechtsverkéier	ɡ ə ʃ l æ ɕ t s f ɐ k ɜ ɪ̯ ɐ
geschmaach	ɡ ə ʃ m aː χ
geschmass	ɡ ə ʃ m ɑ s
geschwënn	ɡ ə ʃ w ə n
geschéien	ɡ ə ʃ ɜ ɪ̯ ə n
gesell	ɡ ə z æ l
gesetz	ɡ ə z æ t͡s
gesetzlech	ɡ ə z æ t͡s l ə ɕ
gesiicht	ɡ ə z iː ɕ t
gesinn	ɡ ə z i n
gesond	ɡ ə z o n t
gespier	ɡ ə ʃ p i ə̯
gespier	ɡ ə ʃ p iː ɐ
gesprongen	ɡ ə ʃ p ʀ o ŋ ə n
gespréich	ɡ ə ʃ p ʀ ɜ ɪ̯ ɕ
gespréicheg	ɡ ə ʃ p ʀ ɜ ɪ̯ ɕ ə ɕ
gestraich	ɡ ə ʃ t ʀ ɑ ɪ̯ ɕ
gestreits	ɡ ə ʃ t ʀ ɑ ɪ̯ t s
gesträift	ɡ ə ʃ t ʀ æˑ ɪ̯ f t
getratt	ɡ ə t ʀ ɑ t
getrueden	ɡ ə t ʀ u ə̯ d ə n
getëppelt	ɡ ə t ə p ə l t
gewannen	ɡ ə v ɑ n ə n
gewierz	ɡ ə v i ə̯ t͡s
gewiicht	ɡ ə v iː ɕ t
gewinnen	ɡ ə v i n ə n
gewosst	ɡ ə v o s t
gewuess	ɡ ə v u ə̯ s
gewuesst	ɡ ə v u ə̯ s t
gewunnecht	ɡ ə v u n ə ɕ t
gewënn	ɡ ə v ə n
gewëssen	ɡ ə v ə s ə n
gezei	ɡ ə t͡s ɑ ɪ̯
gezunn	ɡ ə t͡s u n
gezwitschert	ɡ ə t͡s w i t͡ʃ ɐ t
giedel	ɡ i ə̯ d ə l
giel	ɡ i ə̯ l
gierwen	ɡ i ə̯ v ə n
gierwer	ɡ i ə̯ v ɐ
gierwerei	ɡ i ə̯ v ə ʀ ɑ ɪ̯
giess	ɡ i ə̯ s
giicht	ɡ iː ɕ t
giraff	ʒ i ʀ ɑ f
gittar	ɡ i t aː χ
glace	ɡ l ɑ s
glanz	ɡ l ɑ n t s
glaseg	ɡ l aː z ə ɕ
glatz	ɡ l ɑ t s
glawen	ɡ l aː v ə n
gleewen	ɡ l eː v ə n
glidderen	ɡ l i d ə ʀ ə n
gliesen	ɡ l i ə̯ z ə n
glous	ɡ l ə ʊ̯ s
glousen	ɡ l ə ʊ̯ t s ə n
gläich	ɡ l æˑ ɪ̯ ɕ
gläichen	ɡ l æˑ ɪ̯ ɕ ə n
gléck	ɡ l e k
glécken	ɡ l e k ə n
glëtsch	ɡ l ə t͡ʃ
glëtz	ɡ l ə t͡s
goen	ɡ oː ə n
goldfësch	ɡ o l t f ə ʃ
gonnen	ɡ o n ə n
gonscht	ɡ o n t ʃ t
goût	ɡ uː
graff	ɡ ʀ ɑ f
grafschrëft	ɡ ʀ aː f ʃ ʀ ə f t
gramm	ɡ ʀ ɑ m
granat	ɡ ʀ ɑ n aː t
granatapel	ɡ ʀ ɑ n aː d aː p ə l
grand	ɡ ʀ ɑ n t
grapp	ɡ ʀ ɑ p
graskaarp	ɡ ʀ aː s k aː χ p
gratinéieren	ɡ ʀ ɑ t i n ɜ ɪ̯ ə ʀ ə n
gravitatioun	ɡ ʀ ɑ v i t ɑ t s j ə ʊ̯ n
gravitéit	ɡ ʀ ɑ v i t ɜ ɪ̯ t
griich	ɡ ʀ iː ɕ
griicheland	ɡ ʀ iː ɕ ə l ɑ n t
griichesch	ɡ ʀ iː ɕ ə ʃ
grimmel	ɡ ʀ i m ə l
gro	ɡ ʀ oː
grommelen	ɡ ʀ o m ə l ə n
gromper	ɡ ʀ o m p ɐ
grondel	ɡ ʀ o n d ə l
grouf	ɡ ʀ ə ʊ̯ f
grouss	ɡ ʀ ə ʊ̯ s
groussem	ɡ ʀ ə ʊ̯ s ə m
groussen	ɡ ʀ ə ʊ̯ s ə n
grousser	ɡ ʀ ə ʊ̯ s ɐ
groussmamm	ɡ ʀ ə ʊ̯ z m ɑ m
grousspapp	ɡ ʀ ə ʊ̯ s p ɑ p
grousst	ɡ ʀ ə ʊ̯ s t
gruef	ɡ ʀ u ə̯ f
gruewen	ɡ ʀ u ə̯ v ə n
gräifen	ɡ ʀ æˑ ɪ̯ f ə n
gräisslech	ɡ ʀ æˑ ɪ̯ s l ə ɕ
gréif	ɡ ʀ ɜ ɪ̯ f
gréissen	ɡ ʀ ɜ ɪ̯ s ə n
gréisst	ɡ ʀ ɜ ɪ̯ s t
gréiwemaacher	ɡ ʀ ɜ ɪ̯ v ə m aː χ ɐ
gréng	ɡ ʀ e ŋ
gréngen	ɡ ʀ e ŋ ə n
grëff	ɡ ʀ ə f
grënnen	ɡ ʀ ə n ə n
grënner	ɡ ʀ ə n ɐ
grëtz	ɡ ʀ ə t͡s
guddem	ɡ u d ə m
gudden	ɡ u d ə n
gudder	ɡ u d ɐ
gued	ɡ u ə̯ t
guer	ɡ u ə̯
guer	ɡ uː ɐ
gäertner	ɡ ɛ ə̯ d n ɐ
gäipmännchen	ɡ æˑ ɪ̯ b m æ n ɕ ə n
gäissel	ɡ æˑ ɪ̯ s ə l
gäisselen	ɡ æˑ ɪ̯ s ə l ə n
gäiz	ɡ æˑ ɪ̯ t͡s
gäizen	ɡ æˑ ɪ̯ t͡s ə n
gäns	ɡ æ n t s
gässen	ɡ æ s ə n
géi	ɡ ɜ ɪ̯
géigend	ɡ ɜ ɪ̯ ʑ ə n t
géigner	ɡ ɜ ɪ̯ ʑ n ɐ
géint	ɡ ɜ ɪ̯ n t
géinteneen	ɡ ɜ ɪ̯ n d ə n eː n
géintiwwer	ɡ ɜ ɪ̯ n d i v ɐ
géissen	ɡ ɜ ɪ̯ s ə n
gëft	ɡ ə f t
gëllen	ɡ ə l ə n
gënnen	ɡ ə n ə n
gëscht	ɡ ə ʃ t
gëschter	ɡ ə ʃ t ɐ
ha	h aː
haaptfach	h aː p t f ɑ χ
haaptsaach	h aː b d͡z aː χ
haaptsächlech	h aː b d͡z æ ɕ l ə ɕ
haart	h aː χ t
haarz	h aː χ t͡s
haassen	h aː s ə n
hachéieren	h ɑ ʃ ɜ ɪ̯ ə ʀ ə n
hackernoss	h ɑ k ɐ n o s
haen	h aː ə n
haff	h ɑ f
haifësch	h ɑ ɪ̯ f ə ʃ
hait	h ɑ ɪ̯ t
haiteg	h ɑ ɪ̯ t ə ɕ
halen	h aː l ə n
hall	h ɑ l
hallef	h ɑ l ə f
hallefnuecht	h ɑ l ə v n u ə̯ ɕ t
hallem	h ɑ l ə m
hals	h ɑ l t s
halschent	h ɑ l ʃ ə n t
hambier	h ɑ m b i ə̯
hambier	h ɑ m b iː ɐ
hamster	h ɑ m s t ɐ
hand	h ɑ n t
handbrems	h ɑ n d b ʀ æ m p s
handduch	h ɑ n d u χ
handelen	h ɑ n d ə l ə n
handgelenk	h ɑ n d ɡ ə l æ ŋ k
handlung	h ɑ n d l u ŋ
handyen	h æ n d i ə n
hank	h ɑ ŋ k
hannen	h ɑ n ə n
hannendran	h ɑ n ə n d ʀ ɑ n
hannendrun	h ɑ n ə n d ʀ u n
hannenno	h ɑ n ə n oː
hanner	h ɑ n ɐ
hannereneen	h ɑ n ə ʀ ə n eː n
hannerwands	h ɑ n ɐ v ɑ n t s
hanneschtsetzen	h ɑ n ə ʒ d͡z æ t s ə n
hannevir	h ɑ n ə f iː ɐ
happ	h ɑ p
har	h aː χ
harespel	h aː ʀ æ s p ə l
harespel	h ɑ ʀ æ s p ə l
harf	h ɑ χ f
hatt	h ɑ t
hauf	h ɑ ʊ̯ f
haus	h æˑ ʊ̯ s
hausdéier	h æˑ ʊ̯ z d ɜ ɪ̯ ɐ
haut	h æˑ ʊ̯ t
haut	h ɑ ʊ̯ t
hautdokter	h ɑ ʊ̯ d d o k t ɐ
hauwemees	h ɑ ʊ̯ v ə m eː s
hee	h eː
heefen	h eː f ə n
heelen	h eː l ə n
heemecht	h eː m ə ɕ t
heemechtshaus	h eː m ə ɕ t s h æˑ ʊ̯ s
heemschécken	h eː m ʃ e k ə n
heeschen	h eː ʃ ə n
heeschnapp	h eː ʃ n ɑ p
heften	h æ f t ə n
hei	h ɑ ɪ̯
heiansdo	h ɑ ɪ̯ ɑ n d z d oː
heizkierper	h ɑ ɪ̯ t͡s k i ə̯ p ɐ
hellblo	h æ l b l oː
helleg	h æ l ə ɕ
hellegspriechen	h æ l ə ɕ ʃ p ʀ i ə̯ ɕ ə n
hengscht	h æ ŋ k ʃ t
herno	h ɐ n oː
herrlech	h æ ʀ l ə ɕ
herrlechkeet	h æ ʀ l ə ɕ k eː t
herzog	h æ χ t͡s o χ
herzogtum	h æ χ t͡s o χ t u m
hessesch	h æ s ə ʃ
hexen	h æ k s ə n
hicken	h i k ə n
hidden	h i d ə n
hiecht	h i ə̯ ɕ t
hief	h i ə̯ f
hiel	h i ə̯ l
hielenner	h i ə̯ l æ n ɐ
hiem	h i ə̯ m
hien	h i ə̯ n
hier	h i ə̯
hier	h iː ɐ
hierk	h i ə̯ k
hierscht	h i ə̯ ʃ t
hierschtkueb	h i ə̯ ʃ t k u ə̯ p
hiert	h i ə̯ t
hiert	h iː ɐ t
hieselnoss	h i ə̯ z ə l n o s
hieselter	h i ə̯ z ə l t ɐ
hiewel	h i ə̯ v ə l
hiewen	h i ə̯ v ə n
himmel	h i m ə l
himmelblo	h i m ə l b l oː
himmelen	h i m ə l ə n
himmelräich	h i m ə l ʀ æˑ ɪ̯ ɕ
himmelsdéierchen	h i m ə l d z d ɜ ɪ̯ ɐ ɕ ə n
hindeiten	h i n d ɑ ɪ̯ t ə n
hinnen	h i n ə n
hir	h i ə̯
hir	h iː ɐ
hirsch	h i χ ʃ
historesch	h i s t oː ʀ ə ʃ
historiker	h i s t oː ʀ i k ɐ
hiweisen	h i v ɑ ɪ̯ z ə n
hiwwel	h i v ə l
ho	h oː
hoer	h oː ɐ
hoerbiischt	h oː ɐ b iː ʃ t
hoffen	h o f ə n
holland	h o l ɑ n t
hollännesch	h o l æ n ə ʃ
holz	h o l t s
homard	h o m aː χ
honger	h o ŋ ɐ
honnert	h o n ɐ t
hoppelen	h o p ə l ə n
horaire	h o ʀ ɛ ə̯
horaire	h oː ʀ ɛ ə̯
houer	h ə ʊ̯ ɐ
houf	h ə ʊ̯ f
houfeisen	h ə ʊ̯ v ɑ ɪ̯ z ə n
houfert	h ə ʊ̯ f ɐ t
houfreg	h ə ʊ̯ f ʀ ə ɕ
houfschmadd	h ə ʊ̯ f ʃ m ɑ t
houscht	h ə ʊ̯ ʃ t
houschten	h ə ʊ̯ ʃ t ə n
huel	h u ə̯ l
huelen	h u ə̯ l ə n
huelt	h u ə̯ l t
huer	h u ə̯
huer	h uː ɐ
huerteg	h ʊ ə̯ t ə ɕ
hues	h u ə̯ s
huesenziwwi	h u ə̯ z ə n t͡s i v i
huewer	h u ə̯ v ɐ
hummer	h u m ɐ
hunneg	h u n ə ɕ
huppen	h u p ə n
huschen	h u ʃ ə n
huwwel	h u v ə l
huwwelen	h u v ə l ə n
häerd	h ɛ ə̯ t
häerden	h ɛ ə̯ d ə n
häerz	h ɛ ə̯ t͡s
häip	h æˑ ɪ̯ p
hällewull	h æ l ə v u l
häls	h æ l t s
hämmelfleesch	h æ m ə l f l eː ʃ
händchen	h æ n t͡ɕ ə n
hänken	h æ ŋ k ə n
hänselen	h æ n z ə l ə n
hätschelen	h æ t͡ʃ ə l ə n
héchstens	h e k s t ə n t s
héich	h ɜ ɪ̯ ɕ
héichhaus	h ɜ ɪ̯ ɕ h æˑ ʊ̯ s
héichsprong	h ɜ ɪ̯ ɕ ʃ p ʀ o ŋ
héicht	h ɜ ɪ̯ ɕ t
héichtenangscht	h ɜ ɪ̯ ɕ t ə n ɑ ŋ k ʃ t
héichuewen	h ɜ ɪ̯ ʑ u ə̯ v ə n
héieren	h ɜ ɪ̯ ə ʀ ə n
héiflech	h ɜ ɪ̯ f l ə ɕ
héiflechkeet	h ɜ ɪ̯ f l ə ɕ k eː t
héijen	h ɜ ɪ̯ ʑ ə n
héil	h ɜ ɪ̯ l
héiss	h ɜ ɪ̯ s
héissen	h ɜ ɪ̯ s ə n
hénger	h e ŋ ɐ
héngeree	h e ŋ ɐ ʔ eː
héngeree	h e ŋ ə ʀ eː
héngerhaut	h e ŋ ɐ h æˑ ʊ̯ t
hëft	h ə f t
hëllef	h ə l ə f
hëllefen	h ə l ə f ə n
hëllefsverb	h ə l ə v z v æ χ p
hëls	h ə l t s
hëlt	h ə l t
hëlzen	h ə l t͡s ə n
hënt	h ə n t
hëtzen	h ə t͡s ə n
hëtzt	h ə t͡s t
ideal	i d ə aː l
iech	i ə̯ ɕ
iech	ə ɕ
iechternach	i ə̯ ɕ t ɐ n ɑ χ
ielebou	i ə̯ l ə b ə ʊ̯
ierbes	i ə̯ b ə s
ierflech	i ə̯ v l ə ɕ
iergenden	i ə̯ ʑ ə n d ə n
iergendeng	i ə̯ ʑ ə n d æ ŋ
iergendengem	i ə̯ ʑ ə n d æ ŋ ə m
iergendenger	i ə̯ ʑ ə n d æ ŋ ɐ
ierger	i ə̯ ʑ ɐ
iergeren	i ə̯ ʑ ə ʀ ə n
ierwen	i ə̯ v ə n
iesel	i ə̯ z ə l
iess	i ə̯ s
iessen	i ə̯ s ə n
iessläffel	i ə̯ s l æ f ə l
iesst	i ə̯ s t
iesszëmmer	i ə̯ s t͡s ə m ɐ
iewescht	i ə̯ v ə ʃ t
igel	i ʑ ə l
imaginatioun	i m ɑ ʒ i n ɑ t s j ə ʊ̯ n
improvisatioun	æ̃ː p ʀ o v i z ɑ t s j ə ʊ̯ n
indien	i n d j ə n
ingenieur	æ̃ː ʒ ə n j øː ɐ
ir	i ə̯
ir	iː ɐ
iren	i ə̯ ʀ ə n
iren	iː ʀ ə n
iwwel	i v ə l
iwwer	i v ɐ
iwwerdreiwen	i v ɐ d ʀ ɑ ɪ̯ v ə n
iwwerdriwwen	i v ɐ d ʀ i v ə n
iwwerfall	i v ɐ f ɑ l
iwwerfloss	i v ɐ f l o s
iwwergräifen	i v ɐ ɡ ʀ æˑ ɪ̯ f ə n
iwwerliewen	i v ɐ l i ə̯ v ə n
iwwersetzen	i v ɐ z æ t͡s ə n
iwwerweisen	i v ɐ v ɑ ɪ̯ z ə n
jach	j ɑ χ
jackett	ʒ ɑ k æ t
jalousie	ʒ ɑ l u z iː
januar	j ɑ n u aː χ
japanesch	j ɑ p aː n ə ʃ
jatt	ʒ ɑ t
jauwen	ʒ ɑ ʊ̯ v ə n
jeans	d͡ʒ iː n t s
jeeër	j eː ɐ
jeeër	ʒ eː ɐ
jidder	j i d ɐ
jiddereen	j i d ə ʀ eː n
jo	j oː
joen	j oː ə n
joer	j oː ɐ
joerdausend	j oː ɐ d ɑ ʊ̯ z ə n t
joerhonnert	j oː ɐ h o n ɐ t
joerzéngt	j oː ɐ t͡s e ŋ k t
joffer	j o f ɐ
jomer	j oː m ɐ
jongléieren	ʒ o ŋ ɡ l ɜ ɪ̯ ə ʀ ə n
joreszäit	j oː ə ʀ ə s t͡s æˑ ɪ̯ t
jubiléieren	j u b i l ɜ ɪ̯ ə ʀ ə n
juegd	j u ə̯ ɕ t
jugendchômage	j uː ʁ ə n t͡ʃ oː m aː ʃ
jus	ʒ yː
jäizen	j æˑ ɪ̯ t͡s ə n
jéimeren	j ɜ ɪ̯ m ə ʀ ə n
jéngelchen	j e ŋ ə l ɕ ə n
kaarp	k aː χ p
kaart	k aː χ t
kabes	k aː b ə s
kach	k ɑ χ
kachen	k ɑ χ ə n
kachkéis	k ɑ χ k ɜ ɪ̯ s
kachmaschinn	k ɑ χ m ɑ ʃ i n
kadaster	k ɑ d ɑ s t ɐ
kafen	k aː f ə n
kaffi	k ɑ f i
kalbass	k ɑ l b ɑ s
kalenner	k ɑ l æ n ɐ
kallef	k ɑ l ə f
kalleffleesch	k ɑ l ə f f l eː ʃ
kallek	k ɑ l ə k
kammoud	k ɑ m ə ʊ̯ t
kamp	k ɑ m p
kaméidi	k ɑ m ɜ ɪ̯ d i
kaméil	k ɑ m ɜ ɪ̯ l
kand	k ɑ n t
kann	k ɑ n
kanns	k ɑ n t s
kant	k ɑ n t
kaul	k ɑ ʊ̯ l
kauzeg	k ɑ ʊ̯ t͡s ə ɕ
kichelchen	k i ɕ ə l ɕ ə n
kichen	k i ɕ ə n
kierfmécher	k i ə̯ v m ə ɕ ɐ
kloer	k l oː ɐ
konstitutioun	k o n s t i t u t s j ə ʊ̯ n
konzentréieren	k o n t͡s æ n t ʀ ɜ ɪ̯ ə ʀ ə n
krouch	k ʀ ə ʊ̯ χ
kränken	k ʀ æ ŋ k ə n
kréich	k ʀ ɜ ɪ̯ ɕ
kréien	k ʀ ɜ ɪ̯ ə n
kuerz	k u ə̯ t s
kätzercher	k æ t͡s ɐ ɕ ɐ
kënnen	k ə n ə n
leeën	l eː ə n
leien	l ɑ ɪ̯ ə n
liichttuerm	l iː ɕ t u ə̯ m
lycée	l i s e
lycéesschüler	l i s e s ʃ yː l ɐ
léift	l ɜ ɪ̯ f t
léiwen	l ɜ ɪ̯ v ə n
lëtzebuerg	l ə t s ə b u ə̯ ɕ
lëtzebuergesch	l ə t͡s ə b uː ə̯ j ə ʃ
mass	m ɑ s
mauer	m ɑ ʊ̯ ɐ
mech	m ə ɕ
mir	m iː ə̯
moer	m oː ɐ
mä	m ɛː
méiglecherweis	m ɜ ɪ̯ ʑ l ə ɕ ɐ v ɑ ɪ̯ s
méindeg	m ɜ ɪ̯ n d ə ɕ
méiw	m ɜ ɪ̯ f
mëttelfeldspiller	m ə t ə l f æ l t ʃ p i l ɐ
mëttwoch	m ə t v o χ
naachen	n aː χ ə n
natierlech	n ɑ t iː ɐ l ə ɕ
net	n ə t
netzwierk	n æ d͡z v iː ə̯ k
nidderlanden	n i d ɐ l ɑ n d ə n
nuechtegailchen	n u ə̯ ɕ t ə ɡ ɑ ɪ̯ l ɕ ə n
nämlech	n ɛː m l ə ɕ
nëmmen	n ə m ə n
ofspriechen	oː f ʃ p ʀ i ə̯ ɕ ə n
olivenueleg	o l iː v ə n u ə̯ l ə ɕ
onbaarmhäerzeg	o n b aː m h ɛː ɐ̯ t͡s ə ɕ
onnatierlech	o n ɑ t iː ɐ l ə ɕ
opreegen	o p ʀ eː ʑ ə n
paangech	p aː ŋ ə ɕ
panech	p aː n ə ɕ
pankech	p ɑ ŋ k ə ɕ
plaum	p l ɑ ʊ̯ m
praum	p ʀ ɑ ʊ̯ m
priedegen	p ʀ i ə̯ d ə ʑ ə n
priedeger	p ʀ i ə̯ d ə ʑ ɐ
priedegt	p ʀ i ə̯ d ə ɕ t
pruecht	p ʀ u ə̯ ɕ t
puppelchen	p u p ə l ɕ ə n
päerd	p ɛː ə̯ t
quecksëlwer	k w æ ɡ z ə l v ɐ
queesch	k w eː ʃ
quell	k w æ l
quetsch	k w æ t͡ʃ
quitt	k w i t
quëllen	k w ə l ə n
rechtlech	ʀ æ ɕ t l ə ɕ
regel	ʀ eː ʑ ə l
rengegen	ʀ æ ŋ ə ʑ ə n
riicht	ʀ iː ɕ t
riichtbéien	ʀ iː ʑ d b ɜ ɪ̯ ə n
riichten	ʀ iː ɕ t ə n
riichter	ʀ iː ɕ t ɐ
roden	ʀ oː d ə n
räich	ʀ æː ɪ̯ ɕ
rëmeleng	ʀ ə m ə l e ŋ
sachlech	z ɑ χ l ə ɕ
salzeg	z ɑ l t͡s ə ɕ
samschdeg	z ɑ m ʒ d ə ɕ
sauerstoff	z ɑ ʊ̯ ɐ ʃ t o f
schaarf	ʃ aː f
schantjen	ʃ ɑ n t ɕ ə n
schiertech	ʃ iː ə̯ t ə ɕ
schliisslech	ʃ l iː s l ə ɕ
schluechten	ʃ l u ə̯ ɕ t ə n
schmadd	ʃ m ɑ t
schnapp	ʃ n ɑ p
schrëftsteller	ʃ ʀ ə f t ʃ t æ l ɐ
schwaarz	ʃ w aː t s
schwaarz	ʃ w aː χ t s
schweessen	ʃ w eː s ə n
schwäin	ʃ w æˑ ɪ̯ n
schwäiz	ʃ w æː ɪ̯ t͡s
schwämm	ʃ w æ m
schwätzen	ʃ w æ t s ə n
schéngen	ʃ e ŋ ə n
schëlleg	ʃ ə l ə ɕ
sech	z ə ɕ
siedegen	z i ə̯ d ə ʑ ə n
sigel	z i ʑ ə l
sonndeg	z o n d ə ɕ
sonnenënnergang	z o n ə n ə n ɐ ɡ ɑ ŋ
spoun	ʃ p ə ʊ̯ n
spriechen	ʃ p ʀ i ə̯ ɕ ə n
spriecher	ʃ p ʀ i ə̯ ɕ ɐ
sproochlech	ʃ p ʀ oː χ l ə ɕ
spären	ʃ p ɛː ʀ ə n
stater	ʃ t aː t ɐ
storch	ʃ t o χ ɕ
strofen	ʃ t ʀ oː f ə n
stroossbuerg	ʃ t ʀ oː s b uː ə̯ ɕ
strëmp	ʃ t ʀ ə m p
stäerchen	ʃ t ɛ ə̯ ɕ ə n
stänneg	ʃ t æ n ə ɕ
stär	ʃ t ɛ ə̯
stären	ʃ t ɛː ʀ ə n
stärercher	ʃ t ɛː ʀ ɐ ɕ ɐ
stécken	ʃ t e k ə n
suerg	z u ə̯ ɕ
suergen	z u ə̯ ʑ ə n
sächlech	z æ ɕ l ə ɕ
sécher	z ə ɕ ɐ
séissen	z ɜ ɪ̯ s ə n
sëndegen	z ə n d ə ʑ ə n
toufen	t ə ʊ̯ f ə n
trauen	t ʀ ɑ ʊ̯ ə n
trei	t ʀ ɑ ɪ̯
téinen	t ɜ ɪ̯ n ə n
tëscht	t ə ʃ t
uebstjus	u ə̯ b z d ʒ yː
uechten	u ə̯ ɕ t ə n
uergelbauer	u ə̯ ʑ ə l b ɑ ʊ̯ ɐ
uerteel	u ə̯ t eː l
ursaach	uː ə̯ z aː χ
uspriechen	u ʃ p ʀ i ə̯ ɕ ə n
verbannen	f ɐ b ɑ n ə n
verdeedegen	f ɐ d eː d ə ʑ ə n
verdeedeger	f ɐ d eː d ə ʑ ɐ
verfollegung	f ɐ f o l ə ʑ u ŋ
vergläichen	f ɐ ɡ l æː ɪ̯ ɕ ə n
verspriechen	f ɐ ʃ p ʀ i ə̯ ɕ ə n
verspriechung	f ɐ ʃ p ʀ i ə̯ ɕ u ŋ
versteesdemech	f ɐ ʃ t eː s d ə m ə ɕ
verstoen	f ɐ ʃ t oː ə n
versécherung	f ɐ z e ɕ ə ʀ u ŋ
verteideger	f ɐ t ɑ ɪ̯ d ə ʑ ɐ
veruechten	f ɐ u ə̯ ɕ t ə n
vir	f i ə̯
vir	f iː ɐ
waarm	v aː m
wand	v ɑ n t
wanter	v ɑ n t ɐ
wee	v eː
weeër	v eː ɐ
werfen	v æ χ f ə n
wichtegkeet	v i ɕ t ə ɕ k eː t
wieder	v i ə̯ d ɐ
wierbeldéier	v iː ə̯ b ə l d ɜ ɪ̯ ɐ
wierdegen	v iː ə̯ d ə ʑ ə n
wierder	v i ə̯ d ɐ
wierderbuch	v i ə̯ d ɐ b u χ
wirschtchen	v i χ ʃ t ɕ ə n
wirschtchen	v i χ ʃ ə n
wirschtercher	v i χ ʃ t ɐ ɕ ɐ
wopen	v oː p ə n
wourecht	v ə ʊ̯ ʀ ə ɕ t
wuert	v u ə̯ t
wurscht	v u χ ʃ t
wurschten	v u χ ʃ t ə n
wéini	v ɜ ɪ̯ n i
zeck	t͡s æ k
zecken	t͡s æ k ə n
zeechnen	t͡s eː ɕ n ə n
zeechnung	t͡s eː ɕ n u ŋ
zeitung	t͡s ɑ ɪ̯ tʰ u ŋ
zeitungen	t͡s ɑ ɪ̯ tʰ u ŋ ə n
ziffer	t͡s i f ɐ
zouspriechen	t͡s ə ʊ̯ ʃ p ʀ i ə̯ ɕ ə n
zweeeeëg	t͡s w eː ʔ eː ə ɕ
zweiwel	t͡s w ɑ ɪ̯ v ə l
zweiwelen	t͡s w ɑ ɪ̯ v ə l ə n
zwäig	t͡s w æˑ ɪ̯ ɕ
äerd	ɛ ə̯ t
äerdbier	ɛ ə̯ d b iː ɐ
äerz	ɛ ə̯ t s
äerzbëschof	ɛ ə̯ d z b ə ʃ oː f
ähnlech	ɛː n l ə ɕ
äifer	æˑ ɪ̯ f ɐ
äifereg	æˑ ɪ̯ f ə ʀ ə ɕ
äis	æˑ ɪ̯ s
äisbier	æˑ ɪ̯ z b iː ɐ
äisbierg	æˑ ɪ̯ z b i ə̯ ɕ
äisch	æˑ ɪ̯ ʃ
äishockey	æˑ ɪ̯ s h o k i
äiskal	æˑ ɪ̯ s k aː l
äisvull	æˑ ɪ̯ s f u l
äiszäit	æˑ ɪ̯ s t͡s æˑ ɪ̯ t
änneren	æ n ə ʀ ə n
ännerung	æ n ə ʀ u ŋ
äntweren	æ n d v ə ʀ ə n
äntwert	æ n d v ɐ t
äppeljus	æ p ə l ʒ yː
äppeltaart	æ p ə l t aː χ t
äppeltäsch	æ p ə l t æ ʃ
äppelviz	æ p ə l f iː t͡s
äquator	æ k w aː t o χ
är	ɛ ə̯
äschepuddel	æ ʃ ə p u d ə l
äschermëttwoch	æ ʃ ɐ m ə d v o χ
äusseren	o ɪ̯ s ə ʀ ə n
éier	ɜ ɪ̯ ɐ
éierchen	ɜ ɪ̯ ɐ ɕ ə n
éieregaascht	ɜ ɪ̯ ə ʀ ə ɡ aː ʃ t
éieren	ɜ ɪ̯ ə ʁ ə n
éig	ɜ ɪ̯ ɕ
éil	ɜ ɪ̯ l
éischt	ɜ ɪ̯ ʃ t
éislek	ɜ ɪ̯ s l e k
éisträich	ɜ ɪ̯ s t ʀ æˑ ɪ̯ ɕ
éiweg	ɜ ɪ̯ v ə ɕ
éiwegkeet	ɜ ɪ̯ v ə ɕ k eː t
ëffnung	ə f n u ŋ
ëm	ə m
ëmdoen	ə m d oː ə n
ëmdréien	ə m d ʀ ɜ ɪ̯ ə n
ëmdréiung	ə m d ʀ ɜ ɪ̯ u ŋ
ëmgang	ə m ɡ ɑ ŋ
ëmgangssprooch	ə m ɡ ɑ ŋ k s ʃ p ʀ oː χ
ëmgangssproochlech	ə m ɡ ɑ ŋ k s ʃ p ʀ oː χ l ə ɕ
ëmleeën	ə m l eː ə n
ëmsetzen	ə m z æ t͡s ə n
ëmwelt	ə m v æ l t
ëmänneren	ə m æ n ə ʀ ə n
ënn	ə n
ënnen	ə n ə n
ënner	ə n ɐ
ënnerdaach	ə n ɐ d aː χ
ënnergang	ə n ɐ ɡ ɑ ŋ
ënnerleeën	ə n ɐ l eː ə n
ënnerleien	ə n ɐ l ɑ ɪ̯ ə n
ënnerläif	ə n ɐ l æˑ ɪ̯ f
ënnerscheed	ə n ɐ ʃ eː t
ënnerwäsch	ə n ɐ v æ ʃ
ëss	ə s
ësst	ə s t
ëstlech	ə s t l ə ɕ
