aaet	ɰ ɰ æ j e tˠ
aba	ɰ æ pˠ æ ɰ
abba	ɰ æ pˠ pˠ æ ɰ
abbain	ɰ æ pˠ pˠ æ ɰ i nʲ
abōļ	ɰ æ pˠ ɛ lˠ
abōļin	ɰ æ pˠ ɛ lˠ i nʲ
addi	ɰ æ rʲ rʲ i j
aej	ɰ æ j e tʲ
aejin	ɰ æ j e tʲ i nʲ
aejkudiim	ɰ æ j e tʲ kʷ i rʲ i j i mʲ
aejkudiimin	ɰ æ j e tʲ kʷ i rʲ i j i mʲ i nʲ
aejkudiim̧	ɰ æ j e tʲ kʷ i rʲ i j i mˠ
aejkudiim̧in	ɰ æ j e tʲ kʷ i rʲ i j i mˠ i nʲ
aelok	ɰ æ j e lʲ e kʷ
aelōn̄	ɰ æ j e lʲ e ŋ
aelōn̄in	ɰ æ j e lʲ e ŋ i nʲ
aelōn̄inae	ɰ æ j e lʲ e ŋ i nʲ ɰ æ j ɛ j
aelōn̄ļapļap	ɰ æ j e lʲ e ŋ lˠ æ pʲ lˠ æ pʲ
aen	ɰ æ j ɛ nʲ
aet	ɰ ɰ æ j e tˠ
aij	ɰ æ j i tʲ
aijin	ɰ æ j i tʲ i nʲ
aijkudiim	ɰ æ j i tʲ kʷ i rʲ i j i mʲ
aijkudiimin	ɰ æ j i tʲ kʷ i rʲ i j i mʲ i nʲ
aijkudiim̧	ɰ æ j i tʲ kʷ i rʲ i j i mˠ
aijkudiim̧in	ɰ æ j i tʲ kʷ i rʲ i j i mˠ i nʲ
aj	ɰ æ tʲ
aje	ɰ æ tʲ e j
ajein	ɰ æ tʲ e j i nʲ
aji	ɰ æ tʲ i j
akjijen	ɰ æ k tʲ i j tʲ ɛ nʲ
akwāāl	ɰ æ kʷ æ j æ lʲ
allōn̄	ɰ æ lʲ lʲ e ŋ
amedka	ɰ æ mʲ ɛ rʲ k æ ɰ
am̧bo	ɰ æ mˠ pˠ e w
am̧onika	ɰ æ mˠ ɛ w nʲ i k æ ɰ
am̧onikain	ɰ æ mˠ ɛ w nʲ i k æ ɰ i nʲ
anij	ɰ æ nʲ i tʲ
an̄	ɰ æ ŋ
aolep	ɰ æ w ɛ lʲ ɛ pʲ
aoļōt	ɰ æ w e lˠ e tˠ
arņo	ɰ æ rˠ nˠ ɛ w
atļaņtiik	ɰ æ tˠ lˠ æ nˠ tˠ i j i k
aujpitōļ	ɰ æ w i tʲ pʲ i tˠ ɛ lˠ
aujtōrōlia	ɰ æ w i tʲ tˠ ɛ rˠ ɛ lʲ i j æ ɰ
aur	ɰ æ w i rˠ
awa	ɰ æ w æ ɰ
awaan	ɰ æ w æ ɰ æ nʲ
awai	ɰ æ w æ ɰ j i j
aļ	ɰ æ lˠ
aļajka	ɰ æ lˠ æ tʲ k æ ɰ
aļap	ɰ æ lˠ æ pʲ
aļaļ	ɰ æ lˠ ɰ æ lˠ
aļbapeet	ɰ æ lˠ pˠ æ ɰ pʲ ɛ j ɛ tˠ
baajikōļ	pˠ æ ɰ æ tʲ i k ɛ lˠ
baajkōļ	pˠ æ ɰ æ tʲ k ɛ lˠ
baam̧	pˠ æ ɰ æ mˠ
baam̧in	pˠ æ ɰ æ mˠ i nʲ
baam̧le	pˠ æ ɰ æ mˠ lʲ e j
baan̄ke	pˠ æ ɰ æ ŋ k e j
baba	pˠ æ ɰ pˠ æ ɰ
babbūb	pˠ æ pˠ pˠ i pˠ
bae	pˠ æ ɰ j ɛ j
baeoliin	pˠ æ ɰ j ɛ w lʲ i j i nʲ
baeoliinin	pˠ æ ɰ j ɛ w lʲ i j i nʲ i nʲ
baeļ	pˠ æ ɰ j ɛ lˠ
baibōļ	pˠ æ ɰ j i pˠ ɛ lˠ
baijin	pˠ æ ɰ j i tʲ i nʲ
baiklaaj	pˠ æ ɰ j i k lʲ æ ɰ æ tʲ
baiļat	pˠ æ ɰ j i lˠ æ tˠ
bajinjea	pˠ æ ɰ tʲ i nʲ tʲ ɛ j æ ɰ
bajjipiik	pˠ æ tʲ tʲ i j pʲ i j i k
bajjipik	pˠ æ tʲ tʲ i j pʲ i k
bao	pˠ æ ɰ w ɛ w
barulep	pˠ æ rˠ i w lʲ ɛ pʲ
bata	pˠ æ ɰ tˠ æ ɰ
baļebo̧o̧ļ	pˠ æ ɰ lˠ e j pˠ æ w æ lˠ
baļuun	pˠ æ lˠ i w i nʲ
baļuunin	pˠ æ lˠ i w i nʲ i nʲ
baļwūn	pˠ æ lˠ w i nʲ
baļwūnin	pˠ æ lˠ w i nʲ i nʲ
boea	pˠ ɛ w j æ ɰ
bojin	pˠ e w tʲ i nʲ
bok	pˠ e kʷ
bok	pˠ ɛ kʷ
bokaak	pˠ ɛ kʷ ɰ æ k
bokin	pˠ e kʷ i nʲ
bon̄	pˠ e ŋʷ
boonpe	pˠ e w e nʲ pʲ e j
boraan̄	pˠ e w rˠ æ ɰ æ ŋ
bou	pˠ e w i w
boub	pˠ e w i pˠ
bouk	pˠ e w i k
bo̧kutan̄	pˠ æ kʷ i tˠ æ ŋ
bujeen̄	pˠ i w tʲ ɛ j ɛ ŋ
bujentōm̧a	pˠ i w tʲ ɛ nʲ tˠ ɛ mˠ æ ɰ
bukun	pˠ i kʷ i nʲ
bukwabok	pˠ i kʷ æ pˠ ɛ kʷ
bukwi	pˠ i kʷ i j
buoj	pˠ i w e tʲ
buum̧	pˠ i w i mˠ
buwae	pˠ i w æ ɰ j e j
buwaj	pˠ i w æ tʲ
bwe	pˠ e j
bwe	pˠ ɛ j
bweetkōn	pˠ e j e tˠ k e nʲ
bweo	pˠ e j e w
bweoan	pˠ ɛ j ɛ w æ nʲ
bwiaea	pˠ i j æ ɰ j æ ɰ
bwiin	pˠ i j i nʲ
bwij	pˠ i tʲ
bwijuwe	pˠ i tʲ i w w e j
bwilijmāāņ	pˠ i lʲ i tʲ mʲ æ j æ nˠ
bwiro	pˠ i j rˠ e w
bāibōļ	pˠ æ j i pˠ ɛ lˠ
bōjin	pˠ e ɰ tʲ i nʲ
bōkāro	pˠ ɛ k æ j rˠ ɛ w
bōraide	pˠ ɛ rˠ æ ɰ j i rʲ ɛ j
bōta	pˠ ɛ tˠ æ ɰ
bōļaide	pˠ ɛ lˠ æ ɰ j i rʲ ɛ j
bōļao	pˠ ɛ lˠ æ ɰ w ɛ w
bōļau	pˠ ɛ lˠ æ ɰ w i w
bōļeak	pˠ ɛ lˠ j æ k
bōļeakin	pˠ ɛ lˠ j æ k i nʲ
bōļāāk	pˠ ɛ lˠ æ j æ k
bōļāākin	pˠ ɛ lˠ æ j æ k i nʲ
būranij	pˠ i rˠ æ ɰ nʲ i tʲ
būrawūn	pˠ i rˠ æ ɰ w i nʲ
būreej	pˠ i rˠ ɛ j ɛ tʲ
būrotijen	pˠ i rˠ ɛ w tˠ i j tʲ ɛ nʲ
būro̧k	pˠ i rˠ æ kʷ
būrōrō	pˠ i rˠ ɛ ɰ rˠ ɛ ɰ
būton̄	pˠ i tˠ ɛ ŋʷ
būton̄in	pˠ i tˠ ɛ ŋʷ i nʲ
būton̄ton̄	pˠ i tˠ ɛ ŋʷ tˠ ɛ ŋʷ
būttiwaļ	pˠ i tˠ tˠ i j w æ lˠ
būļajtiik	pˠ i lˠ æ tʲ tˠ i j i k
būļan̄kōj	pˠ i lˠ æ ŋ k ɛ tʲ
būļu	pˠ i lˠ i w
būļāide	pˠ i lˠ æ j i rʲ ɛ j
būļāwūt	pˠ i lˠ æ j w i tˠ
da	rʲ æ ɰ
dak	rʲ æ k
debweiu	rʲ ɛ pˠ e j i w
deo̧	rʲ ɛ j æ w
diaka	rʲ i j æ k æ ɰ
diin̄ko	rʲ i j i ŋ k e w
dik	rʲ i k
ditōb	rʲ i tˠ e pˠ
diwōj	rʲ i j w e tʲ
duoj	rʲ i w e tʲ
dān	rʲ æ nʲ
dānnin	rʲ æ nʲ nʲ i nʲ
dāp	rʲ æ pʲ
eakeak	j æ k j æ k
eakeake	j æ k j æ k ɛ j
eakto	j æ k tˠ e w
eaktuwe	j æ k tˠ i w ɛ j
ean̄	j æ ŋ
ean̄in	j æ ŋ i nʲ
eaļ	j æ lˠ
ebeje	j ɛ pʲ tʲ æ j
ed	j ɛ rʲ
eijia	j e j i tʲ i j æ ɰ
ek	j e k
elej	j ɛ lʲ ɛ tʲ
ellep	j ɛ lʲ lʲ ɛ pʲ
em	j ɛ mʲ
emān	j ɛ mʲ æ nʲ
em̧m̧an	j ɛ mˠ mˠ æ nʲ
ene	j e nʲ e j
enjeļ	j ɛ nʲ tʲ ɛ lˠ
enm̧aat	j ɛ nʲ mˠ æ ɰ æ tˠ
en̄oul	j e ŋ e w i lʲ
eok	j e kʷ
eo̧n̄	j æ ŋʷ
eo̧n̄wōd	j æ ŋʷ ɛ rʲ
eo̧n̄ōd	j æ ŋʷ ɛ rʲ
eo̧r	j æ rʷ
eo̧werōk	j æ w e j rˠ e k
epatōn	j ɛ pʲ æ tˠ ɛ nʲ
epjā	j ɛ pʲ tʲ æ j
epoon	j ɛ pʲ ɛ w ɛ nʲ
eprōļ	j ɛ pʲ rˠ ɛ lˠ
erm̧we	j e rˠ mˠ e j
erm̧ween	j e rˠ mˠ e j e nʲ
etal	j ɛ tˠ æ lʲ
ewan	j ɛ w æ nʲ
ewerōk	j e w e j rˠ e k
eļbōn	j ɛ lˠ pˠ ɛ nʲ
eōō	j ɛ ɰ ɛ ɰ
iaab	j i̯ j æ ɰ æ pˠ
iaam̧	j i̯ j æ ɰ æ mˠ
iakiakwe	j i̯ j æ kʷ j i̯ j æ kʷ ɛ j
iakiu	j i̯ j æ k i j i w
iakiuin	j i̯ j æ k i j i w i nʲ
iakwe	j i̯ j æ kʷ ɛ j
iakwāāl	j i ɰ æ kʷ æ j æ lʲ
iaļ	j i j æ lˠ
iaļo	j i j æ lˠ e w
ibae	j i pˠ æ ɰ j ɛ j
ibbuku	j i pˠ pˠ i kʷ i w
ibkij	j i pˠ k i tʲ
idaak	j i rʲ æ ɰ æ k
iia	j i j j æ ɰ
iiaeae	j i j j æ ɰ j æ ɰ j ɛ j
iiaieo	j i j j æ ɰ j i j e w
iiaļ	j i j j æ lˠ
iiaļan̄e	j i j j æ lˠ æ ŋ ɛ j
iiaļo	j i j j æ lˠ e w
iij	j i j i tʲ
iiāekwōj	j i j j æ j e kʷ e tʲ
iiāio	j i j j æ j i j e w
ijitō	j i tʲ i tˠ ɛ ɰ
iju	j i tʲ i w
ikbwij	j i k pˠ i tʲ
ilo	j i lʲ e w
ilo	j i lʲ ɛ w
im	j i mʲ
im̧wej	j i mˠ j e tʲ
in	j i nʲ
indeeo	j i nʲ rʲ e j j ɛ w
intia	j i nʲ tˠ i j æ ɰ
intiia	j i nʲ tˠ i j i j æ ɰ
in̄	j i ŋ
in̄len	j i ŋ lʲ ɛ nʲ
in̄lij	j i ŋ lʲ i tʲ
io̧kio̧kwe	j i̯ j æ kʷ j i̯ j æ kʷ ɛ j
io̧kwe	j i̯ j æ kʷ ɛ j
io̧kwein	j i̯ j æ kʷ e j i nʲ
io̧o̧t	j i̯ j æ w æ tˠ
irooj	j i rˠ ɛ w ɛ tʲ , j i rˠ e w e tʲ
iroojin	j i rˠ ɛ w ɛ tʲ i nʲ , j i rˠ e w e tʲ i nʲ
irwōj	j i rˠ w ɛ tʲ , j i rˠ w e tʲ
iu	j i w
iuun	j i w i nʲ
iuunin	j i w i nʲ i nʲ
iuwi	j i w w i j
iāekwōj	j i j æ j e kʷ e tʲ
iōn̄	j i̯ j e ŋ
iōn̄in	j i̯ j e ŋ i nʲ
jaab	tʲ æ ɰ æ pˠ
jaajmi	tʲ æ ɰ æ tʲ mʲ i j
jaam̧	tʲ æ ɰ æ mˠ
jaat	tʲ æ ɰ æ tˠ
jabwi	tʲ æ pˠ i j
jabōn	tʲ æ pˠ ɛ nʲ
jabōt	tʲ æ pˠ ɛ tˠ
jabōļ	tʲ æ pˠ ɛ lˠ
jaidin̄	tʲ æ ɰ j i rʲ j i ŋ
jaij	tʲ æ ɰ j i tʲ
jain	tʲ æ ɰ j i nʲ
jaina	tʲ æ ɰ j i nʲ æ ɰ
jaintiij	tʲ æ ɰ j i nʲ tˠ i j i tʲ
jaki	tʲ æ k i j
jakkūramen	tʲ æ k k i rˠ æ ɰ mʲ ɛ nʲ
jakōļ	tʲ æ k ɛ lˠ
jam̧uwa	tʲ æ ɰ mˠ i w w æ ɰ
jam̧ōņ	tʲ æ mˠ ɛ nˠ
jan̄	tʲ æ ŋ
jan̄ai	tʲ æ ɰ ŋ æ ɰ j i j
jan̄ij	tʲ æ ŋ i tʲ
jan̄in̄i	tʲ æ ɰ ŋ i j ŋ i j
jarej	tʲ æ rˠ ɛ tʲ
jarom	tʲ æ rʷ ɛ mʲ
jaromin	tʲ æ rʷ ɛ mʲ i nʲ
jarōj	tʲ æ rˠ ɛ tʲ
jatiin	tʲ æ ɰ tˠ i j i nʲ
jatiraito	tʲ æ ɰ tˠ i j rˠ æ ɰ j i tˠ e w
jauwi	tʲ æ w w i j
jaņtōj	tʲ æ nˠ tˠ ɛ tʲ
je	tʲ e j
jebat	tʲ ɛ pˠ æ tˠ
jebkwanwūjo̧	tʲ ɛ pˠ kʷ æ nʲ w i tʲ æ w
jebtōm̧ba	tʲ ɛ pˠ tˠ ɛ mˠ pˠ æ ɰ
jebwa	tʲ ɛ pˠ w æ ɰ
jebwad	tʲ ɛ pˠ w æ rʲ
jedo̧ujij	tʲ ɛ rʲ æ w i tʲ i tʲ
jedpānit	tʲ ɛ rʲ pʲ æ nʲ i tˠ
jeen	tʲ ɛ j ɛ nʲ
jeeļ	tʲ ɛ j ɛ lˠ
jeina	tʲ e j i nʲ æ ɰ
jelba	tʲ e lʲ pˠ æ ɰ
jelbain	tʲ e lʲ pˠ æ ɰ i nʲ
jemene	tʲ ɛ mʲ ɛ nʲ ɛ j
jemo̧	tʲ æ j mʲ æ w
jem̧ar	tʲ ɛ mˠ æ rˠ
jendik	tʲ ɛ nʲ rʲ i k , tʲ e nʲ rʲ i k
jennade	tʲ ɛ nʲ nʲ æ ɰ rʲ e j
jepaan	tʲ ɛ pʲ æ ɰ æ nʲ
jeptōm̧ba	tʲ ɛ pʲ tˠ ɛ mˠ pˠ æ ɰ
jera	tʲ ɛ rˠ æ ɰ
jerbal	tʲ ɛ rˠ pˠ æ lʲ
jerā	tʲ ɛ rˠ æ j
jibuki	tʲ i pˠ i kʷ i j
jibukwi	tʲ i pˠ i kʷ i j
jiij	tʲ i j i tʲ
jiijin	tʲ i j i tʲ i nʲ
jiip	tʲ i j i pʲ
jiipip	tʲ i j i pʲ j i pʲ
jijej	tʲ i j tʲ e tʲ
jijer	tʲ i j tʲ ɛ rˠ
jijilimjuon	tʲ i tʲ i lʲ i mʲ tʲ i w ɛ nʲ
jijāj	tʲ i j tʲ æ tʲ
jikako	tʲ i k æ ɰ k e w
jikka	tʲ i k k æ ɰ
jikuuļ	tʲ i k i w i lˠ
jiljilimjuon	tʲ i lʲ tʲ i lʲ i mʲ tʲ i w ɛ nʲ
jiljilimjuonn̄oul	tʲ i lʲ tʲ i lʲ i mʲ tʲ i w ɛ nʲ ŋ e w i lʲ
jiljino	tʲ i tʲ i nʲ ɛ w
jiljinon̄oul	tʲ i tʲ i nʲ ɛ w ŋ e w i lʲ
jiljinōn̄n̄oul	tʲ i tʲ i nʲ e ŋ ŋ e w i lʲ
jiln̄uul	tʲ i lʲ ŋ i w i lʲ
jilu	tʲ i lʲ i w
jimeeņ	tʲ i mʲ ɛ j ɛ nˠ
jimjuon	tʲ i mʲ tʲ i w ɛ nʲ
jimjuon̄oul	tʲ i mʲ tʲ i w ɛ ŋ e w i lʲ
jimāāņ	tʲ i mʲ æ j æ nˠ
jipein	tʲ i pʲ e j i nʲ
jisōs	tʲ i j tʲ e tʲ
jitni	tʲ i tˠ nʲ i j
jito̧kin	tʲ i tˠ æ w k i nʲ
jitūūl	tʲ i tˠ i ɰ i lʲ
jitūūlin	tʲ i tˠ i ɰ i lʲ i nʲ
joiu	tʲ e w j i w
jojo	tʲ e w tʲ e w
jojo	tʲ ɛ w tʲ ɛ w
jojoin	tʲ e w tʲ e w i nʲ
jojoin	tʲ ɛ w tʲ e w i nʲ
jok	tʲ ɛ kʷ
jon̄oul	tʲ e ŋʷ e w i lʲ , tʲ ɛ ŋʷ e w i lʲ
joob	tʲ ɛ w ɛ pˠ
joobin	tʲ ɛ w ɛ pˠ i nʲ
jourur	tʲ e w i rˠ w i rˠ
jowapin	tʲ ɛ w æ ɰ pʲ i nʲ
jo̧jej	tʲ æ w tʲ ɛ tʲ
jo̧kleej	tʲ æ kʷ lʲ ɛ j ɛ tʲ
jo̧o̧n	tʲ æ w æ nʲ
jo̧o̧ļ	tʲ æ w æ lˠ
jo̧uwi	tʲ æ w w i j
juga	tʲ i kʷ æ ɰ
juje	tʲ i w tʲ ɛ j
jukuuļ	tʲ i kʷ i w i lˠ
jukwa	tʲ i kʷ æ ɰ
jukwain	tʲ i kʷ æ ɰ i nʲ
jukweea	tʲ i kʷ ɛ j j æ ɰ
jukweeain	tʲ i kʷ ɛ j j æ ɰ i nʲ
juon	tʲ i w ɛ nʲ
jurbak	tʲ i rʷ pˠ æ k
jure	tʲ i w rˠ e j
jurub	tʲ i rʷ i pˠ
jurubin	tʲ i rʷ i pˠ i nʲ
juub	tʲ i w i pˠ
juubin	tʲ i w i pˠ i nʲ
juuj	tʲ i w i tʲ
juun	tʲ i w i nʲ
juwapen	tʲ i w w æ pʲ e nʲ
juwapin	tʲ i w æ ɰ pʲ i nʲ
juļae	tʲ i w lˠ æ ɰ j ɛ j
jādede	tʲ æ rʲ ɛ j rʲ ɛ j
jāidin̄	tʲ æ j i rʲ j i ŋ
jāij	tʲ æ j i tʲ
jāina	tʲ æ j i nʲ æ ɰ
jāioon	tʲ æ j i j ɛ w ɛ nʲ
jāipaan	tʲ æ j i pʲ æ ɰ æ nʲ
jāj	tʲ æ tʲ
jāje	tʲ æ j tʲ e j
jālele	tʲ æ lʲ e j lʲ e j
jālooj	tʲ æ lʲ e w e tʲ
jālwōj	tʲ æ lʲ w e tʲ
jāmne	tʲ æ mʲ nʲ ɛ j
jāmo̧	tʲ æ j mʲ æ w
jāndik	tʲ æ nʲ rʲ i k
jāntōj	tʲ æ nʲ tˠ ɛ tʲ
jānwōde	tʲ æ nʲ w ɛ rʲ ɛ j
jāān	tʲ æ j æ nʲ
jāānwūj	tʲ æ j æ nʲ w i tʲ
kaab	k æ ɰ æ pˠ
kaaj	k æ ɰ æ tʲ
kaar	k æ ɰ æ rˠ
kaarar	k æ ɰ æ rˠ ɰ æ rˠ
kaarin	k æ ɰ æ rˠ i nʲ
kaj	k æ tʲ
kajin	k æ tʲ i nʲ
kajji	k æ tʲ tʲ i j
kako	k æ ɰ k e w
kalboonea	k æ lʲ pˠ ɛ w ɛ nʲ j æ ɰ
kameļ	k æ mʲ ɛ lˠ
kam̧bōj	k æ mˠ pˠ ɛ tʲ
kam̧putōr	k æ mˠ pʲ i w tˠ ɛ rˠ
kanbōj	k æ nʲ pˠ ɛ tʲ
kanniōk	k æ nʲ nʲ i j e k
kanniōkin	k æ nʲ nʲ i j e k i nʲ
kapel	k æ ɰ pʲ ɛ lʲ
kapen	k æ pʲ ɛ nʲ
kapilōn̄	k æ pʲ i j lʲ e ŋ
kapjer	k æ pʲ tʲ e rˠ
kapjerin	k æ pʲ tʲ e rˠ i nʲ
kapjor	k æ pʲ tʲ e rʷ
kapjorin	k æ pʲ tʲ e rʷ i nʲ
kapwor	k æ pʲ w e rˠ
kare	k æ rˠ e j
karjin	k æ rˠ tʲ i nʲ
karoļāin	k æ rˠ ɛ w lˠ æ j i nʲ
katiin	k æ ɰ tˠ i j i nʲ
katiin̄	k æ ɰ tˠ i j i ŋ
katin	k æ tˠ i nʲ
katkijm̧uuj	k æ tˠ k i tʲ mˠ i w i tʲ
katlik	k æ tˠ lʲ i k
katļo̧k	k æ tˠ lˠ æ kʷ
katļo̧kin	k æ tˠ lˠ æ kʷ i nʲ
kau	k æ ɰ w i w
kaubowe	k æ ɰ w i w pˠ ɛ w ɛ j
kaubowein	k æ ɰ w i w pˠ e w e j i nʲ
kauin	k æ ɰ w i w i nʲ
keepran̄	k ɛ j ɛ pʲ rˠ æ ŋ
kena	k ɛ j nʲ æ ɰ
kiaaj	k i j æ ɰ æ tʲ
kiaj	k i j ɰ æ tʲ
kideddelbwij	k i rʲ e rʲ rʲ e lʲ pˠ i tʲ
kidu	k i rʲ i w
kiduin	k i rʲ i w i nʲ
kiduun	k i rʲ i w i nʲ
kieo	k i j j ɛ w
kiin̄	k i j i ŋ
kiin̄in	k i j i ŋ i nʲ
kij	k i tʲ
kijdik	k i tʲ rʲ i k
kijeek	k i tʲ ɛ j ɛ k
kil	k i lʲ
kilaaj	k i lʲ æ ɰ æ tʲ
kilaj	k i lʲ ɰ æ tʲ
kilbōt	k i lʲ pˠ ɛ tˠ
kilin	k i lʲ i nʲ
kilmeej	k i lʲ mʲ ɛ j ɛ tʲ
kilmir	k i lʲ mʲ i rˠ
kimej	k i mʲ e tʲ
kio	k i j ɛ w
kior	k i j e rʷ
kiorin	k i j e rʷ i nʲ
kipilōn̄	k i pʲ i j lʲ e ŋ
kito	k i j tˠ e w
kiuba	k i j i w pˠ æ ɰ
kiudi	k i j i w rʲ i j
kiur	k i j i rʷ
kiurin	k i j i rʷ i nʲ
koba	k e w pˠ æ ɰ
koba	k ɛ w pˠ æ ɰ
koko	k e w k e w
koko	k e w k e w , k ɛ w k ɛ w , kʷ e w kʷ e w , kʷ ɛ w kʷ ɛ w
kokōro	k ɛ w k ɛ rˠ ɛ w
kom̧	kʷ e mˠ
kom̧le	kʷ e mˠ lʲ e j
kom̧m̧ool	kʷ ɛ mˠ mˠ ɛ w ɛ lʲ
koot	k ɛ w ɛ tˠ
korap	kʷ ɛ rˠ æ pʲ
kotin	kʷ ɛ tˠ i nʲ
kotōl	kʷ e tˠ ɛ lʲ
koļeiaat	kʷ e lˠ e j i j æ ɰ æ tˠ
ko̧kwe	kʷ æ kʷ e j
ko̧o̧j	k æ w æ tʲ
ko̧o̧joj	k æ w æ tʲ w e tʲ
ko̧o̧n	k æ w æ nʲ
ko̧pe	k æ w pʲ e j
kraist	k i rˠ æ ɰ j i tʲ
kuajleen	kʷ i w æ tʲ lʲ ɛ j ɛ nʲ
kuam̧	kʷ i w ɰ æ mˠ
kujjae	kʷ i tʲ tʲ æ ɰ j ɛ j
kuria	kʷ i rˠ i j æ ɰ
kuriļa	kʷ i rˠ i j lˠ æ ɰ
kurm̧a	kʷ i rˠ mˠ æ ɰ
kurob	kʷ i rʷ ɛ pˠ
kuuj	k i w i tʲ
kuujin	k i w i tʲ i nʲ
kuum̧	k i w i mˠ
kuum̧in	k i w i mˠ i nʲ
kuum̧um̧	k i w i mˠ w i mˠ
kuwaam̧	kʷ i w æ ɰ æ mˠ
kuwaj	kʷ i w æ tʲ
kuwajleen	kʷ i w æ tʲ lʲ ɛ j ɛ nʲ
kuļuļ	kʷ i lʷ i lʷ
kwarkwar	kʷ æ rˠ kʷ æ rˠ
kwaļm̧we	kʷ æ lˠ mˠ e j
kweet	kʷ e j e tˠ
kweetin	kʷ e j e tˠ i nʲ
kwiin	kʷ i j i nʲ
kwiinin	kʷ i j i nʲ i nʲ
kwōle	kʷ e lʲ e j
kwōle	kʷ ɛ lʲ ɛ j
kwōlej	kʷ e lʲ j e tʲ , kʷ ɛ lʲ j ɛ tʲ
kāpin	k æ j pʲ i nʲ
kāāntōļ	k æ j æ nʲ tˠ ɛ lˠ
kāān̄	k æ j æ ŋ
kōba	k ɛ pˠ æ ɰ
kōbaatat	k ɛ pˠ æ ɰ æ tˠ ɰ æ tˠ
kōjae	k ɛ tʲ æ ɰ j ɛ j
kōjjeb	k ɛ tʲ tʲ ɛ pˠ
kōjwad	k ɛ tʲ w æ rʲ
kōjām	k ɛ tʲ æ mʲ
kōle	k e lʲ e j
kōm	k e mʲ
kōmālij	k ɛ mʲ æ lʲ i tʲ
kōrein	k ɛ rˠ e j i nʲ
kōrā	k ɛ rˠ æ j
kōrāin	k ɛ rˠ æ j i nʲ
kōtrāāk	k ɛ tˠ rˠ æ j æ k
kōtōmānlimpok	k ɛ tˠ ɛ mʲ æ nʲ lʲ i mʲ pʲ ɛ kʷ
kōōb	k e ɰ e pˠ
kūm̧ake	k i mˠ æ k e j
kūraij	k i rˠ æ ɰ j i tʲ
kūrawūn	k i rˠ æ ɰ w i nʲ
kūrawūnin	k i rˠ æ ɰ w i nʲ i nʲ
kūre	k i rˠ e j
kūreep	k i rˠ e j e pʲ
kūrepe	k i rˠ e j pʲ e j
kūriij	k i rˠ i j i tʲ
kūriin	k i rˠ i j i nʲ
kūrijm̧ōj	k i rˠ i tʲ mˠ e tʲ
kūrjin	k i rˠ tʲ i nʲ
kūro	k i rˠ e w
kūru	k i rˠ i w
kūta	k i tˠ æ ɰ
kūtain	k i tˠ æ ɰ i nʲ
lae	lʲ æ ɰ j ɛ j
lan̄	lʲ æ ŋ
lelejkakkak	lʲ e lʲ e tʲ k æ k k æ k
lemn̄oul	lʲ e mʲ ŋ e w i lʲ
lerooj	lʲ e j rˠ e w e tʲ
leroojin	lʲ e j rˠ e w e tʲ i nʲ
libwetōr	lʲ i pˠ ɛ j tˠ ɛ rˠ
liele	lʲ i j e lʲ e j
lijjo̧o̧n	lʲ i tʲ tʲ æ w æ nʲ
likiep	lʲ i k i j ɛ pʲ
likijjine	lʲ i k i tʲ tʲ i nʲ e j
lomo̧o̧r	lʲ ɛ w mʲ æ w æ rˠ
lo̧jet	lʲ æ w tʲ e tˠ
lo̧lo̧	lʲ æ w lʲ æ w
lo̧lo̧in	lʲ æ w lʲ æ w i nʲ
lo̧mo̧o̧r	lʲ æ w mʲ æ w æ rˠ
lūbōntōr	lʲ i pˠ ɛ nʲ tˠ ɛ rˠ
mar	mʲ æ rˠ
maroro	mʲ æ ɰ rˠ ɛ w rˠ ɛ w
mat	mʲ æ tˠ
meik	mʲ e j i k
mejatoto	mʲ ɛ tʲ æ tˠ ɛ w tˠ ɛ w
mejatto	mʲ ɛ tʲ æ tˠ tˠ ɛ w
mejjiko	mʲ ɛ tʲ tʲ i k ɛ w
metak	mʲ ɛ tˠ æ k
metwe	mʲ e tˠ w e j
mijel	mʲ i tʲ e lʲ
mile	mʲ i lʲ e j
milik	mʲ i lʲ i k
mir	mʲ i rˠ
mouj	mʲ e w i tʲ
mour	mʲ e w i rˠ
mourin	mʲ e w i rˠ i nʲ
mā	mʲ æ j
mādke	mʲ æ rʲ k e j
māe	mʲ æ j e j
māj	mʲ æ tʲ
mājeej	mʲ æ tʲ e j e tʲ
mājej	mʲ æ tʲ j e tʲ
mājro	mʲ æ tʲ rˠ e w
mājur	mʲ æ tʲ i rʷ
mānnueaļ	mʲ æ nʲ nʲ i w j æ lˠ
m̧aaj	mˠ æ ɰ æ tʲ
m̧adianna	mˠ æ rʲ i j ɰ æ nʲ nʲ æ ɰ
m̧aikronijia	mˠ æ ɰ j i k rʷ ɛ nʲ i tʲ i j æ ɰ
m̧ajeļ	mˠ æ ɰ tʲ ɛ lˠ
m̧akneet	mˠ æ k nʲ ɛ j ɛ tˠ
m̧akōni	mˠ æ ɰ k ɛ nʲ i j
m̧am̧a	mˠ æ ɰ mˠ æ ɰ
m̧am̧ōj	mˠ æ mˠ e tʲ
m̧ande	mˠ æ nʲ rʲ ɛ j
m̧aļoeļap	mˠ æ lˠ ɛ w j ɛ lˠ æ pʲ
m̧aōkōni	mˠ æ ɰ ɛ ɰ k ɛ nʲ i j
m̧m̧an	mˠ mˠ æ nʲ
m̧ool	mˠ ɛ w ɛ lʲ
m̧upi	mˠ i w pʲ i j
m̧uļe	mˠ i lʷ e j
m̧uļein	mˠ i lʷ e j i nʲ
m̧weiuk	mˠ e j i kʷ
m̧weiukin	mˠ e j i kʷ i nʲ
m̧wian̄	mˠ i j æ ŋ
m̧wian̄in	mˠ i j æ ŋ i nʲ
m̧wijm̧wij	mˠ i tʲ mˠ i tʲ
m̧winam̧ōn	mˠ i nʲ æ mˠ ɛ nʲ
m̧ōjlim	mˠ ɛ tʲ lʲ i mʲ
m̧ōjm̧ōj	mˠ e tʲ mˠ e tʲ
m̧ōm̧	mˠ e mˠ
m̧ōm̧an	mˠ ɛ mˠ æ nʲ
m̧ōm̧ōj	mˠ e mˠ e tʲ
m̧ōn̄ā	mˠ ɛ ŋ æ j
m̧ūrar	mˠ i rˠ æ rˠ
naaj	nʲ æ ɰ æ tʲ
nam̧	nʲ æ mˠ
nam̧dik	nʲ æ mˠ rʲ i k
nam̧o	nʲ æ mˠ e w
nana	nʲ æ ɰ nʲ æ ɰ
nawōdo	nʲ æ ɰ w ɛ rʲ ɛ w
ni	nʲ i j
nibbon̄	nʲ i pˠ pˠ ɛ ŋʷ
niiļ	nʲ i j i lˠ
nim̧ur	nʲ i mˠ i rʷ
nitijeļā	nʲ i tˠ i j tʲ ɛ lˠ æ j
nitōļ	nʲ i tˠ ɛ lˠ , nʲ i j tˠ ɛ lˠ
nobōm̧ba	nʲ ɛ w pˠ ɛ mˠ pˠ æ ɰ
nopem̧ba	nʲ ɛ w pʲ ɛ mˠ pˠ æ ɰ
nujiiļōn	nʲ i w tʲ i j i lˠ ɛ nʲ
nukne	nʲ i kʷ nʲ e j , nʲ i kʷ nʲ ɛ j
nuuj	nʲ i w i tʲ
nuujpeba	nʲ i w i tʲ pʲ e j pˠ æ ɰ
nuwio̧o̧k	nʲ i w i j æ w æ k
nāj	nʲ æ tʲ
nōt	nʲ ɛ tˠ , nʲ e tˠ
nōļ	nʲ ɛ lˠ
n̄e	ŋ e j
n̄e	ŋ ɛ j
n̄i	ŋ i j
n̄iitwa	ŋ i j i tˠ w æ ɰ
n̄ituwa	ŋ i j tˠ i w æ ɰ
obwin	w ɛ pˠ i nʲ , w e pˠ i nʲ
obwinin	w ɛ pˠ i nʲ i nʲ , w e pˠ i nʲ i nʲ
oja	w ɛ tʲ æ ɰ
ok	w e kʷ
oktoba	w ɛ k tˠ ɛ w pˠ æ ɰ
om̧	w e mˠ
om̧rawūn	w ɛ mˠ rˠ æ ɰ w i nʲ
on̄kon̄	w ɛ ŋʷ kʷ ɛ ŋʷ
opiem̧	w e pʲ i j e mˠ
opij	w ɛ pʲ j i tʲ
oran	w ɛ rˠ æ nʲ
orpāp	w e rˠ pʲ æ pʲ
oteeļ	w ɛ tˠ ɛ j ɛ lˠ
otemjej	w e tˠ e mʲ tʲ e tʲ
otemjeļo̧k	w e tˠ e mʲ tʲ ɛ lˠ æ kʷ
otobai	w ɛ tˠ ɛ w pˠ æ ɰ i j
oļeo̧	w ɛ lˠ ɛ j æ w
oļip	w ɛ lˠ i pʲ
o̧b	w æ pˠ
o̧kwōj	w æ kʷ ɛ tʲ
o̧kwōn	w æ kʷ ɛ nʲ
o̧kwōnin	w æ kʷ ɛ nʲ i nʲ
o̧kōnjo̧	w æ kʷ ɛ nʲ tʲ æ w
o̧o̧j	w æ w æ tʲ
o̧o̧jin	w æ w æ tʲ i nʲ
o̧o̧jo̧j	w æ w æ tʲ w æ tʲ
o̧waj	w æ w w æ tʲ
o̧wajin	w æ w w æ tʲ i nʲ
pako	pʲ æ k ɛ w
pat	pʲ æ tˠ
peba	pʲ e j pˠ æ ɰ
peba	pʲ ɛ pˠ æ ɰ
pedam̧wijm̧wij	pʲ ɛ rʲ æ mˠ i tʲ mˠ i tʲ
pedan̄otn̄ot	pʲ ɛ rʲ æ ŋʷ ɛ tˠ ŋʷ ɛ tˠ
pedan̄utn̄ut	pʲ ɛ rʲ æ ŋʷ i tˠ ŋʷ i tˠ
pedan̄wūjn̄wūj	pʲ ɛ rʲ æ ŋʷ i tʲ ŋʷ i tʲ
peejnej	pʲ e j e tʲ nʲ e tʲ
peinabōļ	pʲ e j i nʲ æ ɰ pˠ ɛ lˠ
peljem̧	pʲ ɛ lʲ tʲ ɛ mˠ
penkō	pʲ ɛ nʲ k ɛ ɰ
penkōin	pʲ ɛ nʲ k e ɰ i nʲ
pepa	pʲ ɛ pʲ æ ɰ
peptaij	pʲ ɛ pʲ tˠ æ ɰ j i tʲ
peran	pʲ ɛ rˠ æ nʲ
petkōj	pʲ e tˠ k e tʲ
pi	pʲ i j
pia	pʲ i j æ ɰ
piaea	pʲ i j æ ɰ j æ ɰ
piano	pʲ i j æ ɰ nʲ ɛ w
pianoin	pʲ i j æ ɰ nʲ e w i nʲ
piik	pʲ i j i k
piin̄	pʲ i j i ŋ
piji	pʲ i j tʲ i j
pijin	pʲ i tʲ i nʲ
pik	pʲ i k
pikaar	pʲ i k æ ɰ æ rˠ
pikeej	pʲ i k ɛ j ɛ tʲ
pikin	pʲ i k i nʲ
pikinni	pʲ i k i nʲ nʲ i j
pikōļ	pʲ i k ɛ lˠ
pilawā	pʲ i lʲ æ ɰ w æ j
piliet	pʲ i lʲ i j ɛ tˠ
pilipin	pʲ i lʲ i pʲ i nʲ
pinana	pʲ i nʲ æ ɰ nʲ æ ɰ
pinjeļ	pʲ i nʲ tʲ ɛ lˠ
pinneep	pʲ i nʲ nʲ ɛ j ɛ pʲ
pinniep	pʲ i nʲ nʲ i j ɛ pʲ
pinōt	pʲ i j nʲ ɛ tˠ
piolōt	pʲ i j ɛ w lʲ ɛ tˠ
pirōk	pʲ i rˠ e k
piteto	pʲ i tˠ ɛ j tˠ ɛ w
piwūj	pʲ i j w i tʲ
pāpode	pʲ æ pʲ ɛ w rʲ ɛ j
pāār	pʲ æ j æ rˠ
pāārin	pʲ æ j æ rˠ i nʲ
raij	rˠ æ ɰ j i tʲ
raijin	rˠ æ ɰ j i tʲ i nʲ
raj	rˠ æ tʲ
rak	rˠ æ k
ralitōk	rˠ æ ɰ lʲ i j tˠ e k
rapit	rˠ æ pʲ i tˠ
ratak	rˠ æ ɰ tˠ æ k
ratimjuon	rˠ æ ɰ tˠ i mʲ tʲ i w ɛ nʲ
reba	rˠ e j pˠ æ ɰ
rej	rˠ ɛ tʲ
rilomo̧o̧r	rˠ i lʲ ɛ w mʲ æ w æ rˠ
rilo̧mo̧o̧r	rˠ i lʲ æ w mʲ æ w æ rˠ
robba	rʷ ɛ pˠ pˠ æ ɰ
robbain	rʷ ɛ pˠ pˠ æ ɰ i nʲ
roj	rʷ ɛ tʲ
rojia	rʷ e w tʲ i j æ ɰ
ron̄	rˠ ɛ ŋʷ
ron̄dik	rʷ ɛ ŋʷ rʲ i k
ron̄oul	rˠ ɛ ŋʷ e w i lʲ , rˠ e ŋʷ e w i lʲ
ron̄ļap	rʷ ɛ ŋʷ lˠ æ pʲ
rooj	rˠ ɛ w ɛ tʲ
roojin	rˠ ɛ w ɛ tʲ i nʲ
roojoj	rˠ ɛ w ɛ tʲ w ɛ tʲ
rualitōk	rˠ i w æ ɰ lʲ i j tˠ e k
ruatimjuon	rˠ i w æ ɰ tˠ i mʲ tʲ i w ɛ nʲ
ruk	rˠ i kʷ
ruo	rˠ i w ɛ w
ruot	rʷ i w ɛ tˠ
ruujia	rʷ i w i tʲ j i j æ ɰ
ruwalitōk	rˠ i w æ ɰ lʲ i j tˠ e k
ruwatimjuon	rˠ i w æ ɰ tˠ i mʲ tʲ i w ɛ nʲ
rwalitōk	rʷ æ ɰ lʲ i j tˠ e k
rālik	rˠ æ j lʲ i k
rārōk	rˠ æ j rˠ e k
rōplen	rˠ ɛ pʲ lʲ ɛ nʲ
rūm̧m̧an	rˠ i mˠ mˠ æ nʲ
tabwil	tˠ æ pˠ i lʲ
taeo	tˠ æ ɰ j ɛ w
taewan	tˠ æ ɰ j ɛ w æ nʲ
taibuun	tˠ æ ɰ j i pˠ i w i nʲ
taije	tˠ æ ɰ j i tʲ ɛ j
taikō	tˠ æ ɰ j i k ɛ ɰ
taim̧oņ	tˠ æ ɰ j i mˠ ɛ nʷ
taiwan	tˠ æ ɰ j i w æ nʲ
tak	tˠ æ k
take	tˠ æ k e j
takin	tˠ æ k i nʲ
taktō	tˠ æ k tˠ ɛ ɰ
talboon	tˠ æ lʲ pˠ ɛ w ɛ nʲ
tampeļ	tˠ æ mʲ pʲ ɛ lˠ
tanim	tˠ æ nʲ i mʲ
tapioka	tˠ æ pʲ i j ɛ w k æ ɰ
tata	tˠ æ ɰ tˠ æ ɰ
taun	tˠ æ ɰ w i nʲ
tawūn	tˠ æ ɰ w i nʲ
taļa	tˠ æ ɰ lˠ æ ɰ
tebu	tˠ e j pˠ i w
teem̧bura	tˠ ɛ j ɛ mˠ pˠ i rʷ æ ɰ
teem̧būra	tˠ ɛ j ɛ mˠ pˠ i rˠ æ ɰ
teļap	tˠ ɛ j lˠ æ pʲ
ti	tˠ i j
tiin	tˠ i j i nʲ
tijem̧ba	tˠ i j tʲ ɛ mˠ pˠ æ ɰ
til	tˠ i lʲ
tonaaj	tˠ ɛ w nʲ æ ɰ æ tʲ
toļ	tˠ ɛ lʷ
toļin	tˠ ɛ lʷ i nʲ
toņ	tˠ ɛ nʷ
to̧nōt	tˠ æ w nʲ ɛ tˠ
to̧o̧l	tˠ æ w æ lʲ
to̧o̧lin	tˠ æ w æ lʲ i nʲ
to̧o̧n̄ke	tˠ æ w æ ŋ k e j
to̧ujin	tˠ æ w i tʲ i nʲ
tubaļu	tˠ i w pˠ æ ɰ lˠ i w
tuean̄	tˠ i w j æ ŋ
tuen̄	tˠ i w j e ŋ
tuiōn̄	tˠ i w j e ŋ
tun̄n̄ūlaļļo̧k	tˠ i ŋʷ ŋʷ i lʲ æ lˠ lˠ æ kʷ
tāeo	tˠ æ j ɛ w
tāākji	tˠ æ j æ k tʲ i j
tōkā	tˠ ɛ k æ j
tōm̧ato	tˠ ɛ mˠ æ ɰ tˠ ɛ w
tūkjinede	tˠ i k tʲ i nʲ ɛ j rʲ ɛ j
tūkōk	tˠ i k e k
tūm̧m̧wilaļļo̧k	tˠ i mˠ mˠ i lʲ æ lˠ lˠ æ kʷ
tūrāikōn	tˠ i rˠ æ j i k ɛ nʲ
u	w i w
uin	w i w i nʲ
ujae	w i tʲ æ ɰ j ɛ j
ujlan̄	w i tʲ lʲ æ ŋ
ujooj	w i tʲ e w e tʲ
uklele	w i kʷ lʲ ɛ j lʲ ɛ j
uklelein	w i kʷ lʲ ɛ j lʲ e j i nʲ
untoba	w i nʲ tˠ ɛ w pˠ æ ɰ
upaaj	w i pʲ æ ɰ æ tʲ
upaajaj	w i pʲ æ ɰ æ tʲ ɰ æ tʲ
ut	w i tˠ
utilomar	w i tˠ j i lʲ ɛ w mʲ æ rˠ
uton̄	w i tˠ ɛ ŋʷ
uto̧r	w i tˠ æ rʷ
uto̧rin	w i tˠ æ rʷ i nʲ
utrooj	w i tˠ rˠ ɛ w ɛ tʲ
utrōk	w i tˠ rˠ e k
utut	w i tˠ w i tˠ
uuk	w i w i k
uwi	w w i j
wa	w æ ɰ
wab	w æ pˠ
wain	w æ ɰ j i nʲ
waj	w æ tʲ
wajwaj	w æ tʲ w æ tʲ
wan̄	w æ ŋ
watre	w æ tˠ rˠ e j
wau	w æ ɰ w i w
wea	w ɛ j æ ɰ
weain	w ɛ j æ ɰ i nʲ
weejej	w e j e tʲ j e tʲ
weejejin	w e j e tʲ j e tʲ i nʲ
weiļ	w e j i lˠ
wiawe	w i j æ ɰ w e j
wio̧we	w i j æ w e j
wōd	w ɛ rʲ
wōil	w e j i lʲ
wōj	w e tʲ
wōja	w ɛ tʲ æ ɰ
wōjjā	w ɛ tʲ tʲ æ j
wōjke	w e tʲ k e j
wōl	w e lʲ
wōn	w e nʲ
wōn	w ɛ nʲ
wōnje	w ɛ nʲ tʲ ɛ j
wōpiem̧	w e pʲ i j e mˠ
wōpij	w ɛ pʲ j i tʲ
wōt	w e tˠ
wōtbai	w ɛ tˠ pˠ æ ɰ j i j
wōtbaiin	w ɛ tˠ pˠ æ ɰ j i j i nʲ
wōteļ	w ɛ tˠ j ɛ lˠ
wōtmiiļ	w ɛ tˠ mʲ i j i lˠ
wōtto	w ɛ tˠ tˠ ɛ w
wōtōmjej	w e tˠ e mʲ tʲ e tʲ
wōtōmjeļo̧k	w e tˠ e mʲ tʲ ɛ lˠ æ kʷ
wūdeakeak	w i rʲ j æ k j æ k
wūdkabbe	w i rʲ k æ pˠ pˠ e j
wūjae	w i tʲ æ ɰ j ɛ j
wūjlan̄	w i tʲ lʲ æ ŋ
wūjooj	w i tʲ e w e tʲ
wūjwūj	w i tʲ w i tʲ
wūlka	w i lʲ k æ ɰ
wūntoba	w i nʲ tˠ ɛ w pˠ æ ɰ
wūntō	w i nʲ tˠ ɛ ɰ
wūpaaj	w i pʲ æ ɰ æ tʲ
wūpaajaj	w i pʲ æ ɰ æ tʲ ɰ æ tʲ
wūt	w i tˠ
wūtwūt	w i tˠ w i tˠ
yok	j e kʷ
yokwe	j i̯ j æ kʷ ɛ j
yokyokwe	j i̯ j æ kʷ j i̯ j æ kʷ ɛ j
yuk	j e kʷ
ādkup	j æ rʲ kʷ i pʲ
ākto	j æ k tˠ e w
āktuwe	j æ k tˠ i w ɛ j
ākūtwe	j æ k i tˠ w ɛ j
āne	j æ nʲ e j
āneeļļapkaņ	j æ nʲ e j e lˠ lˠ æ pʲ k æ nˠ
ānewetak	j æ nʲ e j w ɛ j tˠ æ k
ānewātak	j æ nʲ e j w æ j tˠ æ k
āt	j æ tˠ
ātāt	j æ tˠ j æ tˠ
ļaam̧	lˠ æ ɰ æ mˠ
ļaam̧am̧	lˠ æ ɰ æ mˠ ɰ æ mˠ
ļaim̧	lˠ æ ɰ j i mˠ
ļaim̧in	lˠ æ ɰ j i mˠ i nʲ
ļaiōn	lˠ æ ɰ j i j ɰ ɛ nʲ
ļaiōōn	lˠ æ ɰ j i j ɛ ɰ ɛ nʲ
ļalem	lˠ æ lʲ e mʲ
ļan̄	lˠ æ ŋ
ļan̄e	lˠ æ ŋ e j
ļap	lˠ æ pʲ
ļaņtōn	lˠ æ nˠ tˠ ɛ nʲ
ļokwājek	lˠ ɛ kʷ æ j tʲ ɛ k , lˠ ɛ kʷ æ j tʲ e k
ļon̄	lʷ e ŋʷ
ļon̄	lˠ ɛ ŋʷ
ļoob	lˠ ɛ w ɛ pˠ
ļoobin	lˠ ɛ w ɛ pˠ i nʲ
ļora	lˠ ɛ w rˠ æ ɰ
ļo̧n̄	lʷ æ ŋʷ , lˠ æ ŋʷ
ļuj	lʷ i tʲ
ļwe	lʷ e j
ļwein	lʷ e j i nʲ
ļwūj	lʷ i tʲ
ņadikdik	nˠ æ ɰ rʲ i k rʲ i k
ņaib	nˠ æ ɰ j i pˠ
ņaibin	nˠ æ ɰ j i pˠ i nʲ
ņam̧	nˠ æ mˠ
ņo	nˠ e w
ņo	nˠ ɛ w
ņokwanej	nˠ ɛ kʷ æ nʲ j ɛ tʲ
ņo̧kneej	nˠ æ kʷ nʲ ɛ j ɛ tʲ
ōeōe	ɰ e j ɰ e j
ōne	ɰ e nʲ e j
ōō	ɰ e ɰ e ɰ
ōō	ɰ ɛ ɰ ɛ ɰ
ūlūl	ɰ i lʲ ɰ i lʲ
ūlūlin	ɰ i lʲ ɰ i lʲ i nʲ
