a	a
abortiv	ɑ b ɔ ʁ t iː ʋ
abortiv	ɑ b ɔ ʈ iː ʋ
adel	ɑː d ɛ l
adept	ɑ d ɛ p t
afrikansk	ɑ f r i k ɑː n s k
aftan	ɑ̂ f t ɑ n
agurktid	a ɡ ʉ r k t iː
aksel	² ɑ k s ɛ l
aksent	ɑ k s ɑ ŋ
aktsam	a k t s aː m
alaskar	a l a s k a r
alaskisk	a l a s k i s k
alder	ɑ l d ɛ r
alfabet	a l f a b eː t
alke	² ɑ l k ə
all	ɑ lː
altso	ɑ l t s ɔ
altso	ɑ l t s ʊ
altså	ɑ l t s ɔ
alvorleg	ɑ l ʋ oː r l ɛ
alvorleg	ɑ l ʋ oː r l ɛ ɡ
amerikanar	aː m ə r i k aː n aː r
ananas	ɑ nː ɑ n ɑ s
and	ɑ n d
and	ɑ nː
andlet	² ɑ n l eː t
ane	ɑː n ə
angripa	a n ɡ r iː p a
annan	² ɑ nː ɑ n
anten	a n t ɛ n
antibiotikum	a n t i b i uː t i k ʉ m
apokalypse	a p u k a l y p s ə
argument	ɑ r ɡ ʉ m ɛ n t
arm	ɑ r m
ask	ɑ s k
at	ɑ tː
ateist	ɑ t ə ɪ s t
atomvåpen	aː t uː m ʋ ɒː p ɛ n
attanfor	a t a n f ɔ r
attom	² a tː ʊ m
aud	æ ʉ
auga	² æ ʉ̯ ɡ ɑ
auge	² æ ʉ̯ ɡ ə
augestikkar	ø ʉ ɡ ə s t i k a r
auka	ø ʉ k a
auke	ø u k ə
austover	ø ʉ s t ɔː ʋ ɛ r
av	ɑː ʋ
avgjera	ɑː ʋ j eː r ɑ
avhengig	aː ʋ h e ŋ ɡ i
avhoppar	aː ʋ h ɔ p a r
avis	ɑ ʋ iː s
avisa	ɑ ʋ iː s ɑ
avisene	ɑ ʋ iː s n̩ ə
aviser	ɑ ʋ iː s ə r
avkastning	aː ʋ k a s t n i ŋ ɡ
avl	ɑ ʋ l
avla	a ʋ l a
avstand	aː ʋ s t a n
b	b
b	b eː
bacon	b eː k ə n
bacon	b æ j k ə n
bad	b ɑː d
bakbord	b aː k b uː r
banan	b a n aː n
bank	b ɑ ŋ k
banne	² b a n n e
bannlyse	b a nː ² l yː s e
barn	b ɑː r n
barnehage	b aː r n e h aː ɡ e
bart	b a r t
be	b eː
begge	b ɛ ɡ ə
behageleg	b ə h aː ɡ ə l eː ɡ
behalda	b eː h a l d a
beita	² b æ ɪ t ɑ
beite	b ɛ i t ə
bendelorm	b ɛ n d ə l ɔ r m
benektelse	b e n e k t e l s e
bergmann	b æ r ɡ m ɑ n
bergta	b ɛ r ɡ t a
besøk	b eː s øː k
besøkja	b eː s øː ç a
bety	b eː t y
bever	b eː ʋ ɛ r
biblioteka	b ɪ b l j u t eː k ɑ
bilda	b ɪ l d ɑ
bilde	b ɪ l d ə
bildet	b ɪ l d ə
binær	b i n æː r
blant	b l a n t
blemme	b l e m m e
bli	b l iː
blodskam	b l uː s k a m
blomkål	b l u m k ɒː l
blåmeis	² b l oː m æ ɪ s
bløffe	b l ø f f e
bokstav	b ʊ k s t ɑː ʋ
bokstavleg	b uː k s t aː ʋ l eː ɡ
boms	b u m s
bonde	² b ʊ n d ə
bonde	² b ʊ nː ə
bongotromme	b u n ɡ u t r u m m e
borgarleg	b ɔ r ɡ aː r l eː ɡ
borte	² b ʊ r t ə
bortkasta	b ʊ r t k a s t a
bos	b oː s
breiflabb	b r æ ɪ f l ɑ b
breiflabb	² b r æ ɪ f l ɑ b
brekkjern	b r e k j æː r n
brenna	b r ɛ n a
brennmanet	b r ɛ n m aː n eː t
brev	b r eː ʋ
brok	b r uː k
brokkoli	b r ɔ k ɔː l i
bronse	b r ɔ n s ə
bror	b r uː r
brosme	² b r ɔ s m ə
brotsverk	b r ɔː t s v ɛ r k
bru	b r ʉː
bryllaup	b r y l ø ʉ p
brød	b r øː
brødskive	² b r øː ʃ iː ʋ ə
bu	b ʉː
buddhist	b ʉ d ɪ s t
buddhisten	b ʉ d ɪ s t n̩
bukse	² b ʊ k s ə
burka	b ʉ r k ɑ
by	b yː
byggja	² b ʏ jː ɑ
byggja	² b ʏ ɟ͡ʝː ɑ
byggja	² b ʏ ʝː ɑ
byksa	b ʏ k s ɑ
byksa	² b ʏ k s ɑ
bystat	b yː s t aː t
båe	b ɒ ə
bæsje	b æ ʃː ə
bønn	b œ n
bønner	² b œ n ə r
bøya	² b œ ʏ ɑ
d	d eː
da	d ɑː
daa	d oː
dane	² d ɑː n ə
datamus	d aː t a m ʉː s
dataspel	d aː t a s p eː l
dataspeling	d aː t a s p eː l i ŋ ɡ
definera	d ə f i n eː r a
definisjon	d ə f i n i ʃ uː n
deg	d eː ɡ
dei	d æ ɪ
deig	d ɛ i ɡ
deira	² d æ ɪ r ɑ
dekkja	d ɛ ç a
den	d ɛ nː
deretter	d ɛ r ɛ t ɛ r
dermed	d ɛ r m ə
dess	d ɛ sː
dessutan	d ɛ sː ² ʉː t ɑ n
dessutan	d ɛ sː ʉ t ɑ n
det	d eː
di	d iː
dimed	d iː m e
din	d i n
dine	d iː n ə
diskotek	d i s k u t eː k
ditt	d i t
djerv	d j ɛ r ʋ
djerv	j ɛ r ʋ
do	d oː
dokument	d ʊ k ʉ m ɛ n t
dovendyr	d oː v e n d yː r
drag	d r ɑː ɡ
drikke	² d r ɪ kː ə
drone	d r uː n ə
drosje	d r o ʂ e
dryle	² d r yː l e
du	d ʉː
duga	d ʉː ɡ a
dumming	d u m m i ŋ
dunge	² d ʊ ŋː ə
dvd	d eː ʋ ə d eː
dvergplanet	d ʋ ɛ r ɡ p l aː n eː t
dykk	d y k
dysleksi	d y s l e k s iː
då	d oː
døgn	d ø ɡ n
døyande	d ø y a n d ə
e	e
e	eː
e	æ
e	ə
e	ɛ
edderkopp	e d e r k o p
eg	eː ɡ
egg	e ɡː
egg	ɛ ɡː
eid	æ ɪ d
eika	² æ ɪ k ɑ
eika	æ ɪ k ɑ
ein	æ ɪ n
einannan	ɛ i n a n a n
eineståande	ɛ iː n ə s t ɒ a n d ə
eingong	ɛ i n ɡ ɔ ŋ ɡ
einherje	² e i n h e r j e
einig	² æ ɪ n ɪ
einskap	ɛ i n s k aː p
ekorn	ɛ kː ʊ r n
eksplodera	ɛ k s p l uː d eː r a
ekstrem	ɛ k s t r eː m
ekstremist	ɛ k s t r e m i s t
ekstremt	ɛ k s t r eː m t
ekteskap	² ɛ k t ə s k ɑː p
elbil	ɛ l b iː l
elev	ɛ l eː ʋ
elg	ɛ l ɡ
eliminera	eː l i m i n eː r a
endåtil	² ɛ n d ɔ t ɪ lː
eng	ɛ ŋː
engsteleg	ɛ ŋ ɡ s t ə l eː ɡ
enorm	eː n ɔ r m
enormt	eː n ɔ r m t
eplepai	e p l e p a j
er	eː r
er	æː r
erfaring	ɛ r f aː r i ŋ ɡ
erklæring	e r k l æː r i ŋ
erobra	eː r uː b r a
eta	² eː t ɑ
etterpå	² ɛ tː ɛ r p oː
fa	f ɑː
fable	f ɑː b l ə
fader	² f ɑː d ɛ r
fagidiot	f aː ɡ i d i uː t
faktisk	f a k t i s k
falkeblikk	f a l k ə b l i k
fall	f ɑ lː
fallskjermhopping	f a l ʂ e r m h o p p i ŋ
fan	f æ n
fange	² f ɑ ŋː ə
fanteri	f a n t əː r i
far	f ɑː r
farar	f aː r aː r
faren	f ɑː r n̩
faren	² f ɑː r n̩
farge	² f ɑ r ɡ ə
fasan	f a s aː n
fasinera	f a s iː n eː r a
fasinerande	f a s iː n eː r a n ə
fat	f ɑː t
fata	f ɑː t ɑ
fata	² f ɑː t ɑ
fegge	² f ɛ ɡː ə
feira	f ɛ iː r a
fele	f eː l e
felle	² f ɛ lː ə
femling	f ɛ m l i ŋ ɡ
fennek	f e n n e k
ferdamål	f ɛ r d a m ɒː l
ferie	f eː r j ə
festning	² f ɛ s t n ɪ ŋ
fil	f iː l
filleonkel	f i lː ə u ŋ k ə l
fillerista	f ɪ l ə r i s t a
filletante	f i lː ə t a n t ə
finna	² f ɪ nː ɑ
finnast	² f ɪ nː ɑ s t
firling	f iː r l i ŋ ɡ
fjellrev	² f j ɛ l r eː v
fjerna	f j ɛ r n a
fjernsyn	f j ɛ r n s yː n
fjord	f j uː r
fjorår	f j uː r ɒː r
fjære	f j æː r e
fjøl	f j øː l
fjøs	f j øː s
flagg	f l a ɡ
flaske	² f l a s k ə
flaum	f l æ ʉ m
fleinsopp	f l ɛ i n s ɔ p
fleire	² f l æ ɪ r ɛ
fleirtal	f l æ ɪ r t ɑː l
flekk	f l ɛ kː
fly	f l yː
flyga	² f l yː ɡ ɑ
flykta	f l y k t a
flyktning	f l y k t n i ŋ ɡ
flå	f l oː
flåte	f ɽ oː t ə
flått	f l o t
fløyte	² f l œ ʏ t ə
fokk	f ɔ kː
for	f ɔ rː
forakte	f o r à k t e
forbløffa	f ɔ r b l ø f a
forbløffande	f ɔ r b l ø f a n ə
forelder	f ɔ r ɛ l d ɛ r
forfallen	f ɔ r f ɑ lː n̩
forkasta	f ɔ r k a s t a
formål	f ɔ r m ɒː l
fornøgd	f ɔ r n œ ɡ d
forsiktig	f ɔ r s i k t i ɡ
forsvar	f ɔ r s v aː r
forsvara	f ɔ r s v aː r a
forsøk	f ɔ r s øː k
fort	f u r t
fort	f ɔ r t
fortena	f ɔ r t eː n ɑ
fortid	f ɔ r t iː
forvirra	f ɔ r v i r a
foss	f ɔ sː
framand	f r aː m a n d
framdrift	f r a m d r i f t
framfor	² f r ɑ m f ɔ r
framføre	f r ɑ m f øː r ə
fransk	f r a n s k
franske	f r a n s k ə
fredeleg	f r eː d e l eː ɡ
fredsdue	f r eː d s d ʉ ə
fremja	f r ɛ m j a
fri	f r iː
frykt	f r y k t
frykteleg	f r y k t ə l eː ɡ
frysning	f r ŷː s n i ŋ
fugleinfluensa	f ʉ ɡ l ə i n f l ʉ ə n s a
fundamentalist	f ʉ n d a m ɛ n t a l i s t
furu	² f ʉː r ʉ
fyka	² f yː k ɑ
fylgja	² f ʏ l j ɑ
fyr	f yː r
få	f oː
fårikål	f oː r i k o l
føra	² f øː r ɑ
føre	f øː r ə
førebels	f øː r ə b eː l s
førebu	f øː r eː b ʉː
førelegg	f ø̂ː r e l e ɡ
føremon	² f øː r ə m uː n
føremål	f øː r ə m ɒː l
gamal	² ɡ ɑː m ɑ l
gammal	² ɡ ɑ mː ɑ l
garn	ɡ a r n
garn	ɡ a ʁ n
gasspedal	ɡ a s p eː d aː l
gatekjøken	ɡ aː t e ç øː k e n
gatekjøkken	ɡ aː t e ç ø k e n
gauk	ɡ æ ʉ k
gaule	ɡ æ ʉ l e
gaum	ɡ ø ʉ m
generasjon	ɡ e n eː r a ʃ uː n
gissel	ɡ i s s e l
gisseltakar	ɡ i s ə l t aː k aː r
gje	j eː
gjennomføra	j ɛ n u m f øː r a
gjennomsnittsfart	j e n n u m s n i t s f a r t
gjera	² j eː r ɑ
gjerne	² j ɛ r n ə
gjerningsmann	j e r n i ŋ ɡ s m a n
gjæv	j eː ʋ
gjø	j øː
gjøde	j øː d ə
gjørme	j ø r m ə
glas	ɡ l ɑː s
glasmanet	ɡ l aː s m aː n eː t
glimt	ɡ l ɪ m t
god	ɡ uː
googla	ɡ ʉː ɡ l a
gote	² ɡ oː t ə
gran	ɡ r ɑː n
granmeis	ɡ r aː n m ɛ i s
grateng	ɡ r a t e ŋ
grava	² ɡ r ɑː ʋ ɑ
gravla	ɡ r aː ʋ l aː
gravleggja	ɡ r aː ʋ l ɛ ʝ a
grei	ɡ r æ ɪ
greia	² ɡ r æ ɪ ɑ
greie	² ɡ r æ ɪ ə
grein	ɡ r æ ɪ n
grind	ɡ r ɪ n d
grind	ɡ r ɪ nː
gripa	² ɡ r iː p ɑ
gripe	² ɡ r iː p ə
gro	ɡ r uː
grov	ɡ r oː ʋ
grov	ɡ r uː ʋ
grunn	ɡ r ʉ nː
grunnleggja	² ɡ r ʉ nː l ɛ jː ɑ
grunnleggjande	ɡ r ʉ n l ɛ ʝ a n d ə
grunnlov	ɡ r ʉ n l ɔ ʋ
gruppe	² ɡ r ʉ pː ə
grut	ɡ r ʉː t
gruvedrift	ɡ r ʉː v e d r i f t
gråbein	ɡ r oː b e i n
gråt	ɡ r oː t
gråta	² ɡ r oː t ɑ
grøn	ɡ r øː n
gudskjelov	ɡ ʉ t ʃ ə l ɔː ʋ
gullalder	ɡ ʉ l a l d ɛ r
guvernør	ɡ ʉ ʋ ɛ r n øː r
gyger	j yː ɡ ɛ r
gås	ɡ oː s
gåte	² ɡ oː t ə
hallik	h a l l i k
halvøy	h ɑ l œ j
hamarhai	h aː m a r h a i
hammar	h a m m a r
han	h ɑ nː
hand	h ɑ n d
hand	h ɑ nː
handlevogn	h â n l e v o ɡ n
hann	h a n
hans	h ɑ n s
har	h ɑː r
hard	h ɑː r
hardare	² h ɑː r ɑ r ə
hardast	h ɑː r ɑ s t
hardaste	² h ɑː r ɑ s t ə
harde	² h ɑː r ə
hardt	h ɑ r t
hare	² h ɑː r ə
hatefull	h aː t ə f ʉ l
hav	h ɑː ʋ
heie	h ê i e
heil	h æ ɪ l
heilag	h ɛ i l aː ɡ
heim	h æ ɪ m
heim	h ɛ ɪ m
heimanfrå	h ɛ i m a n f r ɒ
heimebrent	h ɛ i m ə b r ɛ n t
heimland	h ɛ i m l a n
heimsøkja	h ɛ i m s øː ç a
heimsøkt	h ɛ i m s øː k t
heita	² h æ ɪ t ɑ
hekka	h ɛ k a
heller	h ɛ lː ɛ r
heller	² h ɛ lː ɛ r
helst	h ɛ l s t
hemmeleg	h ɛ m ə l eː ɡ
hemn	h ɛ m n
hems	h ɛ m s
hending	h ɛ n d i ŋ ɡ
henne	h ɛ n ə
her	h eː r
her	h æː r
herleg	h ɛː r l eː ɡ
herme	h e r m e
herregud	h ɛ r ə ɡ ʉː d
hes	h eː s
hettitt	h eː t i t
hettittisk	h eː t i t i s k
hevda	² h ɛ ʋ d ɑ
hi	h iː
hidsjab	h iː d ʂ ɑ b
hidsjab	h ɪ d ʂ ɑ b
hijab	h iː d ʂ ɑ b
hijab	h ɪ d ʂ ɑ b
hin	h ɪ nː
hindu	h ɪ n d ʉ
hinduisme	h ɪ n d ʉ ɪ s m ə
hine	² h iː n ə
historikar	h i s t u r i k a r
hitt	h ɪ tː
hjarte	² j ɑ r t ə
hjarte	² j ɑː r t ə
hjelpa	j ɛ l p ɑ
hjelpa	² j ɛ l p ɑ
hjort	j ʊ r t
ho	h uː
hoe	h uː ə
hogga	² h ɔ ɡː ɑ
homofili	h u m u f i l iː
horngjel	h ɔ r n j eː l
hov	h oː ʋ
hov	h uː ʋ
hovuddel	h uː v ʉ d d eː l
hovudinngang	h uː v ʉ d i n ɡ a ŋ
hummar	h ʊ m a r
hund	h ʉ n d
hund	h ʉ nː
hund	h ʊ n d
hund	h ʊ nː
hundemat	h ʉ n n e m aː t
hundrevis	h ʊ n d r ə v iː s
hundreår	² h ʉ n d r ə oː r
hundreår	² h ʊ n d r ə oː r
husfred	h ʉː s f r eː
huttemegtu	h ʉ t əː m eː ɡ t ʉː
huttetu	h ʉ t əː t ʉː
hyggjeleg	h y ʝ e l eː ɡ
hyse	² h yː s ə
håpa	h ɒː p a
hóv	h uː ʋ
høg	h øː ɡ
høgre	h øː ɡ r ə
høgre	h œ ɡ r ə
høgre	² h œ ɡ r ə
høyrast	h ø y r a s t
iallfall	j a f a l
iallfall	j a l f a l
idrett	iː d r ɛ t
ikkje	² ɪ c͡çː ə
ikkje	² ɪ çː ə
image	ɪ m ɪ d ʂ
imperium	i m p eː r i ʉ m
imponera	i m p uː n eː r a
indianar	i n d i aː n aː r
industriland	i n d ʉ s t r iː l a n
ingen	² ɪ ŋː ɛ n
ingenting	² ɪ ŋː ɛ n t ɪ ŋ
inkje	² ɪ n ç ə
inkje	² ɪ ŋ ç ə
innanfor	² ɪ nː ɑ n f ɔ r
innavl	i n a ʋ l
innbrot	i n b r ɔː t
innehalda	i n ə h a l d a
innom	i n u m
innsjå	i n ʃ ɒː
innvandra	i n ʋ a n d r a
innvandrar	i n ʋ a n d r aː r
innvandring	i n ʋ a n d r i ŋ ɡ
innverknad	i n ʋ ɛ r k n a
inspirerande	i n s p i r eː r aː n ə
internasjonal	i n t ɛ r n aː ʃ uː n aː l
intim	i n t iː m
invadera	i n ʋ aː d eː r a
invasjon	i n ʋ a ʃ uː n
invitera	i n ʋ iː t eː r a
is	iː s
isfjell	iː s f j ɛ l
islam	ɪ s l ɑː m
islam	ɪ ʂ l ɑː m
jakt	j a k t
jakta	j a k t a
jaktar	j a k t aː r
jest	j e s t
joletid	j uː l e t i d
joletre	j uː l əː t r e
jord	j uː r
jordbær	j u r b æː r
jordbær	j u ɻ b æː r
jordeple	j uː r æː p l æ
journalist	ʃ u r n a l i s t
jovial	j u v i aː l
juletre	j ʉː l əː t r e
jungel	j ʊ ŋ ɡ ə l
juv	j ʉː ʋ
jøde	j øː d ə
jødedom	j øː d ə d ɔː m
jødisk	j øː d i s k
kabylsk	k ɑ b yː l s k
kaffi	k a f i
kalde	² k ɑ l d ə
kalde	² k ɑ lː ə
kalla	² k ɑ lː ɑ
kameleon	k ɑ m ə l ə uː n
kar	k ɑː r
karboksylsyre	k a r b u k s yː l s yː r e
karsk	k a r s k
katastrofal	k a t a s t r u f aː l
katastrofalt	k a t a s t r u f aː l t
katt	k ɑ tː
kebab	k eː b ɑ b
kebab	k eː b ɑː b
keisam	ç ɛ iː s aː m
keisar	² ç æ ɪ s ɑ r
keisarpingvin	ç ɛ i s aː r p i ŋ ɡ ʋ iː n
keisemd	ç ɛ iː s ɛ m d
keton	k e t uː n
kikert	ç iː k ɛ r t
kikkert	ç i k ɛ r t
kilo	ç iː l u
kime	² ç iː m ə
kiwi	k iː ʋ i
kje	ç eː
kje	ç ə
kjekk	ç ɛ kː
kjeks	ç ɛ k s
kjel	ç eː l
kjele	ç eː l e
kjem	ç eː m
kjem	ç ɛ mː
kjend	ç ɛ n d
kjenna	² ç ɛ nː ɑ
kjepp	ç ɛ p
kjerne	ç ɛ r n ə
kjernefysikk	ç ɛ r n ə f yː s i k
kjå	t ʃ oː
kjå	ç oː
kjå	ʃ oː
kjøken	ç øː k e n
kjønn	ç ø n
kjøt	ç øː t
kjøtmeis	² ç øː t m æ ɪ s
kjøttmeis	² ç ø t m æ ɪ s
klassekamerat	k l a s s e k a m m e r aː t
klauv	k l æ ʉ ʋ
klegg	k l ɛ ɡ
klimaendring	k l iː m a ɛ n d r i ŋ ɡ
klubbe	k l u b b e
knebel	k n eː b e l
knivstikk	k n iː v s t i k
knyttneve	k n y t n eː v ə
kokain	k u k a iː n
kol	k ɔː l
kolsvart	k ɔː l s ʋ a r t
kom	k ɔ mː
konge	² k ɔ ŋː ə
kongeleg	k ɔ ŋ ɡ ə l eː ɡ
konkurranse	k u n k ʉ r a n s ə
konkurrera	k u n k ʉː r eː r a
konsa	k u n s a
konsentrera	k u n s ɛ n t r eː r a
kor	k uː r
kor	k ʊ rː
korthus	k ɔ r t h ʉː s
kosa	k uː s a
koseleg	k uː s ə l eː ɡ
kosmisk	k u s m i s k
krake	k r âː k e
kratt	k r a t
kreft	k r e f t
krevja	² k r ɛ ʋ j ɑ
krige	k r iː ɡ e
krigserklæring	k r iː ɡ s e r k l æː r i ŋ
krigshissar	k r i k s h i s aː r
kringom	² k r ɪ ŋː ʊ m
kro	k r uː
krokodilletåre	k r u k u d i l l e t oː r e
kronhjort	k r uː n j u r t
krotekake	k r uː t ə k ɑː k ə
krydder	k r y d e r
kryptovaluta	k r y p t u v a l ʉ t a
kråke	² k r oː k ə
kråkesølv	k r oː k e s ø lː
ku	k ʉː
kum	k u m
kurdar	k ʉ r d a r
kva	k ʋ ɑː
kval	k ʋ ɑː l
kvantefysikk	k v a n t e f y s i k k
kvar	k ʋ ɑː r
kvarandre	k ʋ ɑ r ² ɑ n d r ə
kvelds	k v e l s
kvi	k ʋ iː
kvik	k v i k
kvila	² k ʋ iː l ɑ
kvinne	² k ʋ ɪ nː ə
kvinnfolk	k ʋ i n f ɔ l k
kviskre	k v i s k r e
kvit	k ʋ iː t
kvitare	k ʋ iː t aː r ə
kvitast	k ʋ iː t a s t
kvitaste	k ʋ iː t a s t ə
kvite	² k ʋ iː t ə
kvithai	² k ʋ iː t h a ɪ
kvitt	k ʋ ɪ tː
kynikar	ç yː n i k aː r
kynisk	ç yː n i s k
kynisme	ç yː n i s m ə
kyr	ç yː r
kyrkje	² ç ʏ r ç ə
laga	² l ɑː ɡ ɑ
lagnad	² l ɑː ɡ n ɑ
land	l ɑ n d
land	l ɑ nː
lande	l â n n e
landsbygd	l a n s b y ɡ d
landsmøte	l a n s m øː t ə
landssvik	l a n s s ʋ iː k
landssvikar	l a n s s ʋ iː k aː r
lang	l ɑ ŋː
latskap	l aː t s k aː p
latterleg	l a t ə r l eː ɡ
laug	l æ ʉ ɡ
lauga	l æ ʉ ɡ ɑ
lauk	l ø ʉ k
laup	l æ ʉ p
laus	l æ ʉ s
le	l eː
ledd	l ɛ dː
leilegheit	l ɛ i l əː ɡ h ɛ i t
leit	l ɛ i t
lemen	² l ɛ mː ə n
lemen	² l ɛ mː ɛ n
lenge	l ɛ ŋ ɡ ə
lerke	² l ɛ r k ə
lesa	² l eː s ɑ
levande	² l eː ʋ ɑ n ə
lita	l iː t ɑ
lita	² l iː t ɑ
litande	l iː t a n d ə
lite	² l iː t ə
liten	l iː t n̩
liten	² l iː t n̩
liter	l iː t ɛ r
livvakt	l iː ʋ ʋ a k t
ljosår	l j uː s oː r
ljuga	j ʉː ɡ a
ljå	j oː
lo	l uː
loden	² l oː d n̩
loden	² l oː ɛ n
log	l oː ɡ
log	l uː ɡ
lova	l oː ʋ ɑ
lova	² l oː ʋ ɑ
luftforsvar	l ʉ f t f ɔ r s ʋ aː r
lunde	² l ʉ n d ə
lundehund	l ʉ n d e h ʉ n
lunn	l ʉ nː
lus	l ʉː s
lut	l ʉː t
lyd	l yː d
lyga	l yː ɡ a
lyge	l yː ɡ ə
lykke	l y k e
lyng	l ʏ ŋː
lyta	² l yː t ɑ
lyte	² l yː t ə
låg	l oː ɡ
låtteleg	l ɒ t ə l eː ɡ
lækje	l eː ç ə
lækje	l æː ç ə
lærepeng	l æː r ə p ɛ ŋ ɡ
lærepenge	l æː r ə p ɛ ŋ ɡ ə
lét	l eː t
lóve	² l uː ʋ ə
løk	l øː k
løysa	² l œ ʏ s ɑ
løytnant	l ø yː t n a n t
mage	² m ɑː ɡ ə
mager	m ɑː ɡ ɛ r
majoritet	m a j uː r iː t eː t
makrell	m ɑ k r ɛ lː
makrell	² m ɑː k r ɛ l
mamma	m a m a
mandolin	m a n d u l iː n
manet	m aː n eː t
mangleta	m a ŋ l eː t a
mann	m ɑ nː
mannfolk	m a n f ɔ l k
mareritt	m âː r e r i t
marknad	m a r k n aː
marsipan	m a r s i p aː n
massasje	m aː s aː ʃ əː
massemord	m a s ə m u r d
mast	m ɑ s t
matematikk	m a t e m a t i k
matpakke	m aː t p a k e
maurtue	m æ ʉ ɾ t ʉː ə
me	m eː
mea	² m eː ɑ
medan	² m eː ɑ n
meg	m eː ɡ
meina	² m æ ɪ n ɑ
meining	m ɛ i n i ŋ
meister	m ɛ i s t ɛ r
men	m ɛ nː
menneskeleg	m ɛ n ə s k l eː ɡ
merkeleg	² m ɛ r k l ɛ
merkeleg	² m ɛ r k l ɛ ɡ
mi	m iː
middagskvil	m i d a ɡ s k v iː l
middagskvild	m i d a ɡ s k v i l
middagskvild	m i d a ɡ s k v i l d
middelalderlitteratur	m i d e l a l d e r l i t e r a t ʉː r
midnattssol	m i d n a t s uː l
militær	m i l i t æː r
miljøvernar	m i l j øː ʋ ɛ r n a r
min	m iː n
min	m ɪ nː
mina	² m iː n ɑ
mindre	m ɪ n d r ə
mindretal	m i n d r ə t aː l
mindreverd	m i n d r ə ʋ ɛ r d
mine	² m iː n ə
minoritet	m i n oː r i t eː t
minst	m ɪ n s t
mitt	m ɪ tː
mjøden	m j øː d n̩
mjølk	m j ø l k
modig	m uː d i
mol	m oː l
mold	m ɔ lː
moll	m ɔ lː
mor	m uː r
morosam	m uː r uː s aː m
mot	m uː t
motgift	m uː t j i f t
motstand	m uː t s t a n
mottakar	m uː t aː k aː r
munn	m ʉ nː
mus	m ʉː s
muse	m ʉ s eː
museum	m ʉ s eː ʉ m
muslim	m ʉː s l iː m
muslimen	m ʉː s l iː m ə n
musling	m ʉ s l i ŋ
musé	m ʉ s eː
mye	² m yː ə
mykje	² m yː ç ə
mykje	² m ʏ çː ə
myr	m yː r
mål	m oː l
målføre	m oː l f øː r e
måltid	m oː l t iː
måndag	m ɔ n d ɑ ɡ
måne	² m oː n ə
månefisk	² m oː n ə f ɪ s k
måtta	² m ɔ tː ɑ
måtte	² m ɔ tː ə
mæla	² m eː l ɑ
mæle	² m eː l ə
mòl	m oː l
møy	m ø j
namnedag	n a m n e d aː ɡ
naturleg	n aː t ʉː r l eː ɡ
naudsynleg	n a ʉː s yː n l eː ɡ
naudsynt	n a ʉː s yː n t
nazisme	n a s i s m ə
nazist	n aː s i s t
nazistisk	n a s i s t i s k
ned	n eː
ned	n eː d
nei	n æ ɪ
nemleg	n ɛ m l eː ɡ
neppe	n ɛ p ə
nettside	n ɛ t s i ə
nettstad	n ɛ t s t aː
nettvett	n e t v e t
nifs	n ɪ f s
no	n uː
nokolunde	n ɔː k uː l ʉ n ə
nordnorsk	n uː r n ɔ ʂ k
nordover	n uː r ɔː ʋ ɛ r
noreg	n oː r ɛ ɡ
norsk	n ɔ r s k
not	n uː t
nubiar	n ʉː b i a r
nubisk	n ʉː b i s k
nummer	n ʉ m ə r
nyheit	n yː h ɛ i t
nykel	² n ʏ kː ə l
nynazist	n yː n aː s i s t
nynne	² n y n n e
nynorsk	n yː n ɔ r s k
nysgjerrigper	n y ʂ æ r i p eː r
nær	n æː r
nærleik	n æː r l ɛ i k
nøkkel	² n œ kː ɛ l
nøre	n øː r ə
nøtt	n œ tː
offentleg	ɔ f ə n t l eː ɡ
offer	ɔ f ɛ r
ofra	ɔ f r a
ofte	² ɔ f t ə
og	oː
ohm	uː m
olbogerom	ô l b o ɡ e r u m
olje	ɔ l j ə
olje	ʊ l j ə
om	uː m
om	ɔ m
om	ʊ m
omgivnad	u m j iː v n aː
omgjevnad	u m j eː v n aː
omn	ɔ m n
omsorgsfull	u m s o r ɡ s f ʉ l
omsyn	u m s yː n
omsynslaus	u m s yː n s l ø u s
onomatopoetikon	u n u m a t u p u eː t i k o n
open	² oː p ɛ n
openberring	ɔː p ɛ n b ɛ r i ŋ ɡ
opp	ɔ pː
opp	ʊ pː
oppdaga	u p d aː ɡ a
oppdrag	ʊ p d r aː ɡ
oppgåve	ʊ p ɡ ɒː ʋ ə
opphav	² ʊ pː h ɑː ʋ
oppsiktsvekkjande	u p s i k t s ʋ ɛ ç a n ə
optikar	u p t i k aː r
or	uː r
ord	uː r
ordbok	² uː r b uː k
ordbok	² uː ɽ b uː k
ordre	ɔ r d r ə
ordstilling	uː r s t i l l i ŋ
ornitolog	u r n i t u l ɔː ɡ
orrfugl	ɔ r f ʉ ɡ l
orrhane	ɔ r h aː n ə
orrhøne	ɔ r h øː n ə
orsaka	ɔː r s aː k a
orsaking	ɔː r s aː k i ŋ ɡ
oslo	u s l u
oslo	u ʃ l u
osp	ɔ s p
oss	ɔ sː
oter	uː t ə r
oter	uː t ɛ r
overdriven	ɔː ʋ ɛ r d r iː ʋ ɛ n
overleva	ɔː ʋ ɛː r l eː v a
overraskande	ɔː ʋ ə r a s k a n ə
overtyda	ɔː ʋ ɛ r t yː a
partnar	p aː r t n a r
peng	p ɛ ŋː
penge	² p ɛ ŋː ə
pepar	p eː p a r
persar	p ɛ r sː a r
person	p æ ʂ ʂ uː n
personleg	p ɛ r s uː n l eː ɡ
pigghå	p i ɡː h ɔ
pilleskrukketroll	p i l l e s k r u k k e t r o l l
pinleg	p iː n l eː ɡ
pizza	p i t s a
plan	p l aː n
plant	p l ɑ n t
plutseleg	p l ʉ t s e l eː ɡ
pol	p uː l
populær	p u p ʉ l æː r
primær	p r i m æː r
psykiater	s yː k i aː t ɛː r
psykiatri	s yː k i a t r i
pult	p ʉ l t
pult	p ʉː l t
purre	² p ʉ rː ə
pus	p ʉː s
påfugl	p ɒː f ʉ ɡ l
påverka	p ɒː v ɛ r k a
påverknad	p ɒː ʋ ɛ r k n a
radikal	r a d i k aː l
radikalar	r a d i k aː l a r
ramn	r ɑ m n
raud	r æ ʉ
raudruss	r ø ʉ r ʉ s
raudspette	² r æ ʉ s p ɛ t ə
rauv	r ø ʉː ʋ
redd	r ɛ dː
redda	r ɛ d a
regnbogeaure	² r ɛ ɡ n b ɔ ɡ ə æ ʉ r ə
rein	r æ ɪ n
reindrift	r e j n d r i f t
reinsdyr	r æ ɪ n s d yː r
reklame	r e k l aː m e
rekning	² r ɛ k n ɪ ŋ
retning	r ɛ t n i ŋ ɡ
rettkomen	r ɛ t k ɔː m e n
rettkommen	r ɛ t k ɔ m e n
revebjølle	r eː v ə b j ø l ə
revehi	r eː v e h iː
revolusjon	r eː ʋ u l ʉː ʃ uː n
rike	² r iː k ə
rime	r iː m e
ro	r uː
romvesen	r u m v eː s e n
ropa	² r u pː a
rorbu	r uː r b ʉː
rot	r uː t
rotte	² r ɔ tː ə
rovdyr	r ɔː ʋ d yː r
rullestol	r ʉ l ə s t uː l
rune	r ʉː n ə
russ	r ʉ s
rute	² r ʉː t ə
rå	r oː
rådgivar	r ɒː d j iː ʋ a r
rådgjevar	r ɒː d j eː ʋ a r
ræv	r æː ʋ
røvar	² r øː ʋ ɑ r
røvarkjøp	r øː ʋ aː r ç øː p
røyk	r œ ʏ k
røyksopp	r ø y k s ɔ p
saka	s ɑː k ɑ
saka	² s ɑː k ɑ
sakna	s aː k n a
sal	s ɑː l
samanlikna	s aː m aː n l i k n a
samarbeida	s a m a r b ɛ i a
samd	s a m d
samfunn	² s ɑ m f ʉ n
sanning	² s ɑ nː ɪ ŋ
sannsyn	s a n s yː n
sannsynleg	s a n s yː n l eː ɡ
satan	s aː t a n
sau	s æ ʉ
seg	s eː ɡ
sein	s æ ɪ n
seksling	s ɛ k s l i ŋ ɡ
seksuell	s ɛ k s ʉ ɛ l
seksuelt	s ɛ k s ʉ ɛ l t
sel	s eː l
selle	s e l l e
sendar	s ɛ n d aː r
separatisme	s ə p a r a t i s m e
separatist	s ə p a r a t i s t
separatistisk	s ə p a r a t i s t i s k
sete	s eː t ə
show	ʂ ɔ u
show	ʂ ɔ ʋ
showa	ʂ ɔ ʋ ɑ
showet	ʂ ɔ ʋ ə
si	s iː
siddis	s i d i s
side	² s iː d ə
sidesyn	s iː d e s yː n
siger	s iː ɡ ɛ r
sikksakk	s i k s a k
sild	s ɪ l d
sild	s ɪ lː
sin	s ɪ nː
sine	² s iː n ə
sirka	s i r k a
sist	s ɪ s t
sitja	² s ɪ t j ɑ
sitja	² s ɪ çː ɑ
sitron	s i t ɾ uː n
sitt	s ɪ tː
sivil	s iː ʋ iː l
sivilisasjon	s i ʋ i l i s aː ʃ uː n
sjarmera	ʃ a r m eː r a
sjevron	ʂ ɛ ʋ r uː n
sjuk	ʃ ʉː k
sjy	ʃ yː
sjå	ʃ oː
sjåar	ʃ ɒː aː r
sjølv	ʃ øː l
sjølv	ʃ œ l ʋ
sjølve	² ʃ œ l ʋ ə
sjølvstende	² ʃ øː l s t ɛ n d ə
sjølvstende	² ʃ œ lː s t ɛ n d ə
sjølvtillit	ʃ ø l ʋ t ɪ l ɪ t
sjørøye	ʃ øː r ø y ə
skaka	² s k ɑː k ɑ
skaldyr	s k aː l d yː r
skalle	² s k ɑ lː ə
skapning	s k aː p n i ŋ
skatt	s k a t
skatteflyktning	s k a t ə f l y k t n i ŋ ɡ
skaut	s k æ ʉ t
skeise	² ʃ æ ɪ s ə
skikkeleg	ʃ i k e l eː ɡ
skilnad	ʃ ɪ l n aː
skilt	ʃ i l t
skilta	ʃ i l t a
skilting	ʃ i l t i ŋ ɡ
skjegg	ʂ e ɡ
skjer	ʃ eː r
skjera	² ʃ eː r ɑ
skjera	ʃ eː r ɑ
skjerm	ʃ ɛ r m
skjule	² ʃ uː ɽ ə
skjule	² ʃ ʉː l ə
skjør	ʂ øː r
sko	s k uː
skotår	s k ɔː t oː r
skrella	s k r ɛ l a
skremma	s k r ɛ m a
skremmande	s k r ɛ m a n d ə
skrå	s k r oː
skvadron	s k ʋ a d r uː n
skvåsj	s k ʋ ɔ ʂ
sky	ʃ yː
skyss	ʂ y s
skyttargrav	ʃ y t a r ɡ r aː v
skøyr	ʃ ø y r
skøyte	ʂ ø j t e
slagmark	² s l ɑː ɡ m ɑ r k
slektning	s l ɛ k t n i ŋ ɡ
slik	s l iː k
slutt	s l ʉ tː
slutta	² s l ʉ tː ɑ
slåstkamp	s l o s t k a m p
sløg	s l øː ɡ
små	s m oː
snart	s n ɑː r t
snikmordar	s n iː k m u r d a r
snø	s n øː
so	s uː
sofagris	s uː f a ɡ r iː s
soge	² s oː ɡ ə
sol	s uː l
sol	s ɔː l
solbrend	s uː l b r ɛ n d
solbrent	s uː l b r ɛ n t
solbær	s uː l b æː r
sole	s k uː l ə
solrenning	s uː l r ɛ n i ŋ ɡ
solsikke	s uː l s i k ə
som	s ɔ mː
som	s ʊ mː
sommar	² s ɔ mː ɑ r
sovjetar	s ɔ ʋ j ɛ t a r
spanjol	s p a n j uː l
spekk	s p ɛ k
spela	² s p eː l ɑ
speleliste	s p êː l ə l i s t ə
spettmeis	s p ɛ t m ɛ i s
spreia	s p r ɛ i a
språkforsking	s p r oː k f o ʂ k i ŋ
spyfluge	s p yː f l ɔː ɡ a
spøk	s p øː k
spøkja	s p øː ç a
squash	s k ʋ ɔ ʂ
stabbur	s t â b b ʉ r
stad	s t ɑː
stand	s t ɑ n d
stand	s t ɑ nː
steinbit	s t æ j n b iː t
steinsopp	s t ɛ i n s ɔ p
steinsprang	s t ɛ i n s p r a ŋ ɡ
stemne	² s t ɛ m n ə
stengje	² s t ɛ ŋ j ə
stikkontakt	s t i k k u n t a k t
stillongs	s t iː l l o ŋ s
stor	s t uː r
storleik	s t uː r l ɛ iː k
strandflate	s t r a n f l aː t e
strid	s t r iː
strid	s t r iː d
student	s t ʉː d ɛ n t
studera	s t ʉː d eː r a
stut	s t ʉː t
stutt	s t ʉ t
stykke	² s t ʏ kː ə
stå	s t oː
stålorm	² s t oː l ɔ r m
støvel	s t ø v e l
sumar	² s ʊ mː ɑ r
svalbardrein	s v aː l b aː r d r æ j n
svale	² s ʋ ɑː l ə
sveiv	s ʋ æ i̯ ʋ
sverdfisk	² s ʋ ɛ r d f ɪ s k
svik	s ʋ iː k
svika	s ʋ iː k a
svikar	s ʋ iː k a r
svikt	s ʋ i k t
svikta	s ʋ i k t a
svineinfluensa	s ʋ iː n ə i n f l ʉ ə n s a
svolt	s ʋ ɔ l t
svolten	s ʋ ɔ l t n̩
svolten	² s ʋ ɔ l t n̩
sykkel	s y k e l
syklus	s yː k l ʉ s
sylv	s ʏ l
sysken	s ʏ s k ɛ n
syster	s ʏ s t ɛ r
sånn	s ɒ n
sølv	s ø l
søring	s øː r i ŋ ɡ
sørover	s øː r ɔː ʋ ɛ r
søsken	s ø s k ɛ n
søt	s øː t
søtleik	s øː t l e i k
søvn	s ø v n
søye	s ø yː ə
t	t
t	t eː
t	ʈ
ta	t ɑː
takksam	t a k s aː m
talskvinne	t aː l s k ʋ i n ə
talsmann	t aː l s m a n
talsperson	t aː l s p ɛ r s uː n
tank	t a n k
tanke	² t ɑ ŋ k ə
tannkost	t a n k u s t
te	t eː
teleportere	t e l e p u r t eː r e
tenest	² t eː n ɛ s t
terrorangrep	t ɛ r u r a n ɡ r eː p
terroråtak	t ɛ r u r ɒː t aː k
ti	t iː
til	t ɪ lː
tilbake	t ɪ l b ɑː k ə
tilbod	² t ɪ l b oː
tilbod	² t ɪ l b oː d
tilfelle	t ɪ l f ɛ l ə
tilsetja	t ɪ l s ɛ ç a
tilsett	t ɪ l s ɛ t
tilsette	t ɪ l s ɛ t ə
time	² t iː m ə
timeglas	t iː m ə ɡ l aː s
ting	t ɪ ŋː
tispe	t i s p e
tjukk	ç ʊ kː
tjukn	c ç ʊ k n
tjukn	ç ʊ k n
to	t uː
tom	t ʊ mː
tore	² t oː r ə
tore	² t uː r ə
tosk	t o s k
tradisjon	t r a d i ʃ uː n
trena	t r eː n a
trenar	t r eː n aː r
trenga	² t r ɛ ŋ a
trengast	t r ɛ n ɡ a s t
trillebår	t r i l l e b oː r
trilling	t r i l i ŋ ɡ
trivast	t r iː v a s t
troll	t r ɔ lː
trolldom	² t r ɔ l d ɔ m
trolldom	² t r ɔ l d ʊ m
trollkvinne	t r ɔ l k ʋ i n ə
trollmann	t r ɔ l m a n
trost	t r ɔ s t
tru	t r ʉː
trufast	² t r ʉː f ɑ s t
trugande	² t r ʉː ɡ ɑ n d ə
trugande	² t r ʉː ɡ ɑ n ə
tryggleik	t r y ɡ l ɛ iː k
trøye	² t r œ ʏ ə
tsjetsjenar	t ʃ ə t ʃ eː n aː r
tsjetsjensk	t ʃ ə t ʃ eː n s k
tue	² t ʉː ə
tung	t ʊ ŋː
tunge	² t ʊ ŋː ə
tungtvatn	t u n k t ʋ a t n
tungvatn	t u ŋ ɡ ʋ a t n
tusen	t ʉː s n̩
tusenfryd	t ʉː s ɛ n f r yː d
tv	t eː ʋ eː
tyda	t yː d a
tydelegvis	t yː d ə l eː ɡ ʋ iː s
tyding	t yː d i ŋ ɡ
tyggja	t ʏ jː ɑ
tyggja	t ʏ ʝ ɑ
tylft	t ʏ l f t
tyngdekraft	t y ŋ ɡ d ə k r a f t
tyrann	t y r a n
tåg	tʰ oː ɡ
tåre	² t oː r ə
tørsta	² t œ r s t ɑ
uansett	ʉ ɑ n s ɛ tː
ubehageleg	ʉː b ə h aː ɡ ə l eː ɡ
udyr	ʉː d yː r
ueinig	ʉː ɛ i n i
uer	ʉː r
uer	ʉː ɛ r
ufo	ʉː f u
ufoen	ʉː f u n
under	ʉ n d ə r
underhalding	ʊ n d ɛ r h a l i ŋ ɡ
undersøkja	ʉ n d ɛ r s øː ç a
ung	ʊ ŋː
ungkar	u ŋ k aː r
usamd	ʉː s a m d
usemje	ʉː s ɛ m j ə
uskuldig	ʉː s k ʉ l d i ɡ
uskyldig	ʉː ʃ y l d i ɡ
utanfrå	ʉː t a n f r ɒ
utanom	² ʉː t ɑ n ʊ m
utbrot	ʉː t b r ɔː t
utfor	² ʉ t f ɔ r
utfor	² ʉː t f ɔ r
utfordra	ʉː t f ɔ r d r a
utfordrande	ʉː t f ɔ r d r a n ə
utfordrar	ʉː t f ɔ r d r a r
utfordring	ʉː t f ɔ r d r i ŋ ɡ
utforska	ʉː t f ɔ r s k a
utnytta	ʉː t n y t a
utru	ʉː t r ʉː
utsetja	ʉː t s ɛ ç a
utslett	ʉː t s l ɛ t
utsletta	ʉː t s l ɛ t a
uttaleordbok	² ʉː t t ɑː l ə uː r b uː k
uttaleordbok	² ʉː t t ɑː l ə uː ɽ b uː k
utval	ʉː t ʋ aː l
utvandrar	ʉː t ʋ a n d r aː r
utvandring	ʉː t ʋ a n d r i ŋ ɡ
utvikla	ʉː t ʋ i k l a
utviklar	ʉː t ʋ i k l a r
utvikling	ʉː t ʋ i k l i ŋ ɡ
uunngåeleg	ʉ ʉ n ɡ ɒ ə l eː ɡ
uventa	ʉː v ɛ n t a
uvitskapeleg	ʉː ʋ iː t s k a p ə l eː ɡ
uvitskapleg	ʉː ʋ iː t s k a p l eː ɡ
vaksen	² ʋ ɑ k s n̩
valdtekt	ʋ a l t ɛ k t
valkamp	v aː l k a m p
valkyrje	² v aː l k y r j e
vanedyr	v aː n e ² d yː r
vanlegvis	ʋ aː n l eː ɡ ʋ iː s
vanta	² ʋ ɑ n t ɑ
vantru	ʋ a n t r ʉ
var	ʋ ɑː r
varsam	ʋ aː r s aː m
varsel	ʋ ɑ r s ɛ l
vart	ʋ ɑ r t
vart	ʋ ɑː r t
vas	ʋ aː s
vaskebjørn	v a s k e b j øː r n
vassavkjølt	v a s a v ç øː l t
vassblemme	v a s b l e m m e
vassdrag	v a s d r aː ɡ
vassmelon	v a s m e l uː n
vatn	ʋ ɑ t n̩
ved	ʋ eː
vedda	v ɛ d a
veg	ʋ eː ɡ
vega	² ʋ eː ɡ ɑ
vegetarianar	ʋ eː ɡ eː t aː r i aː n aː r
vegetasjon	ʋ eː ɡ eː t aː ʃ uː n
veida	² ʋ æ ɪ d ɑ
veida	² ʋ æ ɪ ɑ
vekkja	² ʋ ɛ çː ɑ
vekt	ʋ ɛ k t
velkomen	ʋ ɛ l k ɔː m ə n
velståande	ʋ ɛ l s t ɒː a n ə
venleg	v eː n l eː ɡ
vennleg	v ɛ n l eː ɡ
vera	² ʋ eː r ɑ
vera	² ʋ æː r ɑ
verkeleg	² v ɛ r k l ɛ
verkeleg	² v ɛ r k ə l ɛ ɡ
vern	ʋ ɛ r n
verna	ʋ ɛ r n a
vernar	ʋ ɛ r n a r
verneplikt	ʋ ɛ r n ə p l i k t
vesle	² ʋ ɛ s l ə
vestover	ʋ ɛ s t ɔː ʋ ɛ r
vetta	² ʋ ɛ tː ɑ
vetta	ʋ ɛ tː ɑ
vi	ʋ iː
vil	ʋ ɪ l
vill	ʋ ɪ lː
vin	ʋ iː n
vindauga	² ʋ ɪ n d æ ʉ ɡ ɑ
vindauge	² ʋ ɪ n d æ ʉ ɡ ə
visepresident	ʋ iː s ə p r ɛ s i d ɛ n t
visjon	ʋ i ʃ uː n
viskelêr	v i s k e l eː r
vitja	ʋ i ç a
vitskap	ʋ ɪː t s k aː p
vitskapeleg	ʋ iː t s k a p ə l eː ɡ
vitskapleg	ʋ iː t s k a p l eː ɡ
von	f ɔ nː
von	ʋ uː n
vor	ʋ oː r
vore	² ʋ oː r ə
vå	ʋ oː
våg	ʋ oː ɡ
våpenkvile	ʋ ɒː p ɛ n k ʋ iː l ə
vår	ʋ oː r
vårteikn	ʋ ɒː r t ɛ i k n
våt	ʋ oː t
væpna	ʋ æː p n a
væte	² v eː t e
væte	² v æː t e
vêrfast	v eː r f a s t
vòr	ʋ oː r
yr	yː r
åbot	ôː b uː t
åbry	ôː b ɾ yː
åk	oː k
ånd	ɔ n d
åndeleg	² ɔ n d ə l ɛ
åndeleg	² ɔ n d ə l ɛ ɡ
år	oː r
årevis	² oː r ə ʋ iː s
årsak	ɔː r s aː k
åsyn	oː s yː n
åt	oː t
åtgaum	ɒː t ɡ ø ʉ m
åtvara	ɒː t ʋ aː r a
æresdrap	æː r ə s d r aː p
ærleg	æː r l e ɡ
æsj	ʔ æ ʂ
øksla	ø k s l a
øl	øː l
øl	œ l
ør	øː r
ørkenrev	ø r k e n r eː v
øvre	² œ ʋ r ə
øydar	ø y d aː r
øydelegging	ø y d ə l ɛ ɡ i ŋ ɡ
øyresus	ø y r e s ʉ s
