ali	a l i
amerika	a m ɛ́ː r i k a
ameriški	a m ɛ́ː r i ʃ k i
amper	a m p ɛ́ː r
andrej	a n d r ɛ̀ː j
arterija	a r t ɛ̀ː r i j a
b	b ə́
bedro	b ɛ̀ː d r ɔ
belejši	b ɛ l ɛ́ː j ʃ i
bezeg	b ə z ə́ k
bezeg	b ə̀ z ə k
blesti	b l ɛ̀ː s t i
bober	b ɔ̀ː b ə r
bogat	b ɔ̀ː ɡ a t
bogatejši	b ɔ ɡ a t ɛ́ː j ʃ i
bolha	b ɔ̀ː ʋ x a
bolj	b ɔ́ l
bor	b ɔ́ r
bos	b ɔ́ s
bosti	b ɔ̀ː s t i
božič	b ɔ̀ː ʒ i t͡ʃ
brca	b ə́ r t͡s a
brcniti	b ə̀ r t͡s n i t i
brdo	b ə̀ r d ɔ
brest	b r ɛ́ s t
bresti	b r ɛ̀ː s t i
brez	b r ɛ s
brki	b ə́ r k i
brlog	b ə r l ɔ́ k
brom	b r ɔ́ m
bron	b r ɔ́ n
brskati	b ə r s k a t i
brv	b ə́ r ʋ
celota	t͡s ɛ l ɔ̀ː t a
cerij	t͡s ɛ̀ː r i j
cesar	t͡s ɛ̀ː s a r
cvek	t͡s ʋ ɛ́ k
cvesti	t͡s ʋ ə̀ s t i
cvesti	t͡s ʋ ɛ̀ː s t i
cvrček	t͡s ʋ ə́ r t͡ʃ ə k
debel	d ɛ̀ː b ɛ ʋ
debelejši	d ɛ b ɛ l ɛ́ː j ʃ i
deber	d ə b ə́ r
deblo	d ɛ̀ː b l ɔ
december	d ɛ t͡s ɛ̀ː m b ə r
ded	d ɛ́ t
dekle	d ɛ k l ɛ́
deska	d ə̀ s k a
dež	d ə́ ʃ
dežela	d ɛ ʒ ɛ̀ː l a
dirigent	d i r i ɡ ɛ́ n t
dno	d n ɔ́
do	d ɔ
doba	d ɔ̀ː b a
dobro	d ɔ̀ː b r ɔ
dobrodošel	d ɔ b r ɔ d ɔ̀ː ʃ ə ʋ
dogovor	d ɔ ɡ ɔ́ː ʋ ɔ r
dojenček	d ɔ j ɛ̀ː n t͡ʃ ə k
dokler	d ɔ k l ɛ́ r
dokler	d ɔ́ k l ɛ r
dol	d ɔ̀ː l
dol	d ɔ́ː ʋ
dolg	d ɔ́ː ʋ k
dolgovaloven	d ɔ ʋ ɡ ɔ ʋ a l ɔ́ː ʋ ə n
domov	d ɔ m ɔ̀ː ʋ
domov	d ɔ m ɔ́ː ʋ
dopoldan	d ɔ p ɔ́ː ʋ d a n
dovolj	d ɔ ʋ ɔ́ l
dovoljenje	d ɔ ʋ ɔ l j ɛ̀ː n j ɛ
dovršen	d ɔ ʋ ə́ r ʃ ə n
drek	d r ɛ́ k
dren	d r ɛ́ n
drka	d ə́ r k a
drkaj	d ə́ r k a j
drkajmo	d ə́ r k a j m ɔ
drkajo	d ə́ r k a j ɔ
drkajta	d ə́ r k a j t a
drkajte	d ə́ r k a j t ɛ
drkajva	d ə́ r k a j ʋ a
drkam	d ə́ r k a m
drkamo	d ə́ r k a m ɔ
drkanje	d ə́ r k a n j ɛ
drkata	d ə́ r k a t a
drkate	d ə́ r k a t ɛ
drkati	d ə́ r k a t i
drkava	d ə́ r k a ʋ a
drkaš	d ə́ r k a ʃ
droben	d r ɔ̀ː b ə n
drugoten	d r u ɡ ɔ̀ː t ə n
drva	d ə̀ r ʋ a
dvom	d ʋ ɔ́ m
eden	ɛ̀ː d ə n
en	ɛ́ n
ena	ɛ̀ː n a
enkrat	ɛ̀ː n k r a t
enota	ɛ n ɔ̀ː t a
epicenter	ɛ p i t͡s ɛ̀ː n t ə r
epicenter	ɛ p i t͡s ɛ́ː n t ə r
erbij	ɛ̀ː r b i j
erik	ɛ́ː r i k
eritreja	ɛ r i t r ɛ́ː j a
esej	ɛ s ɛ́ː j
eto	ɛ́ t ɔ
evo	ɛ́ ʋ ɔ
fermij	f ɛ̀ː r m i j
fižol	f i ʒ ɔ́ ʋ
geslo	ɡ ɛ̀ː s l ɔ
glasnejši	ɡ l a s n ɛ́ː j ʃ i
glasoslovje	ɡ l a s ɔ s l ɔ́ː ʋ j ɛ
globok	ɡ l ɔ b ɔ́ k
glog	ɡ l ɔ́ k
gnesti	ɡ n ɛ̀ː s t i
gol	ɡ ɔ́ ʋ
gol	ɡ ɔ́ː ʋ
golt	ɡ ɔ́ː ʋ t
gonoreja	ɡ ɔ n ɔ r ɛ́ː j a
gor	ɡ ɔ̀ː r
gora	ɡ ɔ̀ː r a
gost	ɡ ɔ́ s t
govno	ɡ ɔ̀ː ʋ n ɔ
govor	ɡ ɔ́ː ʋ ɔ r
gozd	ɡ ɔ́ s t
grb	ɡ ə́ r p
grba	ɡ ə̀ r b a
grd	ɡ ə́ r t
grebsti	ɡ r ɛ̀ː p s t i
grenek	ɡ r ɛ̀ː n ə k
grji	ɡ ə́ r j i
grk	ɡ ə́ r k
grkinja	ɡ ə́ r k i n j a
grlica	ɡ ə̀ r l i t͡s a
grlo	ɡ ə̀ r l ɔ
grm	ɡ ə́ r m
grob	ɡ r ɔ́ p
grof	ɡ r ɔ́ f
grom	ɡ r ɔ́ m
grča	ɡ ə̀ r t͡ʃ a
grčija	ɡ ə́ r t͡ʃ i j a
grši	ɡ ə́ r ʃ i
grški	ɡ ə́ r ʃ k i
grško	ɡ ə́ r ʃ k ɔ
grščina	ɡ ə́ r ʃ t͡ʃ i n a
gvineja	ɡ ʋ i n ɛ́ː j a
hitreje	x i t r ɛ̀ː j ɛ
hitrejše	x i t r ɛ̀ː j ʃ ɛ
hleb	x l ɛ́ p
hmelj	x m ɛ́ l
horvat	x ɔ́ː r ʋ a t
hrbet	x ə r b ə́ t
hrbet	x ə̀ r b ə t
hren	x r ɛ́ n
hropsti	x r ɔ̀ː p s t i
hrošč	x r ɔ́ ʃ t͡ʃ
hrček	x ə́ r t͡ʃ ə k
in	i n
iterbij	i t ɛ̀ː r b i j
iz	i s
izmena	i z m ɛ́ː n a
izmolsti	i z m ɔ̀ː ʋ s t i
janšizem	j a n ʃ i z ɛ m
jasnejši	j a s n ɛ́ː j ʃ i
je	j ɛ́
jebati	j ɛ́ː b a t i
jeklo	j ɛ̀ː k l ɔ
jelen	j ɛ̀ː l ɛ n
jesen	j ɛ̀ː s ɛ n
jezik	j ɛ̀ː z i k
jezikoslovec	j ɛ z i k ɔ s l ɔ́ː ʋ ə t͡s
jezikoslovje	j ɛ z i k ɔ s l ɔ́ː ʋ j ɛ
ječmen	j ɛ̀ː t͡ʃ m ɛ n
južnoameriški	j u ʒ n ɔ a m ɛ́ː r i ʃ k i
kakovost	k a k ɔ̀ː ʋ ɔ s t
kdor	ɡ d ɔ́ r
ker	k ɛ r
kern	k ɛ́ː r n
ki	k i
klepec	k l ɛ̀ː p ə t͡s
klop	k l ɔ́ p
klovn	k l ɔ̀ː ʋ n
klošč	k l ɔ́ ʃ t͡ʃ
kmet	k m ɛ́ t
ko	k ɔ
kola	k ɔ̀ː l a
konec	k ɔ̀ː n ə t͡s
konj	k ɔ́ n
kontinent	k ɔ n t i n ɛ́ n t
končen	k ɔ̀ː n t͡ʃ ə n
končno	k ɔ̀ː n t͡ʃ n ɔ
koper	k ɔ̀ː p ə r
kopno	k ɔ̀ː p n ɔ
kopno	k ɔ́ː p n ɔ
koreja	k ɔ r ɛ́ː j a
korenje	k ɔ r ɛ̀ː n j ɛ
kostanj	k ɔ̀ː s t a n
kot	k ɔ t
kovnica	k ɔ́ː ʋ n i t͡s a
koza	k ɔ̀ː z a
kozel	k ɔ̀ː z ə ʋ
koš	k ɔ́ ʃ
kratkovaloven	k r a t k ɔ ʋ a l ɔ́ː ʋ ə n
krma	k ə̀ r m a
krog	k r ɔ k
krom	k r ɔ́ m
krst	k ə́ r s t
krsta	k ə̀ r s t a
krt	k ə́ r t
krzno	k ə́ r z n ɔ
krč	k ə̀ r t͡ʃ
krč	k ə́ r t͡ʃ
le	l ɛ́
lemež	l ɛ̀ː m ɛ ʃ
len	l ɛ́ n
lepota	l ɛ p ɔ̀ː t a
let	l ɛ́ t
lev	l ɛ́ ʋ
levinja	l ɛ̀ː ʋ i n j a
levinja	l ɛ́ː ʋ i n j a
liberija	l i b ɛ̀ː r i j a
ljubeč	l j u b ɛ́ t͡ʃ
lom	l ɔ́ m
lonec	l ɔ̀ː n ə t͡s
lopov	l ɔ́ː p ɔ ʋ
lovec	l ɔ̀ː ʋ ə t͡s
lovka	l ɔ́ː ʋ k a
m	ɛ m
macesen	m a t͡s ɛ̀ː s ə n
maklen	m a k l ɛ́ n
matej	m a t ɛ́ː j
med	m ɛ t
medved	m ɛ̀ː d ʋ ɛ t
megla	m ə̀ ɡ l a
mehek	m ɛ̀ː x ə k
meja	m ɛ̀ː j a
mesti	m ɛ̀ː s t i
met	m ɛ́ t
metla	m ɛ̀ː t l a
mezeg	m ə z ə́ k
mezeg	m ə̀ z ə k
meč	m ɛ́ t͡ʃ
modrejši	m ɔ d r ɛ́ː j ʃ i
mohar	m ɔ̀ː x a r
molsti	m ɔ̀ː ʋ s t i
morski	m ɔ̀ː r s k i
moči	m ɔ̀ː t͡ʃ i
mošeja	m ɔ ʃ ɛ́ː j a
moški	m ɔ̀ː ʃ k i
mošt	m ɔ́ ʃ t
mrkev	m ə̀ r k ə ʋ
mrkva	m ə̀ r k ʋ a
mrtev	m ə̀ r t ə ʋ
muzej	m u z ɛ́ː j
na	n a
nad	n a t
naenkrat	n a ɛ̀ː n k r a t
nasmeh	n a s m ɛ́ x
načelo	n a t͡ʃ ɛ̀ː l ɔ
načrt	n a t͡ʃ ə́ r t
ne	n ɛ
ne	n ɛ́
nedovršen	n ɛ́ d ɔ ʋ ə́ r ʃ ə n
nesti	n ɛ̀ː s t i
nihče	n i x t͡ʃ ɛ́
njegov	n j ɛ ɡ ɔ̀ː ʋ
njegov	n j ɛ ɡ ɔ́ ʋ
nlp	n ə l ə p ə́
noga	n ɔ̀ː ɡ a
nogomet	n ɔ ɡ ɔ m ɛ́ t
noj	n ɔ́ j
nor	n ɔ́ r
nov	n ɔ́ ʋ
november	n ɔ ʋ ɛ̀ː m b ə r
nož	n ɔ́ ʃ
o	ɔ
obed	ɔ b ɛ́ t
objem	ɔ b j ɛ́ m
oblikosloven	ɔ b l i k ɔ s l ɔ́ː ʋ ə n
oblikoslovje	ɔ b l i k ɔ s l ɔ́ː ʋ j ɛ
obrv	ɔ b ə́ r ʋ
od	ɔ t
odeja	ɔ d ɛ́ː j a
odgovor	ɔ d ɡ ɔ́ː ʋ ɔ r
odnos	ɔ d n ɔ́ s
odprt	ɔ t p ə́ r t
ogenj	ɔ̀ː ɡ ə n
okno	ɔ̀ː k n ɔ
on	ɔ́ n
ona	ɔ̀ː n a
one	ɔ̀ː n ɛ
oni	ɔ̀ː n i
ono	ɔ̀ː n ɔ
oreh	ɔ̀ː r ɛ x
orel	ɔ̀ː r ə ʋ
orhideja	ɔ r x i d ɛ́ː j a
osa	ɔ̀ː s a
osel	ɔ̀ː s ə ʋ
osnoven	ɔ s n ɔ́ː ʋ ə n
osnovnejši	ɔ s n ɔ́ː ʋ n ɛ j ʃ i
otok	ɔ̀ː t ɔ k
otrok	ɔ t r ɔ́ k
otroče	ɔ t r ɔ t͡ʃ ɛ́
otrpniti	ɔ t ə̀ r p n i t i
ovca	ɔ̀ː ʋ t͡s a
oven	ɔ̀ː ʋ ə n
oves	ɔ̀ː ʋ ə s
oče	ɔ̀ː t͡ʃ ɛ
pa	p a
pekel	p ə k ə́ ʋ
pekel	p ə̀ k ə ʋ
perverzija	p ɛ r ʋ ɛ̀ː r z i j a
pes	p ə́ s
peta	p ɛ̀ː t a
petelin	p ɛ t ɛ̀ː l i n
peti	p ɛ̀ː t i
peči	p ɛ̀ː t͡ʃ i
plesti	p l ɛ̀ː s t i
po	p ɔ
pod	p ɔ́ t
podel	p ɔ̀ː d ə ʋ
podkev	p ɔ̀ː t k ə ʋ
podla	p ɔ̀ː d l a
podlejši	p ɔ̀ː d l ɛ j ʃ i
pogoj	p ɔ ɡ ɔ́ j
pogoltniti	p ɔ ɡ ɔ̀ː ʋ t n i t i
pogovor	p ɔ ɡ ɔ́ː ʋ ɔ r
pogovoren	p ɔ ɡ ɔ́ː ʋ ɔ r ə n
pokol	p ɔ k ɔ́ l
pokop	p ɔ k ɔ́ p
pokrov	p ɔ k r ɔ́ ʋ
poldan	p ɔ́ː ʋ d a n
polh	p ɔ̀ː ʋ x
polh	p ɔ́ː ʋ x
polkovnica	p ɔ l k ɔ́ː ʋ n i t͡s a
poln	p ɔ́ː ʋ n
polnejši	p ɔ̀ː ʋ n ɛ j ʃ i
polnoč	p ɔ́ː ʋ n ɔ t͡ʃ
polotok	p ɔ l ɔ t ɔ́ k
polž	p ɔ̀ː ʋ ʃ
polž	p ɔ́ː ʋ ʃ
pomen	p ɔ m ɛ́ n
pomenoslovje	p ɔ m ɛ n ɔ s l ɔ́ː ʋ j ɛ
ponos	p ɔ n ɔ́ s
poper	p ɔ̀ː p ə r
popoldan	p ɔ p ɔ́ː ʋ d a n
popolnoma	p ɔ p ɔ́ː ʋ n ɔ m a
por	p ɔ́ r
porod	p ɔ r ɔ́ t
porod	p ɔ̀ː r ɔ t
poročen	p ɔ r ɔ t͡ʃ ɛ́ n
posel	p ɔ̀ː s ə ʋ
posodobiti	p ɔ s ɔ d ɔ̀ː b i t i
posodobiti	p ɔ s ɔ d ɔ́ː b i t i
post	p ɔ́ s t
postrv	p ɔ s t ə́ r ʋ
potem	p ɔ t ɛ́ m
potok	p ɔ̀ː t ɔ k
potres	p ɔ t r ɛ́ s
pozen	p ɔ̀ː z ə n
pozno	p ɔ̀ː z n ɔ
počasneje	p ɔ t͡ʃ a s n ɛ́ː j ɛ
prase	p r a s ɛ́
pred	p r ɛ t
predlog	p r ɛ̀ː d l ɔ k
predmet	p r ɛ̀ː d m ɛ t
predpreteklik	p r ɛ́ t p r ɛ t ɛ̀ː k l i k
preja	p r ɛ̀ː j a
preja	p r ɛ́ː j a
presti	p r ɛ̀ː s t i
prestol	p r ɛ̀ː s t ɔ l
preteklik	p r ɛ t ɛ̀ː k l i k
prevesti	p r ɛ ʋ ɛ̀ː s t i
prevod	p r ɛ ʋ ɔ́ t
prevod	p r ɛ̀ː ʋ ɔ t
prga	p ə̀ r ɡ a
prha	p ə̀ r x a
pri	p r i
prislov	p r i s l ɔ́ ʋ
prisotnost	p r i s ɔ̀ː t n ɔ s t
prost	p r ɔ́ s t
prostor	p r ɔ̀ː s t ɔ r
prst	p ə́ r s t
prstan	p ə̀ r s t a n
prstanec	p ə̀ r s t a n ə t͡s
prt	p ə́ r t
prvi	p ə́ r ʋ i
prvoten	p ə r ʋ ɔ̀ː t ə n
pustejši	p u s t ɛ́ː j ʃ i
ramovš	r a m ɔ́ː ʋ ʃ
razgovor	r a z ɡ ɔ́ː ʋ ɔ r
razpelo	r a s p ɛ̀ː l ɔ
razvoj	r a z ʋ ɔ́ j
rdeč	ə r d ɛ́ t͡ʃ
rebro	r ɛ̀ː b r ɔ
redkejši	r ɛ t k ɛ́ː j ʃ i
redkev	r ɛ̀ː t k ə ʋ
rek	r ɛ́ k
rep	r ɛ́ p
reči	r ɛ̀ː t͡ʃ i
rešeto	r ɛ ʃ ɛ̀ː t ɔ
rojen	r ɔ̀ː j ɛ n
rojstvo	r ɔ̀ː j s t ʋ ɔ
roka	r ɔ̀ː k a
rokomet	r ɔ k ɔ m ɛ́ t
rosa	r ɔ̀ː s a
rovka	r ɔ́ː ʋ k a
rumen	r u m ɛ́ n
rž	ə́ r ʃ
s	s
samomor	s a m ɔ m ɔ́ r
samota	s a m ɔ̀ː t a
sanskrt	s a n s k ə́ r t
se	s ɛ
sedlo	s ɛ̀ː d l ɔ
sel	s ə́ l
sel	s ə́ ʋ
sem	s ə́ m
semenovod	s ɛ m ɛ n ɔ ʋ ɔ́ t
senožet	s ɛ n ɔ̀ː ʒ ɛ t
september	s ɛ p t ɛ̀ː m b ə r
sestra	s ɛ̀ː s t r a
si	s i
sklon	s k l ɔ́ n
skoraj	s k ɔ̀ː r a j
skoraj	s k ɔ́ː r a j
skromen	s k r ɔ̀ː m ə n
skromnejši	s k r ɔ̀ː m n ɛ j ʃ i
sladejši	s l a d ɛ́ː j ʃ i
slon	s l ɔ́ n
slonica	s l ɔ̀ː n i t͡s a
slop	s l ɔ́ p
slovnica	s l ɔ́ː ʋ n i t͡s a
slovničen	s l ɔ́ː ʋ n i t͡ʃ ə n
smo	s m ɔ́
smola	s m ɔ̀ː l a
smrt	s m ə́ r t
smrtonosen	s m ə r t ɔ n ɔ̀ː s ə n
so	s ɔ́
soba	s ɔ̀ː b a
sodoben	s ɔ d ɔ̀ː b ə n
sodobnejši	s ɔ d ɔ̀ː b n ɛ j ʃ i
sokol	s ɔ̀ː k ɔ l
solza	s ɔ̀ː ʋ z a
sorojenec	s ɔ́ r ɔ j ɛ̀ː n ə t͡s
sosed	s ɔ̀ː s ɛ t
sova	s ɔ̀ː ʋ a
spam	s p ɛ́ː m
spem	s p ɛ́ː m
sperma	s p ɛ́ː r m a
splošen	s p l ɔ̀ː ʃ ə n
splošnejši	s p l ɔ̀ː ʃ n ɛ j ʃ i
spodaj	s p ɔ̀ː d a j
spol	s p ɔ́ l
srb	s ə́ r p
srbija	s ə́ r b i j a
srbkinja	s ə́ r p k i n j a
srbski	s ə́ r p s k i
srbščina	s ə́ r p ʃ t͡ʃ i n a
srebrn	s r ɛ b ə́ r n
srednjevaloven	s r ɛ d n j ɛ ʋ a l ɔ́ː ʋ ə n
srečneje	s r ɛ t͡ʃ n ɛ́ː j ɛ
srečnejše	s r ɛ t͡ʃ n ɛ́ː j ʃ ɛ
srečnejši	s r ɛ t͡ʃ n ɛ́ː j ʃ i
srna	s ə̀ r n a
srp	s ə́ r p
sršen	s ə r ʃ ɛ́ n
sršen	s ə̀ r ʃ ɛ n
starejši	s t a r ɛ́ː j ʃ i
ste	s t ɛ́
stegno	s t ɛ̀ː ɡ n ɔ
steklo	s t ɛ̀ː k l ɔ
stetoskop	s t ɛ t ɔ s k ɔ́ p
steza	s t ə̀ z a
stol	s t ɔ́ ʋ
stolp	s t ɔ́ l p
stožec	s t ɔ̀ː ʒ ə t͡s
strgati	s t ə̀ r ɡ a t i
stroj	s t r ɔ́ j
strojen	s t r ɔ́ː j ə n
strop	s t r ɔ́ p
svet	s ʋ ɛ́ t
svetel	s ʋ ə̀ t ə ʋ
svetel	s ʋ ɛ̀ː t ə ʋ
svetloba	s ʋ ɛ t l ɔ̀ː b a
sviloprejka	s ʋ i l ɔ p r ɛ́ː j k a
svoboda	s ʋ ɔ b ɔ̀ː d a
svoboden	s ʋ ɔ b ɔ̀ː d ə n
svobodnejši	s ʋ ɔ b ɔ̀ː d n ɛ j ʃ i
takoj	t a k ɔ́ j
tele	t ɛ̀ː l ɛ
temen	t ə m ə́ n
temen	t ə̀ m ə n
tempelj	t ɛ̀ː m p ə l
tepsti	t ɛ̀ː p s t i
terbij	t ɛ̀ː r b i j
tesen	t ɛ̀ː s ə n
teta	t ɛ̀ː t a
teči	t ɛ̀ː t͡ʃ i
težek	t ɛ̀ː ʒ ə k
tipkovnica	t i p k ɔ́ː ʋ n i t͡s a
toda	t ɔ d a
tok	t ɔ́ k
tolpa	t ɔ̀ː l p a
tolči	t ɔ̀ː ʋ t͡ʃ i
top	t ɔ́ p
topel	t ɔ̀ː p ə ʋ
toplota	t ɔ p l ɔ̀ː t a
topol	t ɔ̀ː p ɔ l
torek	t ɔ̀ː r ə k
trd	t ə́ r t
trener	t r ɛ n ɛ́ː r
trg	t ə́ r k
trgati	t ə̀ r ɡ a t i
trska	t ə̀ r s k a
trst	t ə́ r s t
trši	t ə́ r ʃ i
tudi	t u d i
turoben	t u r ɔ̀ː b ə n
ulic	u l i t s
ulice	u l i t͡s ɛ
ulici	u l i t͡s i
ulico	u l i t͡s ɔ
umor	u m ɔ́ r
univerza	u n i ʋ ɛ́ː r z a
upor	u p ɔ́ r
urok	u r ɔ́ k
uspeh	u s p ɛ́ x
uvel	u ʋ ɛ́ ʋ
učenec	u t͡ʃ ɛ̀ː n ə t͡s
v	ʋ
vdova	ʋ d ɔ́ː ʋ a
vedro	ʋ ɛ̀ː d r ɔ
veja	ʋ ɛ́ː j a
vejati	ʋ ɛ́ː j a t i
vejica	ʋ ɛ́ː j i t͡s a
velik	ʋ ɛ̀ː l i k
vendar	ʋ ə̀ n d a r
vendar	ʋ ə́ n d a r
ves	ʋ ə́ s
veselje	ʋ ɛ s ɛ̀ː l j ɛ
vesti	ʋ ɛ̀ː s t i
več	ʋ ɛ́ t͡ʃ
vhod	ʋ x ɔ́ t
visok	ʋ i s ɔ́ k
vltava	ʋ ə́ l t a ʋ a
voda	ʋ ɔ̀ː d a
vojna	ʋ ɔ̀ː j n a
vojska	ʋ ɔ̀ː j s k a
vol	ʋ ɔ́ ʋ
volga	ʋ ɔ̀ː ʋ ɡ a
volk	ʋ ɔ́ː ʋ k
volna	ʋ ɔ̀ː ʋ n a
vovk	ʋ ɔ́ː ʋ k
vozel	ʋ ɔ̀ː z ə ʋ
vožnja	ʋ ɔ̀ː ʒ n j a
vrba	ʋ ə̀ r b a
vreme	ʋ r ɛ̀ː m ɛ
vretence	ʋ r ɛ t ɛ̀ː n t͡s ɛ
vroč	ʋ r ɔ́ t͡ʃ
vrst	ʋ ə́ r s t
vrsta	ʋ ə̀ r s t a
vrsten	ʋ ə́ r s t ə n
vrstnost	ʋ ə́ r s t n ɔ s t
vrt	ʋ ə́ r t
vrtnica	ʋ ə́ r t n i t͡s a
vrč	ʋ ə́ r t͡ʃ
vrša	ʋ ə̀ r ʃ a
vzhod	ʋ z x ɔ́ t
vzpon	ʋ s p ɔ́ n
z	s
za	z a
zahod	z a x ɔ́ t
zapor	z a p ɔ́ r
zel	z ə́ ʋ
zelen	z ɛ l ɛ́ n
zelena	z ɛ́ː l ɛ n a
zemlja	z ɛ̀ː m l j a
zet	z ɛ́ t
zgoraj	z ɡ ɔ̀ː r a j
zgrešiti	z ɡ r ɛ̀ː ʃ i t i
zlo	z l ɔ́
zlog	z l ɔ́ k
znoj	z n ɔ́ j
zora	z ɔ̀ː r a
zrel	z r ɛ́ ʋ
zrelejši	z r ɛ l ɛ́ː j ʃ i
zrklo	z ə̀ r k l ɔ
zssr	z ə s ə s ə r ə́
zvonec	z ʋ ɔ̀ː n ə t͡s
č	t͡ʃ
čarovnica	t͡ʃ a r ɔ́ː ʋ n i t͡s a
čarovnik	t͡ʃ a r ɔ́ː ʋ n i k
če	t͡ʃ ɛ
čelo	t͡ʃ ɛ̀ː l ɔ
česen	t͡ʃ ɛ̀ː s ə n
četrtek	t͡ʃ ɛ t ə̀ r t ə k
čistota	t͡ʃ i s t ɔ̀ː t a
človek	t͡ʃ l ɔ̀ː ʋ ɛ k
čmrlj	t͡ʃ m ə̀ r l
čoln	t͡ʃ ɔ́ː ʋ n
čopič	t͡ʃ ɔ́ː p i t͡ʃ
črka	t͡ʃ ə̀ r k a
črn	t͡ʃ ə̀ r n
črv	t͡ʃ ə́ r ʋ
šahovnica	ʃ a x ɔ́ː ʋ n i t͡s a
še	ʃ ɛ
še	ʃ ɛ́
šesti	ʃ ɛ̀ː s t i
širok	ʃ i r ɔ́ k
škof	ʃ k ɔ́ f
škorec	ʃ k ɔ̀ː r ə t͡s
štor	ʃ t ɔ́ r
študent	ʃ t u d ɛ́ n t
ž	ʒ
že	ʒ ɛ
že	ʒ ɛ́
žebelj	ʒ ɛ b ə́ l
žebelj	ʒ ɛ̀ː b ə l
želja	ʒ ɛ̀ː l j a
žena	ʒ ɛ̀ː n a
žep	ʒ ɛ́ p
žepar	ʒ ɛ́ː p a r
življenje	ʒ i ʋ l j ɛ̀ː n j ɛ
žolna	ʒ ɔ̀ː ʋ n a
žolt	ʒ ɔ́ː ʋ t
žolč	ʒ ɔ́ː ʋ t͡ʃ
žolčnik	ʒ ɔ́ː ʋ t͡ʃ n i k
žrebe	ʒ r ɛ b ɛ́
žveplo	ʒ ʋ ɛ̀ː p l ɔ
