a	a	4339
aby	a b ɨ	82
adresa	a d r ɛ s a	0
ale	a l ə	376
až	a ʃ	1187
babam	b a b a m	0
babce	b a p t͡s ə	0
babka	b a p k a	0
babkach	b a p k a x	0
babkami	b a p k a mʲ i	0
babki	b a p kʲ i	0
babu	b a b u	0
baby	b a b ɨ	0
badak	b a d a k	0
bakany	b a k a n ɨ	0
banka	b a ŋ k a	2
bankach	b a ŋ k a x	0
bankami	b a ŋ k a mʲ i	0
banki	b a ŋʲ kʲ i	2
banku	b a ŋ k u	1
baran	b a r a n	2
baze	b a z ə	0
bazowy	b a z o w ɨ	0
bazu	b a z u	4
bij	bʲ i j	0
biju	bʲ i j u	0
bili	bʲ i lʲ i	0
bił	bʲ i w	2
biś	bʲ i ɕ	0
bjerjech	bʲ e rʲ e ç	0
bjerjechmej	bʲ e rʲ e ç m e j	0
bjerjechmy	bʲ e rʲ e ç m ɨ	0
bjerjechu	bʲ e rʲ e ç u	0
bjerjecy	bʲ e rʲ ɛ t͡s ɨ	0
bjerješo	bʲ e rʲ ɛ ʃ ɔ	0
bjerještej	bʲ e rʲ ɛ ʃ t e j	0
bjerješćo	bʲ e rʲ e ɕ t͡ɕ ɔ	0
bjerjo	bʲ e rʲ ɔ	2
bjerjom	bʲ e rʲ ɔ m	0
bjerjomej	bʲ e rʲ ɔ m e j	0
bjerjomy	bʲ e rʲ ɔ m ɨ	0
bjerjotej	bʲ e rʲ ɔ t e j	0
bjerjośo	bʲ e rʲ ɔ ɕ ɔ	0
bjerjoš	bʲ e rʲ ɔ ʃ	1
bjeru	bʲ e r u	0
bjerucy	bʲ e r u t s ɨ	0
bjeŕ	bʲ e rʲ	0
bjeŕtej	bʲ e rʲ t e j	0
bjeŕśo	bʲ e rʲ ɕ ɔ	0
blida	b lʲ i d a	6
blido	b lʲ i d ɔ	8
bliska	b lʲ i s k a	2
bliski	b lʲ i s kʲ i	0
bliskich	b lʲ i s kʲ i xʲ	0
bliskim	b lʲ i s kʲ i m	0
bliskimi	b lʲ i s kʲ i mʲ i	0
blisko	b lʲ i s k ɔ	49
bluwa	b l u w a	0
bluwaju	b l u w a j u	0
bluwam	b l u w a m	0
bluwał	b l u w a w	0
bluwaś	b l u w a ɕ	0
blědy	b lʲ ɪ d ɨ	0
boba	b ɔ b a	0
boce	b ɔ t͡s ə	9
bog	b ɔ k	12
bogi	b ɔ ɡʲ i	0
bogojski	b ɔ ɡ ɔ j s k i	0
boka	b ɔ k a	11
boki	b ɔ kʲ i	9
bokom	b ɔ k ɔ m	1
boku	b ɔ k u	62
bomoju	b ɔ m ɔ j u	1
brali	b r a lʲ i	0
brana	b r a n a	0
brane	b r a n ə	0
branu	b r a n u	0
brany	b r a n ɨ	0
brat	b r a t	0
brał	b r a w	0
brała	b r a w a	0
brałej	b r a w e j	0
brało	b r a w ɔ	0
brjaze	b rʲ a z ə	0
brjog	b rʲ ɔ k	2
brjogu	b rʲ ɔ ɡ u	2
brjoze	b rʲ ɔ z ə	15
brody	b r ɔ d ɨ	0
brony	b r ɔ n ɨ	1
brudny	b r u d n ɨ	0
bruka	b r u k a	0
bruku	b r u k u	0
brus	b r u s	0
brusa	b r u s a	0
bruse	b r u s ə	0
brusk	b r u s k	0
buch	b u x	0
buchmej	b u x m e j	0
buchmy	b u x m ɨ	0
buchu	b u x u	35
buda	b u d a	0
budka	b u t k a	0
budu	b u d u	16
budyšyn	b u d ɨ ʃ ɨ n	33
buka	b u k a	4
buki	b u kʲ i	2
buku	b u k u	0
bulgarska	b u l ɡ a r s k a	3
buwoł	b u w o w	0
buštej	b u ʃ t e j	1
bušćo	b u ɕ t͡ɕ ɔ	0
buźo	b u ʑ ɔ	15
buźomej	b u ʑ ɔ m e j	0
buźomy	b u ʑ ɔ m ɨ	0
buźotej	b u ʑ ɔ t e j	0
buźośo	b u ʑ ɔ ɕ ɔ	2
buźoš	b u ʑ ɔ ʃ	1
buźtej	b u ɕ t e j	0
by	b ɨ	38
bydle	b ɨ d l ə	6
bydlenje	b ɨ d l e nʲ ə	0
bydleński	b ɨ d l e nʲ s kʲ i	1
bydli	b ɨ d lʲ i	9
bydlim	b ɨ d lʲ i m	0
bydlit	b ɨ d lʲ i t	0
bydlił	b ɨ d lʲ i w	5
bydliś	b ɨ d lʲ i ɕ	0
byli	b ɨ lʲ i	104
byt	b ɨ t	0
był	b ɨ w	388
była	b ɨ w a	120
było	b ɨ w ɔ	107
byśe	b ɨ ɕ ə	0
bój	b e j	0
bójał	b e j a w	1
bójaś	b e j a ɕ	1
bóje	b e j ə	0
bójm	b e j m	0
bóleś	b ɛ l e ɕ	0
bóleś	b ɨ l e ɕ	0
bóleś	b ʊ l e ɕ	0
bóli	b ɛ lʲ i	0
bóli	b ɨ lʲ i	0
bóli	b ʊ lʲ i	0
caple	t͡s a p l ə	0
carna	t͡s a r n a	18
carne	t͡s a r n ə	24
carnica	t s a r nʲ i t s a	4
carny	t s a r n ɨ	29
casam	t͡s a s a m	0
case	t͡s a s ə	6
casnik	t͡s a s nʲ i k	13
casu	t͡s a s u	71
ceja	t͡s e j a	0
ceje	t͡s e j ə	1
ceji	t͡s e j i	0
cele	t͡s ɛ l ə	17
cep	t͡s ɛ p	0
cepam	t͡s ɛ p a m	0
cepy	t s ɛ p ɨ	1
cerkwja	t͡s ɛ r k vʲ a	24
cesaś	t s ɛ s a ɕ	0
ceste	t͡s ɛ s t ɛ	3
ceły	t s ɛ w ɨ	9
chart	x a r t	0
chartam	x a r t a m	0
chlěw	x lʲ ɪ w	0
chołuj	x o w u j	0
chrome	x r ɔ m ə	0
chyle	x ɨ l ɛ	0
chyliś	x ɨ lʲ i ɕ	0
chytat	x ɨ t a t	0
chytaś	x ɨ t a ɕ	1
chójźiś	x e j ʑ i ɕ	0
chóre	x ɛ r ə	2
chóre	x ɨ r ə	2
chóre	x ʊ r ə	2
chóśebuski	x ɛ ɕ ə b u s kʲ i	0
chóśebuski	x ɨ ɕ ə b u s kʲ i	0
chóśebuski	x ʊ ɕ ə b u s kʲ i	0
chóśebuza	x ɛ ɕ ə b u z a	4
chóśebuza	x ɨ ɕ ə b u z a	4
chóśebuza	x ʊ ɕ ə b u z a	4
cole	t͡s ɔ l ə	0
com	t͡s ɔ m	3
comy	t͡s ɔ m ɨ	1
cołn	t s o w n	1
coło	t s o w ɔ	1
crjej	t͡s rʲ e j	0
crjono	t s rʲ ɔ n ɔ	0
crjowo	t͡s rʲ o w ɔ	0
cu	t͡s u	1
cujo	t͡s u j ɔ	0
cuju	t͡s u j u	0
cuś	t s u ɕ	1
cybula	t͡s ɨ b u l a	2
cycaś	t s ɨ t s a ɕ	0
cynje	t͡s ɨ nʲ ə	4
cysta	t͡s ɨ s t a	1
cyste	t͡s ɨ s t ə	0
cysło	t͡s ɨ s w ɔ	7
cyta	t͡s ɨ t a	3
cytanje	t͡s ɨ t a nʲ ə	2
cytat	t͡s ɨ t a t	0
cytaś	t͡s ɨ t a ɕ	4
dach	d a x	0
daj	d a j	1
dajo	d a j ɔ	50
dajom	d a j ɔ m	0
daju	d a j u	15
dalej	d a l e j	50
dali	d a lʲ i	3
dalina	d a lʲ i n a	0
daloki	d a l ɔ kʲ i	0
dana	d a n a	2
dane	d a n ə	1
danem	d a n ɛ m	1
danje	d a nʲ ə	0
danju	d a nʲ u	0
dank	d a ŋ k	1
danki	d a ŋʲ kʲ i	3
danku	d a ŋ k u	0
dany	d a n ɨ	2
daty	d a t ɨ	5
dawa	d a w a	3
dawaj	d a w a j	0
dawat	d a w a t	0
dawaś	d a w a ɕ	0
dał	d a w	9
dała	d a w a	2
daś	d a ɕ	10
dej	d e j	20
diskutowaś	dʲ i s k u t o w a ɕ	0
dnja	d nʲ a	39
dobre	d ɔ b r ə	8
dobrej	d ɔ b r e j	0
dokulaž	d ɔ k u l a ʃ	123
dole	d ɔ l ə	0
dolnoserbski	d ɔ l n ɔ s ɛ r s kʲ i	25
domk	d ɔ m k	0
domoju	d ɔ m ɔ j u	0
doł	d o w	2
dołojce	d o w ɔ j t͡s ə	19
drapa	d r a p a	0
drježdźany	d rʲ e ʑ d ʑ a n ɨ	5
droga	d r o w ɡ a	12
droge	d r ɔ ɡʲ ə	1
drogi	d r o w ɡʲ i	17
drogi	d r ɔ ɡʲ i	17
drogim	d r ɔ ɡʲ i m	0
drogimi	d r ɔ ɡʲ i mʲ i	0
drogo	d r ɔ ɡ ɔ	0
drogowy	d r o w ɡ o w ɨ	0
droze	d r o w z ə	6
droze	d r ɔ z ə	6
drozna	d r ɔ z n a	1
droznach	d r ɔ z n a x	0
droznam	d r ɔ z n a m	0
droznami	d r ɔ z n a mʲ i	0
droznje	d r ɔ z nʲ ə	0
droznoma	d r ɔ z n ɔ m a	0
droznow	d r ɔ z n o w	1
droznowu	d r ɔ z n o w u	0
drozny	d r ɔ z n ɨ	0
druga	d r u ɡ a	16
drugim	d r u ɡʲ i m	46
drugimi	d r u ɡʲ i mʲ i	11
dubje	d u bʲ ə	0
duj	d u j	0
duli	d u lʲ i	0
duta	d u t a	0
dute	d u t ə	0
dutu	d u t u	0
duty	d u t ɨ	0
duł	d u w	0
dycha	d ɨ x a	0
dychaś	d ɨ x a ɕ	0
dłoń	d w ɔ nʲ	0
długa	d w u ɡ a	0
długi	d w u ɡʲ i	0
dłymoki	d w ɨ m ɔ kʲ i	4
elektrikaŕ	ɛ l ɛ k t rʲ i k a rʲ	0
fabrice	f a b rʲ i t͡s ə	1
fagota	f a ɡ ɔ t a	0
ferije	f ɛ rʲ i j ə	0
fidle	fʲ i d l ə	0
formowaś	f ɔ r m o w a ɕ	1
ga	ɡ a	17
galerija	ɡ a l ə rʲ i j a	27
gaž	ɡ a ʃ	69
giba	ɡʲ i b a	0
gibanje	ɡʲ i b a nʲ ə	4
gibaś	ɡʲ i b a ɕ	0
glej	ɡ l e j	7
glicka	ɡ lʲ i t s k a	0
gołub	ɡ o w u p	0
gołubja	ɡ o w u bʲ a	0
goły	ɡ o w ɨ	1
grab	ɡ r a p	0
graba	ɡ r a b a	0
graj	ɡ r a j	0
grajo	ɡ r a j ɔ	4
grali	ɡ r a lʲ i	0
granica	ɡ r a nʲ i t͡s a	23
granice	ɡ r a nʲ i t͡s ə	8
granicowaś	ɡ r a nʲ i t͡s o w a ɕ	0
grał	ɡ r a w	3
grała	ɡ r a w a	1
grałej	ɡ r a w e j	0
grało	ɡ r a w ɔ	1
graś	ɡ r a ɕ	10
graśe	ɡ r a ɕ ə	10
grimaś	ɡ r i m a ɕ	0
griwa	ɡ rʲ i w a	0
grobje	ɡ r ɔ bʲ ə	0
groda	ɡ r ɔ d a	9
grodowy	ɡ r ɔ d o w ɨ	2
gromaźe	ɡ r ɔ m a ʑ ə	33
groniś	ɡ r ɔ nʲ i ɕ	3
groze	ɡ r ɔ z ə	0
gubawka	ɡ u b a w k a	0
gubu	ɡ u b u	1
gumno	ɡ u m n ɔ	0
gumnyško	ɡ u m n ɨ ʃ k ɔ	0
guste	ɡ u s t ə	0
gójś	ɡ e j ɕ	0
góle	ɡ ɛ l ə	8
góle	ɡ ɨ l ə	8
góle	ɡ ʊ l ə	8
górce	ɡ ɛ r t͡s ə	0
górce	ɡ ɨ r t͡s ə	0
górce	ɡ ʊ r t͡s ə	0
górjejce	ɡ ɛ rʲ e j t͡s ə	26
górjejce	ɡ ɨ rʲ e j t͡s ə	26
górjejce	ɡ ʊ rʲ e j t͡s ə	26
gósćeńc	ɡ ɛ s t͡ɕ e nʲ t͡s	4
gósćeńc	ɡ ɨ s t͡ɕ e nʲ t͡s	4
gósćeńc	ɡ ʊ s t͡ɕ e nʲ t͡s	4
gótowa	ɡ ɛ t o w a	0
gótowa	ɡ ɨ t o w a	0
gótowa	ɡ ʊ t o w a	0
gótowy	ɡ ɛ t o w ɨ	2
gótowy	ɡ ɨ t o w ɨ	2
gótowy	ɡ ʊ t o w ɨ	2
gózdźe	ɡ ɛ z d͡ʑ ə	0
gózdźe	ɡ ɨ z d͡ʑ ə	0
gózdźe	ɡ ʊ z d͡ʑ ə	0
gła	ɡ w a	0
gładka	ɡ w a t k a	6
gładki	ɡ w a t kʲ i	2
gładkim	ɡ w a t kʲ i m	1
gładkimi	ɡ w a t kʲ i m i	0
głos	ɡ w ɔ s	3
głowa	ɡ w o w a	14
głowy	ɡ w o w ɨ	4
głuchy	ɡ w u x ɨ	0
historiska	h i s t ɔ rʲ i s k a	4
historiske	h i s t ɔ rʲ i s kʲ ə	22
historiski	h i s t ɔ rʲ i s kʲ i	21
how	o w	133
hurje	h u rʲ ə	0
hynak	ɨ n a k	0
hyt	ɨ t	0
hyšći	ɨ ɕ t ɕ i	120
jabłucyna	j a b w u t s ɨ n a	1
jabłuko	j a b w u k ɔ	1
jabłušcyna	j a b w u ʃ t s ɨ n a	11
jacmjeń	j a t͡s mʲ e nʲ	0
jadno	j a d n ɔ	13
jagnje	j a ɡ nʲ ə	0
jagnjeśina	j a ɡ nʲ ə ɕ i n a	0
jaja	j a j a	1
jajce	j a j t͡s ə	0
jaji	j a j i	0
jare	j a r ə	1
jaskolicka	j a s k ɔ lʲ i t͡s k a	0
jasne	j a s n ə	5
jasniś	j a s nʲ i ɕ	0
jastśebik	j a s t͡ɕ e bʲ i k	0
jastśebja	j a s t͡ɕ e bʲ a	0
jašćeŕ	j a ɕ t͡ɕ e rʲ	0
jedle	j ɛ d l ə	0
jedła	j ɛ d w a	8
jeglicka	j ɛ ɡ lʲ i t͡s k a	0
jegła	j ɛ ɡ w a	0
jej	j e j	10
jeju	j e j u	7
jen	j ɛ n	11
jerjeł	j e rʲ ɛ w	4
jesotr	j ɛ s ɔ t r	0
ježyk	j ɛ ʒ ɨ k	0
jim	j i m	9
jo	j ɔ	4943
joli	j ɔ lʲ i	0
jsu	s u	0
ju	j u	26
jucha	j u x a	0
jěźech	j ɪ ʑ e ç	0
jěźechmej	j ɪ ʑ e ç m e j	0
jěźechmy	j ɪ ʑ e ç m ɨ	0
jěźechu	j ɪ ʑ e ç u	0
jěźenje	j ɪ ʑ e nʲ ə	0
jěźešćo	j ɪ ʑ e ɕ t͡ɕ ɔ	0
kak	k a k	17
kake	k a kʲ ə	2
kaki	k a kʲ i	1
kaku	k a k u	0
kamele	k a m ɛ l ə	0
kamjeń	k a mʲ e nʲ	2
kana	k a n a	0
kanka	k a ŋ k a	0
kanki	k a ŋʲ kʲ i	0
kapow	k a p o w	0
karam	k a r a m	0
karow	k a r o w	0
karwona	k a r w ɔ n a	2
kawce	k a w t͡s ə	0
kaž	k a ʃ	203
kida	kʲ i d a	0
kidat	kʲ i d a t	0
kidaś	kʲ i d a ɕ	0
kij	kʲ i j	1
kija	kʲ i j a	1
kijach	kʲ i j a x	0
kijami	kʲ i j a mʲ i	0
kije	kʲ i j ə	0
kijom	kʲ i j ɔ m	0
kisały	kʲ i s a w ɨ	2
kito	kʲ i t ɔ	6
kjarmiś	kʲ a r mʲ i ɕ	0
klin	k lʲ i n	0
klina	k lʲ i n a	1
klink	k lʲ i ŋ k	0
klon	k l ɔ n	2
klona	k l ɔ n a	0
klonam	k l ɔ n a m	0
klěb	k lʲ ɪ p	2
klěcaś	k lʲ ɪ t͡s a ɕ	0
klěkaś	k lʲ ɪ k a ɕ	0
klěś	k lʲ ɪ ɕ	1
klěšće	k lʲ ɪ ɕ t͡ɕ ə	0
knigła	k nʲ i ɡ w a	0
kofera	k ɔ f ɛ r a	0
kole	k ɔ l ɛ	0
kopš	k ɔ p ʃ	0
koł	k o w	0
kołp	k o w p	0
kralik	k r a lʲ i k	0
krotki	k r ɔ t kʲ i	11
kuchni	k u x nʲ i	5
kulaty	k u l a t ɨ	0
kulturny	k u l t u r n ɨ	15
kuna	k u n a	0
kupadło	k u p a d w ɔ	0
kupka	k u p k a	28
kupnica	k u p nʲ i t͡s a	0
kupnice	k u p nʲ i t͡s ə	0
kurce	k u r t͡s ə	0
kurjawa	k u rʲ a w a	0
kurkach	k u r k a x	0
kurkami	k u r k a mʲ i	0
kwas	k w a s	0
kónopje	k ɛ n ɔ pʲ ə	0
kónopje	k ɨ n ɔ pʲ ə	0
kónopje	k ʊ n ɔ pʲ ə	0
kórjeń	k ɛ rʲ e nʲ	2
kórjeń	k ɨ rʲ e nʲ	2
kórjeń	k ʊ rʲ e nʲ	2
kóse	k ɛ s ə	0
kóse	k ɨ s ə	0
kóse	k ʊ s ə	0
kłojś	k w ɔ j ɕ	0
kśebjat	k ɕ e bʲ a t	1
kśebjata	k ɕ e bʲ a t a	0
kśemjeń	k ɕ e mʲ e nʲ	0
kšaj	k ʃ a j	0
kšajaś	k ʃ a j a ɕ	0
kšasny	k ʃ a s n ɨ	1
kšawny	k ʃ a w n ɨ	0
kšej	k ʃ e j	0
kšet	k ʃ ɛ t	0
kšyś	k ʃ ɨ ɕ	0
kšyśe	k ʃ ɨ ɕ ə	1
lana	l a n a	0
lanam	l a n a m	0
lank	l a ŋ k	0
lawa	l a w a	0
laž	l a ʃ	0
lažał	l a ʒ a w	1
laže	l a ʒ ə	21
lažki	l a ʃ kʲ i	0
lažy	l a ʒ ɨ	118
lažym	l a ʒ ɨ m	0
lažčejšy	l a ʃ t͡ʃ e j ʃ ɨ	0
leśe	l e ɕ ə	2
leśeł	l e ɕ ɛ w	0
leśeś	l e ɕ e ɕ	1
lic	lʲ i t͡s	0
lice	lʲ i t͡s ə	5
licho	lʲ i xʲ ɔ	3
lichy	lʲ i xʲ ɨ	2
lico	lʲ i t͡s ɔ	0
licy	lʲ i t͡s ɨ	13
licyś	lʲ i t͡s ɨ ɕ	2
lip	lʲ i p	0
lipa	lʲ i p a	1
lipat	lʲ i p a t	0
lipaś	lʲ i p a ɕ	0
lipoma	lʲ i p ɔ m a	0
lipsk	lʲ i p s k	5
list	lʲ i s t	10
lista	lʲ i s t a	3
listy	lʲ i s t ɨ	1
liška	lʲ i ʃ k a	4
loda	l ɔ d a	0
lodka	l ɔ t k a	0
lody	l ɔ d ɨ	1
lube	l u b ə	0
lubje	l u bʲ ə	0
lubjej	l u bʲ e j	59
lubowaś	l u b o w a ɕ	3
luby	l u b ɨ	0
luda	l u d a	15
ludam	l u d a m	0
lute	l u t ə	0
lěkaŕ	lʲ ɪ k a rʲ	0
lěpšy	lʲ ɪ p ʃ ɨ	2
lěs	lʲ ɪ s	9
lěto	lʲ ɪ t ɔ	37
lěwy	lʲ ɪ w ɨ	2
lězć	lʲ ɪ s t͡ɕ	3
lěśe	lʲ ɪ ɕ ə	419
ma	m a	515
malina	m a lʲ i n a	0
malinami	m a lʲ i n a mʲ i	0
mam	m a m	5
mama	m a m a	4
mamach	m a m a x	0
mapje	m a pʲ ə	0
mapu	m a p u	0
mapy	m a p ɨ	0
marchwej	m a r x w e j	0
marchwje	m a r x j ə	0
marchwje	m a r x vʲ ə	0
marznjo	m a r z nʲ ɔ	0
marznjom	m a r z nʲ ɔ m	0
marznu	m a r z n u	0
marznuł	m a r z n u w	0
marznuś	m a r z n u ɕ	0
masle	m a s l ə	0
masć	m a s t͡ɕ	0
mała	m a w a	21
małe	m a w ə	26
mały	m a w ɨ	20
małych	m a w ɨ x	5
mech	m æ x	1
mecha	m æ x a	0
mej	m e j	1
miłe	mʲ i w ə	1
mjaza	mʲ a z a	0
mjelcał	mʲ ɛ l t͡s a w	0
mjelcaś	mʲ e l t s a ɕ	0
mjelce	mʲ ɛ l t͡s ɛ	0
mjelcy	mʲ ɛ l t͡s ɨ	0
mjelcym	mʲ ɛ l t͡s ɨ m	0
mjenja	mʲ e nʲ a	28
mjeńšy	mʲ e nʲ ʃ ɨ	4
mnjo	m nʲ ɔ	5
moderna	m ɔ d ɛ r n a	2
modernam	m ɔ d ɛ r n a m	0
moderne	m ɔ d ɛ r n ə	3
modernem	m ɔ d ɛ r n ɛ m	2
modernu	m ɔ d ɛ r n u	3
moderny	m ɔ d ɛ r n ɨ	2
mokšy	m ɔ k ʃ ɨ	0
mroja	m r ɔ j a	5
mrok	m r ɔ k	0
mroz	m r ɔ s	3
muce	m u t͡s ə	1
muchy	m u x ɨ	0
mucka	m u t s k a	0
mudry	m u d r ɨ	2
muka	m u k a	22
muki	m u kʲ i	7
mule	m u l ə	0
muli	m u lʲ i	0
muski	m u s kʲ i	4
muše	m u ʃ ə	0
mušla	m u ʃ l a	0
muže	m u ʒ ə	2
mydło	m ɨ d w ɔ	0
myjo	m ɨ j ɔ	0
myjom	m ɨ j ɔ m	0
myju	m ɨ j u	0
myli	m ɨ lʲ i	0
mysl	m ɨ s l	0
mysli	m ɨ s lʲ i	3
myslit	m ɨ s lʲ i t	0
mysliś	m ɨ s lʲ i ɕ	0
mył	m ɨ w	0
myśe	m ɨ ɕ ə	1
myška	m ɨ ʃ k a	0
módle	m ɛ d l ə	0
módle	m ɨ d l ə	0
módle	m ʊ d l ə	0
módli	m ɛ d lʲ i	0
módli	m ɨ d lʲ i	0
módli	m ʊ d lʲ i	0
módlim	m ɛ d lʲ i m	0
módlim	m ɨ d lʲ i m	0
módlim	m ʊ d lʲ i m	0
módlił	m ɛ d lʲ i w	0
módlił	m ɨ d lʲ i w	0
módlił	m ʊ d lʲ i w	0
módliś	m ɛ d lʲ i ɕ	0
módliś	m ɨ d lʲ i ɕ	0
módliś	m ʊ d lʲ i ɕ	0
módre	m ɛ d r ə	9
módre	m ɨ d r ə	9
módre	m ʊ d r ə	9
mógli	m ɛ ɡ lʲ i	4
mógli	m ɨ ɡ lʲ i	4
mógli	m ʊ ɡ lʲ i	4
mógłej	m ɛ ɡ w e j	0
mógłej	m ɨ ɡ w e j	0
mógłej	m ʊ ɡ w e j	0
mój	m e j	11
móle	m ɛ l ə	0
móle	m ɨ l ə	0
móle	m ʊ l ə	0
móli	m ɛ lʲ i	0
móli	m ɨ lʲ i	0
móli	m ʊ lʲ i	0
móžomej	m ɛ ʒ ɔ m e j	0
móžomej	m ɨ ʒ ɔ m e j	0
móžomej	m ʊ ʒ ɔ m e j	0
móžotej	m ɛ ʒ ɔ t e j	3
móžotej	m ɨ ʒ ɔ t e j	3
móžotej	m ʊ ʒ ɔ t e j	3
měrje	mʲ ɪ rʲ ə	9
mězdze	mʲ ɪ z d͡z ə	4
młode	m w ɔ d ə	24
młody	m w ɔ d ɨ	6
młoźinske	m ɔ ʑ i n s kʲ ə	4
nadra	n a d r a	0
nadro	n a d r ɔ	0
nage	n a ɡʲ ə	11
nalěwo	n a lʲ ɪ w ɔ	5
nam	n a m	3
nama	n a m a	0
nami	n a mʲ i	1
nanam	n a n a m	0
nanom	n a n ɔ m	1
napad	n a p a t	1
napis	n a pʲ i s	2
nastwark	n a s t w a r k	0
naš	n a ʃ	1
nejgóršy	n e j ɡ ɛ r ʃ ɨ	0
nejgóršy	n e j ɡ ɨ r ʃ ɨ	0
nejgóršy	n ɛ j ɡ ʊ r ʃ ɨ	0
nime	nʲ i m ə	0
nimi	nʲ i mʲ i	14
nimski	nʲ i m s kʲ i	69
nimy	nʲ i m ɨ	1
niskim	nʲ i s kʲ i m	1
niskimi	nʲ i s kʲ i mʲ i	0
niś	nʲ i ɕ	0
njabogi	nʲ a b ɔ ɡʲ i	1
njaso	nʲ a s ɔ	47
njasom	nʲ a s ɔ m	0
njasośo	nʲ a s ɔ ɕ ɔ	0
njasu	nʲ a s u	70
njasć	nʲ a s t ɕ	1
nje	nʲ ɛ	1
njebjo	nʲ e bʲ ɔ	4
njejdu	nʲ e j d u	0
njejsmej	nʲ e j s m e j	0
njejsmy	nʲ e j s m ɨ	2
njejsom	nʲ e j s ɔ m	3
njejstej	nʲ e j s t e j	4
njejsu	nʲ e j s u	55
njejsy	nʲ e j s ɨ	0
njejsćo	nʲ e j s t͡ɕ ɔ	0
njejźo	nʲ e j ʑ ɔ	4
njejźom	nʲ e j ʑ ɔ m	0
njejźomej	nʲ e j ʑ ɔ m e j	0
njejźoš	nʲ e j ʑ ɔ ʃ	0
njen	nʲ ɛ n	1
njewjedro	nʲ e vʲ ɛ d r ɔ	0
njewjericka	nʲ e vʲ ə rʲ i t͡s k a	1
njeźela	nʲ e ʑ e l a	1
njom	nʲ ɔ m	10
nju	nʲ u	2
nogami	n ɔ ɡ a mʲ i	1
nosa	n ɔ s a	0
nose	n ɔ s ə	7
nosu	n ɔ s u	0
nowa	n o w a	14
nowe	n o w ə	21
nowego	n o w ɛ ɡ ɔ	12
nowo	n o w ɔ	3
noze	n ɔ z ə	10
nožyce	n ɔ ʒ ɨ t͡s ə	0
numera	n u m ɛ r a	2
numeram	n u m ɛ r a m	0
pada	p a d a	6
padaj	p a d a j	0
padali	p a d a lʲ i	1
padam	p a d a m	0
padamy	p a d a m ɨ	0
padat	p a d a t	0
padał	p a d a w	0
padała	p a d a w a	0
padało	p a d a w ɔ	0
padaś	p a d a ɕ	0
pak	p a k	174
pal	p a l	2
palack	p a l a t s k	0
pale	p a l ə	0
pali	p a lʲ i	2
palica	p a lʲ i t͡s a	0
palice	p a lʲ i t͡s ə	0
palim	p a lʲ i m	0
palimy	p a lʲ i m ɨ	0
palit	p a lʲ i t	0
palił	p a lʲ i w	0
paliła	p a lʲ i w a	0
paliło	p a lʲ i w ɔ	0
paliś	p a lʲ i ɕ	1
paliśo	p a lʲ i ɕ ɔ	0
pališ	p a lʲ i ʃ	0
palone	p a l ɔ n ə	0
papam	p a p a m	0
papje	p a pʲ ə	0
papu	p a p u	0
papy	p a p ɨ	0
parkam	p a r k a m	0
parki	p a r kʲ i	0
parku	p a r k u	5
pasa	p a s a	0
pase	p a s ə	0
pasu	p a s u	0
pałco	p a w t͡s ɔ	0
pałcom	p a w t͡s ɔ m	0
pałcu	p a w t͡s u	0
pałka	p a w k a	0
pałkach	p a w k a x	0
pałkaju	p a w k a j u	0
pałkam	p a w k a m	0
pałkał	p a w k a w	0
pałkaś	p a w k a ɕ	0
pcołka	t͡s o w k a	0
pij	pʲ i j	0
pijo	pʲ i j ɔ	1
pijom	pʲ i j ɔ m	0
piju	pʲ i j u	0
pile	pʲ i l ə	0
pili	pʲ i lʲ i	1
pisa	pʲ i s a	1
pisaju	pʲ i s a j u	0
pisam	pʲ i s a m	0
pisaśo	pʲ i s a ɕ ɔ	0
pita	pʲ i t a	0
pite	pʲ i t ə	0
pił	pʲ i w	1
piśe	pʲ i ɕ ə	4
piš	pʲ i ʃ	0
pišo	pʲ i ʃ ɔ	8
pišom	pʲ i ʃ ɔ m	1
pišośo	pʲ i ʃ ɔ ɕ ɔ	0
pišu	pʲ i ʃ u	6
pjaco	pʲ a t͡s ɔ	0
pjacom	pʲ a t͡s ɔ m	0
pjakarja	pʲ a k a rʲ a	1
pjakaŕ	pʲ a k a rʲ	0
pjaku	pʲ a k u	2
pjakł	pʲ a k	0
pjas	pʲ a s	7
pjelniś	pʲ e l nʲ i ɕ	0
pjenjeze	pʲ e nʲ ɛ z ə	12
pjerina	pʲ e rʲ i n a	1
planowaś	p l a n o w a ɕ	0
plast	p l a s t	0
platł	p l a t	0
pletu	p l ɛ t u	0
pleśo	p l ɛ ɕ ɔ	0
pleśom	p l ɛ ɕ ɔ m	0
pluwa	p l u w a	0
pluwaju	p l u w a j u	0
pluwam	p l u w a m	0
pluwał	p l u w a w	0
pluwaś	p l u w a ɕ	0
plěś	p lʲ ɪ ɕ	0
politika	p ɔ lʲ i tʲ i k a	11
politiki	p ɔ lʲ i tʲ i kʲ i	4
pomocy	p ɔ m ɛ t s ɨ	3
połniś	p o w nʲ i ɕ	0
połožyś	p o w ɔ ʒ ɨ ɕ	1
pranje	p r a nʲ ə	0
prat	p r a t	0
praś	p r a ɕ	0
prog	p r ɔ k	0
prose	p r ɔ s ə	0
proseta	p r ɔ s ɛ t a	0
proseśa	p r ɔ s ɛ ɕ a	0
proseśi	p r ɔ s ɛ ɕ i	0
psu	p s u	0
ptaškowy	p t a ʃ k o w ɨ	0
puste	p u s t ə	0
pušćaś	p u ɕ t͡ɕ a ɕ	0
pyrje	p ɨ rʲ ə	0
pyta	p ɨ t a	2
pytaj	p ɨ t a j	0
pytaju	p ɨ t a j u	0
pytali	p ɨ t a lʲ i	1
pytam	p ɨ t a m	0
pytamy	p ɨ t a m ɨ	0
pytanje	p ɨ t a nʲ ə	5
pytał	p ɨ t a w	1
pytała	p ɨ t a w a	0
pytało	p ɨ t a w ɔ	0
pytaś	p ɨ t a ɕ	1
póli	p ɛ lʲ i	1
póli	p ɨ lʲ i	1
póli	p ʊ lʲ i	1
pónjeźela	p ɛ nʲ ə ʑ e l a	0
pónjeźela	p ɨ nʲ ə ʑ e l a	0
pónjeźela	p ʊ nʲ ə ʑ e l a	0
pónjeźele	p ɛ nʲ ə ʑ e l ə	3
pónjeźele	p ɨ nʲ ə ʑ e l ə	3
pónjeźele	p ʊ nʲ ə ʑ e l ə	3
pósoł	p ɛ s o w	1
pósoł	p ɨ s o w	1
pósoł	p ʊ s o w	1
pětkow	pʲ ɪ t k o w	0
pětkowu	pʲ ɪ t k o w u	0
płod	p w ɔ t	50
płonina	p w ɔ nʲ i n a	7
płot	p w ɔ t	1
płowy	p o w ɨ	0
pługi	p w u ɡʲ i	0
pśechwatanje	p ɕ ɛ x w a t a nʲ ə	0
pśechójźowaś	p ɕ ɛ x e j ʑ o w a ɕ	1
pśedajo	p ɕ ɛ d a j ɔ	1
pśedajom	p ɕ ɛ d a j ɔ m	0
pśedaju	p ɕ ɛ d a j u	1
pśedawarnja	p ɕ ɛ d a w a r nʲ a	0
pśedał	p ɕ ɛ d a w	0
pśedaś	p ɕ ɛ d a ɕ	0
pśikład	p ɕ i k w a t	83
pśiś	p ɕ i ɕ	3
pšawem	p ʃ a w ɛ m	5
pšawo	p ʃ a w ɔ	7
pšawy	p ʃ a w ɨ	17
pšenica	p ʃ ɛ nʲ i t͡s a	0
pšenice	p ʃ ɛ nʲ i t͡s ə	0
pšose	p ʃ ɔ s ə	0
pšoso	p ʃ ɔ s ɔ	0
pšosty	p ʃ ɔ s t ɨ	0
pšosy	p ʃ ɔ s ɨ	1
pšosym	p ʃ ɔ s ɨ m	2
pšosył	p ʃ ɔ s ɨ w	0
ramje	r a mʲ ə	0
rež	r ɛ ʃ	0
ric	rʲ i t͡s	0
ricali	rʲ i t͡s a lʲ i	0
ricał	rʲ i t͡s a w	0
ricaś	rʲ i t͡s a ɕ	0
rice	rʲ i t͡s ə	0
ricy	rʲ i t͡s ɨ	0
ricym	rʲ i t͡s ɨ m	0
rjemjeń	rʲ e mʲ e nʲ	0
rjeśaz	rʲ e ɕ a s	1
rog	r ɔ k	1
rogi	r ɔ ɡʲ i	0
rosach	r ɔ s a x	0
rosam	r ɔ s a m	0
rose	r ɔ s ə	0
roska	r ɔ s k a	0
roskam	r ɔ s k a m	0
rost	r ɔ s t	1
rostu	r ɔ s t u	15
rosy	r ɔ s ɨ	0
row	r o w	4
rowny	r o w n ɨ	11
rožk	r ɔ ʃ k	2
rub	r u p	0
ruba	r u b a	0
rubaj	r u b a j	0
rubaju	r u b a j u	0
rubam	r u b a m	0
rubał	r u b a w	0
rubaś	r u b a ɕ	0
rubjo	r u bʲ ɔ	1
rubjom	r u bʲ ɔ m	0
rubju	r u bʲ u	0
ruce	r u t͡s ə	4
rukajca	r u k a j t͡s a	0
ruki	r u kʲ i	2
ruku	r u k u	2
rum	r u m	25
rumam	r u m a m	0
rumnosć	r u m n ɔ s t ɕ	1
rybce	r ɨ p t͡s ə	0
rybka	r ɨ p k a	0
rybkach	r i p k a x	0
rybkami	r ɨ p k a mʲ i	0
rybki	r ɨ p kʲ i	0
ryby	r ɨ b ɨ	4
ryj	r ɨ j	0
ryś	r ɨ ɕ	1
rědne	rʲ ɪ d n ə	3
sad	s a t	7
sadom	s a d ɔ m	0
sadło	s a d w ɔ	0
sajźiś	s a j ʑ i ɕ	0
saźe	s a ʑ ə	3
se	s ɛ	2016
seco	s ɛ t͡s ɔ	0
sect	s ɛ t͡s t	0
sednuś	s ɛ d n u ɕ	0
segni	s ɛ ɡ nʲ i	0
segnuś	s ɛ ɡ n u ɕ	0
sej	s e j	2
sejźe	s e j ʑ ə	24
sejźeł	s e j ʑ ɛ w	2
sejźeś	s e j ʑ e ɕ	1
sejźi	s e j ʑ i	3
sejźim	s e j ʑ i m	0
seku	s ɛ k u	0
semje	s ɛ mʲ ə	7
senam	s ɛ n a m	0
senu	s ɛ n u	0
seram	s ɛ r a m	0
serb	s ɛ r p	3
serbiska	s ɛ r bʲ i s k a	8
serbiske	s ɛ r bʲ i s kʲ ə	3
serbiski	s ɛ r bʲ i s kʲ i	5
serbisku	s ɛ r bʲ i s k u	1
serbowka	s ɛ r b o w k a	0
serbska	s ɛ r s k a	37
serbski	s ɛ r s kʲ i	80
serbskim	s ɛ r s kʲ i m	4
serbskimi	s ɛ r s kʲ i mʲ i	0
serbšćina	s ɛ r ɕ t ɕ i n a	4
serca	s ɛ r t͡s a	0
sercach	s ɛ r t͡s a x	0
serce	s ɛ r t͡s ə	0
seroma	s ɛ r ɔ m a	0
serow	s ɛ r o w	0
sery	s ɛ r ɨ	0
set	s ɛ t	0
seś	s ɛ ɕ	14
skok	s k ɔ k	0
skóńcowaś	s k ɛ nʲ t͡s o w a ɕ	0
skóńcowaś	s k ɨ nʲ t͡s o w a ɕ	0
skóńcowaś	s k ʊ nʲ t͡s o w a ɕ	0
slach	s l a x	0
slam	s l a m	0
slami	s l a mʲ i	0
slinik	s lʲ i nʲ i k	0
slow	s l o w	3
slěpy	s lʲ ɪ p ɨ	0
slěwka	s lʲ ɪ w k a	0
slězy	s lʲ ɪ z ɨ	2
smej	s m e j	1
snědanje	s nʲ ɪ d a nʲ ə	0
solam	s ɔ l a m	0
soli	s ɔ lʲ i	3
solny	s ɔ l n ɨ	1
solu	s ɔ l u	0
son	s ɔ n	0
sonach	s ɔ n a x	0
sonje	s ɔ nʲ ə	0
sony	s ɔ n ɨ	0
sotše	s ɔ t͡ʃ ə	0
sowa	s o w a	1
spach	s p a x	2
spachmej	s p a x m e j	0
spachmy	s p a x m ɨ	0
spachu	s p a x u	0
spali	s p a lʲ i	1
spana	s p a n a	0
spane	s p a n ə	0
spany	s p a n ɨ	0
spat	s p a t	0
spał	s p a w	0
spała	s p a w a	0
spałej	s p a w e j	0
spało	s p a w ɔ	0
spašo	s p a ʃ ɔ	0
spaštej	s p a ʃ t e j	0
spašćo	s p a ɕ t ɕ ɔ	0
spi	s pʲ i	6
spica	s pʲ i t͡s a	1
spice	s pʲ i t͡s ə	0
spiju	s pʲ i j u	1
spijucy	s pʲ i j u t s ɨ	0
spim	s pʲ i m	0
spimej	s pʲ i m e j	0
spimy	s pʲ i m ɨ	0
spitej	s pʲ i t e j	0
spiwa	s pʲ i w a	2
spiwaju	s pʲ i w a j u	0
spiwam	s pʲ i w a m	0
spiwał	s pʲ i w a w	1
spiwaś	s pʲ i w a ɕ	1
spiśo	s pʲ i ɕ ɔ	0
spiš	s pʲ i ʃ	0
spižka	s pʲ i ʃ k a	0
sporta	s p ɔ r t a	1
sportam	s p ɔ r t a m	0
sprjewja	s p rʲ e vʲ a	0
srjejź	s rʲ e j ɕ	8
srjoda	s rʲ ɔ d a	0
stadle	s t a d l ə	0
staja	s t a j a	5
stajaś	s t a j a ɕ	2
stajiś	s t a j i ɕ	5
stara	s t a r a	14
stare	s t a r ə	23
starego	s t a r ɛ ɡ ɔ	12
starej	s t a r e j	6
starem	s t a r ɛ m	4
staremu	s t a r ɛ m u	0
starjejše	s t a rʲ e j ʃ ə	0
starjejšej	s t a rʲ e j ʃ e j	4
staru	s t a r u	2
starych	s t a r ɨ x	8
starym	s t a r ɨ m	7
staryma	s t a r ɨ m a	2
starymi	s t a r ɨ mʲ i	0
statny	s t a t n ɨ	10
stawizny	s t a vʲ i z n ɨ	77
stej	s t e j	170
stilist	s tʲ i lʲ i s t	0
stilistika	s tʲ i lʲ i s tʲ i k a	0
stoj	s t ɔ j	57
stole	s t ɔ l ə	0
stoł	s t o w	2
strowiś	s t r o w i ɕ	0
strowy	s t r o w ɨ	0
studowaś	s t u d ɔ w a ɕ	0
stup	s t u p	0
stupi	s t u pʲ i	0
stupiś	s t u pʲ i ɕ	0
styrjo	s t ɨ rʲ ɔ	0
su	s u	1749
suche	s u x ə	15
sudnica	s u d nʲ i t͡s a	0
sudnik	s u d nʲ i k	1
swack	s w a t s k	0
swajźba	s w a j ʑ b a	1
swak	s w a k	0
swój	s w e j	28
swójźba	s w e j ʑ b a	29
sy	s ɨ	11
sykorka	s ɨ k ɔ r k a	1
synk	s ɨ ŋ k	0
synoju	s ɨ n ɔ j u	0
syre	s ɨ r ə	7
syte	s ɨ t ə	0
syty	s ɨ t ɨ	0
sćěnje	s t͡ɕ ɪ nʲ ə	1
słaby	s w a b ɨ	1
sława	s w a w a	1
słodka	s w ɔ t k a	5
słodkim	s w ɔ t kʲ i m	0
słodkimi	s w ɔ t kʲ i mʲ i	0
słomce	s w ɔ m t͡s ə	0
słomkami	s w ɔ m k a mʲ i	0
słomki	s w ɔ m kʲ i	0
słon	s w ɔ n	0
słona	s w ɔ n a	0
słony	s w ɔ n ɨ	2
słowa	s w o w a	81
słup	s w u p	0
ta	t a	53
tam	t a m	117
tase	t a s ə	0
tasow	t a s o w	0
tasu	t a s u	0
te	t ɛ	101
tej	t e j	55
telewizor	t ɛ l ə vʲ i z ɔ r	0
ten	t ɛ n	116
terase	t ə r a s ə	0
terasu	t ɛ r a s u	0
tkaj	t k a j	1
tkali	t k a lʲ i	0
tkała	t k a w a	0
tkałej	t k a w e j	0
tkało	t k a w ɔ	0
tkaś	t k a ɕ	0
to	t ɔ	316
toboła	t ɔ b o w a	0
tobu	t ɔ b u	1
togo	t ɔ ɡ ɔ	247
tom	t ɔ m	131
tomu	t ɔ m u	43
torma	t ɔ r m a	3
tucne	t u t͡s n ə	2
tupy	t u p ɨ	0
tura	t u r a	0
turam	t u r a m	0
turami	t u r a mʲ i	0
twarjenja	t w a rʲ e nʲ a	6
twarjenje	t w a rʲ e nʲ ə	14
twój	t w e j	1
twója	t w e j a	1
ty	t ɨ	23
tych	t ɨ x	44
tym	t ɨ m	71
tyma	t ɨ m a	2
tymi	t ɨ mʲ i	8
tyźeń	t ɨ ʑ e nʲ	2
tłusty	t w u s t ɨ	5
tśmjel	t ɕ mʲ e l	2
tśmjeń	t͡ɕ mʲ e nʲ	0
tšach	t͡ʃ a x	0
tšochu	t͡ʃ ɔ x u	2
wam	w a m	7
wami	w a mʲ i	2
wari	w a rʲ i	2
waršawa	w a r ʃ a w a	3
was	w a s	15
waš	w a ʃ	1
wej	w e j	1
wence	w ɛ n t͡s ə	0
weš	w ɛ ʃ	0
widlicki	vʲ i d lʲ i t͡s kʲ i	3
witaj	vʲ i t a j	3
witali	vʲ i t a lʲ i	0
witam	vʲ i t a m	0
witamy	vʲ i t a m ɨ	0
witał	vʲ i t a w	0
witała	vʲ i t a w a	0
witało	vʲ i t a w ɔ	0
witśe	vʲ i t͡ɕ ə	0
wišnja	vʲ i ʃ nʲ a	10
wiźenje	vʲ i ʑ e nʲ ə	0
wiźeś	vʲ i ʑ e ɕ	9
wjacerja	j a t͡s ɛ rʲ a	0
wjacerja	vʲ a t͡s ɛ rʲ a	0
wjacerjaś	j a t͡s ɛ rʲ a ɕ	0
wjacerjaś	vʲ a t͡s ɛ rʲ a ɕ	0
wjapś	j a p ɕ	0
wjapś	vʲ a p ɕ	0
wjas	j a s	31
wjas	vʲ a s	31
wjasele	j a s ɛ l ə	3
wjasele	vʲ a s ɛ l ə	3
wjasoły	j a s o w ɨ	0
wjasoły	vʲ a s o w ɨ	0
wjaža	j a ʒ a	0
wjaža	vʲ a ʒ a	0
wjele	j e l ə	178
wjele	vʲ e l ə	178
wjelgin	j e l ɡʲ i n	143
wjelgin	vʲ e l ɡʲ i n	143
wjelike	j e lʲ i kʲ ə	61
wjelike	vʲ e lʲ i kʲ ə	61
wjeliki	j e lʲ i kʲ i	55
wjeliki	vʲ e lʲ i kʲ i	55
wjelk	j e l k	0
wjelk	vʲ e l k	0
wjerba	j ɛ r b a	0
wjerba	vʲ ɛ r b a	0
wobjedowali	ɔ bʲ ə d o w a lʲ i	0
wobjedował	ɔ bʲ ə d o w a w	0
wobjedowaś	ɔ bʲ ə d o w a ɕ	0
woblico	ɔ b lʲ i t͡s ɔ	3
wobraz	ɔ b r a s	8
wobrośiś	ɔ b r ɔ ɕ i ɕ	0
wogeń	ɔ ɡʲ e nʲ	8
woglěd	ɔ ɡ lʲ ɪ t	3
woglědaś	ɔ ɡ lʲ ɪ d a ɕ	1
woken	ɔ kʲ ɛ n	0
wokno	ɔ k n ɔ	3
wokoło	ɔ k o w ɔ	109
wole	ɔ l ɛ	0
wopuchnuś	ɔ p u x n u ɕ	0
wopuchowaś	ɔ p u x o w a ɕ	0
wows	o w s	4
woł	o w	2
wołaś	o w a ɕ	0
wołojnik	o w ɔ j nʲ i k	0
wrjeśeno	rʲ e ɕ ɛ n ɔ	0
wrobel	r ɔ b ɛ l	0
wroblik	r ɔ b lʲ i k	0
wron	r ɔ n	3
wrona	r ɔ n a	0
wrota	r ɔ t a	3
wucabnica	u t s a b nʲ i t s a	1
wucabnik	u t s a b nʲ i k	17
wucu	u t͡s u	0
wucuś	u t s u ɕ	0
wucyś	u t s ɨ ɕ	1
wuknica	u k nʲ i t s a	2
wuknik	u k nʲ i k	2
wuknjo	u k nʲ ɔ	3
wuknjom	u k nʲ ɔ m	0
wuknu	u k n u	1
wuknuł	u k n u w	4
wuknuś	u k n u ɕ	4
wule	u l ə	0
wulicowaś	u lʲ i t͡s o w a ɕ	2
wumje	u mʲ ə	0
wumrějom	u m rʲ e j ɔ m	0
wumrěju	u m rʲ e j u	0
wuski	u s kʲ i	4
wusmjerśiś	u s mʲ ɛ r ɕ i ɕ	1
wusmjerśowaś	u s mʲ ɛ r ɕ o w a ɕ	0
wusoki	u s ɔ kʲ i	9
wutšobnje	u t͡ʃ ɔ b nʲ ə	0
wužeńc	u ʒ ɛ nʲ t͡s	0
wódajtej	w ɛ d a j t e j	0
wódajtej	w ɨ d a j t e j	0
wódajtej	w ʊ d a j t e j	0
wódce	w ɛ t t͡s ə	0
wódce	w ɨ t t͡s ə	0
wódce	w ʊ t t͡s ə	0
wódkow	w ɛ t k o w	0
wódkow	w ɨ t k o w	0
wódkow	w ʊ t k o w	0
wójca	w e j t͡s a	1
wónej	w ɛ n e j	5
wónej	w ɨ n e j	5
wónej	w ʊ n e j	5
wósow	w ɛ s o w	1
wósow	w ɨ s o w	1
wósow	w ʊ s o w	1
wósowu	w ɛ s o w u	0
wósowu	w ɨ s o w u	0
wósowu	w ʊ s o w u	0
wósoł	w ɛ s o w	0
wósoł	w ɨ s o w	0
wósoł	w ʊ s o w	0
wóte	w ɛ t ə	4
wóte	w ɨ t ə	4
wóte	w ʊ t ə	4
wótmólowany	w ɛ t m ɛ l o w a n ɨ	0
wótmólowany	w ɨ t m ɨ l o w a n ɨ	0
wótmólowany	w ʊ t ʊ ɛ l o w a n ɨ	0
wótmólowaś	w ɛ t m ɛ l o w a ɕ	0
wótmólowaś	w ɨ t m ɨ l o w a ɕ	0
wótmólowaś	w ʊ t m ʊ l o w a ɕ	0
wěźeś	vʲ ɪ ʑ e ɕ	2
włose	w ɔ s ə	0
włoska	w ɔ s k a	0
włosy	w ɔ s ɨ	0
wšake	ʃ a kʲ ə	23
wšaki	ʃ a kʲ i	0
wšuźi	ʃ u ʑ i	7
wšykne	ʃ ɨ k n ə	59
zajmowaś	z a j m o w a ɕ	0
zajtšo	z a j t ʃ ɔ	2
zasej	z a s e j	46
zasejwiźenje	z a s e j vʲ i ʑ e nʲ ə	0
zeger	z ɛ ɡʲ ɛ r	3
zelena	z ɛ l ɛ n a	9
zeleń	z ɛ lʲ e nʲ	0
zemi	z e mʲ i	26
zemiska	z e mʲ i s k a	0
zemiskam	z e mʲ i s k a m	0
zemiski	z e mʲ i s kʲ i	0
zemisku	z e mʲ i s k u	0
zemja	z e mʲ a	11
zemju	z e mʲ u	16
zgórjelc	z ɡ ɛ rʲ e l t͡s	2
zgórjelc	z ɡ ɨ rʲ e l t͡s	2
zgórjelc	z ɡ ʊ rʲ e l t͡s	2
zmija	z mʲ i j a	0
zmije	z mʲ i j ɛ	0
zmijica	z mʲ i j i t s a	0
znamje	z n a mʲ ə	9
znaty	z n a t ɨ	26
zwěrje	z vʲ ɪ rʲ ə	19
zymny	z ɨ m n ɨ	0
zła	z w a	0
złe	z w ɛ	2
złej	z w e j	0
złemu	z w ɛ m u	0
złote	z w ɔ t ə	3
złotej	z w ɔ t e j	0
złych	z w ɨ x	2
złymi	z w ɨ mʲ i	0
česki	t ʃ e s kʲ i	6
łakomnik	w a k ɔ m nʲ i k	0
łoj	w ɔ j	0
łoje	w ɔ j ə	0
łojm	w ɔ j m	0
łojł	w ɔ j	0
łokś	w ɔ k ɕ	0
łono	w ɔ n ɔ	0
łoska	w ɔ s k a	0
łoskim	w ɔ s kʲ i m	0
łoskimi	w ɔ s kʲ i m i	0
łoź	w ɔ ɕ	2
śańki	ɕ a ŋʲ kʲ i	1
śele	ɕ e l ə	0
śepaś	ɕ ɛ p a ɕ	0
śeśko	ɕ ɛ ɕ k ɔ	0
škrjono	ʃ k rʲ ɔ n ɔ	0
štap	ʃ t a p	0
štapaś	ʃ t a p a ɕ	0
šulaŕ	ʃ u l a rʲ	0
šule	ʃ u l ə	20
šurowaś	ʃ u r o w a ɕ	0
šwigersyn	ʃ vʲ i ɡʲ ɛ r s ɨ n	0
šwigerźowka	ʃ vʲ i ɡʲ ɛ r ʑ o w k a	0
šwon	ʃ w ɔ n	4
šyja	ʃ ɨ j a	2
šyroki	ʃ ɨ r ɔ kʲ i	8
šćenje	ɕ t͡ɕ e nʲ ə	0
źeń	ʑ e nʲ	36
źiwadło	ʑ i w a d w o	3
źiśe	ʑ i ɕ ə	6
źiśecy	ʑ i ɕ ɛ t͡s ɨ	3
źomej	ʑ ɔ m e j	0
źotej	ʑ ɔ t e j	0
źowce	ʑ o w t͡s ə	0
źowka	ʑ o w k a	4
źož	ʑ ɔ ʃ	55
źurja	ʑ u rʲ a	3
źěle	ʑ ɪ l ə	46
žni	ʒ nʲ i	3
žołma	ʒ o w m a	0
žołty	ʒ o w t ɨ	6
žołź	ʒ o w ɕ	0
žrěbje	ʒ rʲ ɪ bʲ ə	0
žurnalist	ʒ u r n a lʲ i s t	1
žurnalistka	ʒ u r n a lʲ i s t k a	2
žywjenje	ʒ ɨ j ɛ nʲ ə	28
žywjenje	ʒ ɨ vʲ ɛ nʲ ə	28
žywot	ʒ ɨ w ɔ t	2
