abatyše	a b a t ɪ ʃ ɛ
ablativ	a b l a t ɪ f
abych	a b ɪ x
adamův	a d a m uː f
adaptace	a d a p t a t͡s ɛ
adheze	a d ɦ ɛ z ɛ
adoptovat	a d o p t o v a t
afrikánština	a f r ɪ k aː n ʃ c ɪ n a
afričanka	a f r ɪ t ʃ a ŋ k a
agresor	ʔ a ɡ r ɛ s ɔ r
ahoj	a ɦ o j
aji	a j ɪ
akanština	a k a n ʃ c ɪ n a
aktivum	a k t ɪ v u m
akvárium	a k v aː r ɪ j u m
akánština	a k aː n ʃ c ɪ n a
albertův	a l b ɛ r t uː f
ale	a l ɛ
alibistický	a l ɪ b ɪ s t ɪ t͡s k iː
aljaška	a l j a ʃ k a
almužna	ʔ a l m ʊ ʒ n a
alois	a l ɔ j s
alpy	a l p ɪ
alternativní	a l t ɛ r n a t ɪ v ɲ iː
americký	a m ɛ r ɪ t͡s k iː
analyticky	a n a l ɪ t ɪ t s k ɪ
ananym	a n a n ɪ m
anapest	a n a p ɛ s t
anapeste	a n a p ɛ s t ɛ
anapestech	a n a p ɛ s t ɛ x
anapestem	a n a p ɛ s t ɛ m
anapestu	a n a p ɛ s t u
anapesty	a n a p ɛ s t ɪ
anapestů	a n a p ɛ s t uː
anapestům	a n a p ɛ s t uː m
anarchismus	a n a r x ɪ z m ʊ s
anatomicky	a n a t ɔ m ɪ t s k ɪ
anděl	a n ɟ ɛ l
anebo	a n ɛ b o
anglicky	a ŋ ɡ l ɪ t͡s k ɪ
anglický	a ŋ ɡ l ɪ t͡s k iː
anglista	a ŋ ɡ l ɪ s t a
anglistika	a ŋ ɡ l ɪ s t ɪ k a
angličanka	a ŋ ɡ l ɪ t͡ʃ a ŋ k a
ani	a ɲ ɪ
ano	a n o
anonymní	a n ɔ n ɪ m ɲ iː
anýz	a n iː s
apatie	a p a t ɪ j ɛ
aplikace	ʔ a p l ɪ k a t͡s ɛ
ar	a r
arašíd	a r a ʃ iː t
architekt	a r x ɪ t ɛ k t
archo	a r x o
archy	a r x ɪ
arkebuza	a r k ɛ b ʊ z a
artefakt	a r t ɛ f a k t
artyčok	a r t ɪ t͡ʃ o k
asi	a s ɪ
astat	a s t a t
astroložka	ʔ a s t r ɔ l ɔ ʃ k a
atypický	a t ɪ p ɪ t s k iː
auto	a ʊ̯ t ɔ
autobus	a u̯ t o b u s
autobusový	a u̯ t o b u s o v iː
automatický	a u̯ t o m a t ɪ t͡s k iː
automobil	a u̯ t o m o b ɪ l
automobilový	a u̯ t o m o b ɪ l o v iː
autoškola	a ʊ̯ t ɔ ʃ k ɔ l a
avokádo	a v o k aː d o
ač	a t ʃ
až	a ʃ
b	b eː
baba	b a b a
babička	b a b ɪ t͡ʃ k a
babou	b a b ɔ u
babrat	b a b r a t
backa	b ɛ k a
backy	b ɛ k ɪ
bagatelizovat	b a ɡ a t ɛ l ɪ z o v a t
bageta	b a ɡ ɛ t a
bagr	b a ɡ r̩
baklažán	b a k l a ʒ aː n
balista	b a l ɪ s t a
balit	b a l ɪ t
balík	b a l iː k
balíček	b a l iː t͡ʃ ɛ k
bankomat	b a ŋ k o m a t
bankovka	b a ŋ k o v k a
bar	b a r
barbeta	b a r b ɛ t a
bare	b a r ɛ
barem	b a r ɛ m
barmanka	b a r m a ŋ k a
baru	b a r u
barů	b a r uː
basa	b a s a
basketbal	b a s k ɛ t b a l
bavit	b a v ɪ t
bazalka	b a z a l k a
bazén	b a z ɛː n
bašta	b a ʃ t a
beci	b ɛ t͡s ɪ
bedel	b ɛ d e l
beden	b ɛ d ɛ n
bedla	b ɛ d l a
bedlový	b ɛ d l o v iː
bedna	b ɛ d n a
bedno	b ɛ d n o
bek	b ɛ k
beka	b ɛ k a
bekovi	b ɛ k o v ɪ
beku	b ɛ k u
benešův	b ɛ n ɛ ʃ uː f
beranidlo	b ɛ r a ɲ ɪ d l ɔ
berlička	b ɛ r l ɪ t͡ʃ k a
beruška	b ɛ r ʊ ʃ k a
beránek	b ɛ r aː n ɛ k
betlém	b ɛ t l ɛː m
bez	b ɛ s
bezcelní	b ɛ s t͡s ɛ l ɲ iː
bezdětný	b ɛ z ɟ ɛ t n iː
beze	b ɛ z ɛ
beznadějný	b ɛ z n a ɟ ɛ j n iː
bezpečný	b ɛ z p ɛ t ʃ n iː
bezpečí	b ɛ s p ɛ t ʃ iː
bezplatný	b ɛ s p l a t n iː
bil	b ɪ l
bilo	b ɪ l o
binárka	b ɪ n aː r k a
bitový	b ɪ t o v ɪː
bizon	b ɪ z o n
bizony	b ɪ z o n ɪ
blamáž	b l a m aː ʃ
blatník	b l a t ɲ iː k
blbec	b l̩ b ɛ t͡s
blbeček	b l̩ b ɛ t͡ʃ ɛ k
blbina	b l̩ b ɪ n a
blbost	b l̩ b ɔ s t
blbý	b l̩ b iː
blok	b l ɔ k
blízký	b l iː s k iː
bobule	b ɔ b u l ɛ
bode	b o d ɛ
bodem	b o d ɛ m
bodlák	b o d l aː k
bodu	b o d u
body	b o d ɪ
bodě	b o ɟ ɛ
bohatý	b o ɦ a t iː
bojkot	b ɔ j k ɔ t
bojovat	b o j o v a t
bolek	b o l ɛ k
bolest	b o l ɛ s t
bolet	b o l ɛ t
boleti	b o l ɛ c ɪ
bologna	b o l o ɲ a
boltcovitka	b o l t t͡s o v ɪ t k a
boltcovitka	b o l t͡s o v ɪ t k a
boltcovitkotvaré	b o l t͡s o v ɪ t k o t v a r ɛː
boltcovitkovité	b o l t͡s o v ɪ t k o v ɪ t ɛː
bombarda	b ɔ m b a r d a
bonzák	b o n z aː k
bore	b o r ɛ
bore	b oː r ɛ
borech	b o r ɛ x
borech	b oː r ɛ x
borem	b o r ɛ m
borem	b oː r ɛ m
boroví	b o r o v iː
borový	b o r o v iː
borový	b oː r o v iː
borte	b o r t ɛ
bortech	b o r t ɛ x
bortem	b o r t ɛ m
bortu	b o r t u
borty	b o r t ɪ
bortě	b o r c ɛ
bortů	b o r t uː
bortům	b o r t uː m
bory	b o r ɪ
bory	b oː r ɪ
borůvka	b o r uː v k a
bota	b o t a
botanicky	b ɔ t a n ɪ t s k ɪ
boční	b o t͡ʃ ɲ iː
bože	b ɔ ʒ ɛ
brambor	b r a m b o r
bramborový	b r a m b o r o v iː
brankoviště	b r a n k o v ɪ ʃ c ɛ
braní	b r a ɲ iː
bratranec	b r a t r a n ɛ t͡s
brigandýna	b r̩ ɪ ɡ a n d iː n a
brigantina	b r̩ ɪ ɡ a n t ɪ n a
brk	b r̩ k
brno	b r̩ n ɔ
brode	b r o d ɛ
brodech	b r o d ɛ x
brodem	b r o d ɛ m
brodit	b r o ɟ ɪ t
brodu	b r o d u
brody	b r o d ɪ
brodě	b r o ɟ ɛ
brodů	b r o d uː
brodům	b r o d uː m
brokolice	b r o k o l ɪ t͡s ɛ
brokovnice	b r ɔ k ɔ v ɲ ɪ t s ɛ
bronchitida	b r o n x ɪ t ɪ d a
bronchitida	b r o ŋ x ɪ t iː d a
brontosaurus	b r ɔ n t ɔ s a ʊ̯ r ʊ s
bronzový	b r o n z o v iː
brouzdaliště	b r ɔ ʊ̯ z d a l ɪ ʃ c ɛ
brouček	b r ɔ ʊ̯ t͡ʃ ɛ k
bruneta	b r ʊ n ɛ t a
brusinka	b r u s ɪ ŋ k a
bruslař	b r ʊ s l a r̝̊
brutální	b r ʊ t aː l ɲ iː
brána	b r aː n a
brýle	b r iː l ɛ
buchta	b u x t a
budiž	b ʊ ɟ ɪ ʃ
budova	b u d o v a
budí	b u ɟ iː
budě	b u ɟ ɛ
buk	b u k
buldok	b ʊ l d ɔ k
bunda	b u n d a
burčák	b u r t͡ʃ aː k
buď	b u c
bych	b ɪ x
bychom	b ɪ x o m
bydliště	b ɪ d l ɪ ʃ c ɛ
byl	b ɪ l
bys	b ɪ s
byste	b ɪ x o m
bystrý	b ɪ s t r iː
byt	b ɪ t
byteček	b ɪ t ɛ t͡ʃ ɛ k
bába	b aː b a
bábovka	b aː b o v k a
báj	b aː j
bál	b aː l
bárka	b aː r k a
báseň	b aː s ɛ ɲ
bát	b aː t
bázlivý	b aː z l ɪ v iː
bída	b iː d a
bídami	b iː d a m ɪ
bído	b iː d o
bídou	b iː d o ʊ̯
bídu	b iː d u
bídy	b iː d ɪ
bídách	b iː d aː x
bídám	b iː d aː m
bídě	b iː ɟ ɛ
bórami	b oː r a m ɪ
bóre	b oː r ɛ
bórech	b oː r ɛ x
bórem	b oː r ɛ m
bóro	b oː r o
bórou	b oː r o ʊ̯
bóry	b oː r ɪ
bórách	b oː r aː x
bórám	b oː r aː m
býk	b iː k
bývalý	b iː v a l iː
bývat	b iː v a t
běd	b j ɛ t
běda	b j ɛ d a
bědami	b j ɛ d a m ɪ
bědo	b j ɛ d o
bědou	b j ɛ d o ʊ̯
bědu	b j ɛ d u
bědy	b j ɛ d ɪ
bědách	b j ɛ d aː x
bědám	b j ɛ d aː m
bědě	b j ɛː ɟ ɛ
běh	b j ɛ x
během	b j ɛ ɦ ɛ m
běloba	b j ɛ l ɔ b a
bělovlnný	b j ɛ l o v l̩ n iː
bělásek	b j ɛ l aː s ɛ k
běžet	b j ɛ ʒ ɛ t
březen	b r̝ ɛ z ɛ n
břichatka	b r̝ ɪ x a t k a
břichatkovité	b r̝ ɪ x a t k o v ɪ t ɛː
břichatky	b r̝ ɪ x a t k ɪ
celer	t͡s ɛ l ɛ r
celnice	t͡s ɛ l ɲ ɪ t͡s ɛ
celozrnný	t͡s ɛ l o z r nː iː
celý	t͡s ɛ l iː
cer	t s ɛː r
cesium	t s ɛː z ɪ j ʊ m
cest	t͡s ɛ s t
cestovat	t͡s ɛ s t o v a t
cestovní	t͡s ɛ s t o v ɲ iː
chcanky	x t s a ŋ k ɪ
cheb	x ɛ p
chemie	x ɛ m ɪ j ɛ
chemik	x ɛ m ɪ k
chiropterolog	x ɪ r o p t ɛ r o l o k
chladno	x l a d n o
chlapec	x l a p ɛ t͡s
chléb	x l ɛː p
chlór	x l oː r
chod	x o t
chodec	x o d ɛ t͡s
chodník	x ɔ d ɲ iː k
chodníček	x ɔ d ɲ iː t͡ʃ ɛ k
choroba	x ɔ r ɔ b a
chovat	x ɔ v a t
chroust	x r o u̯ s t
chrpa	x r̩ p a
chrup	x r u p
chudoba	x ʊ d ɔ b a
chudáček	x ʊ d aː t͡ʃ ɛ k
chudý	x u d iː
chutnat	x u t n a t
chyba	x ɪ b a
chybit	x ɪ b ɪ t
chybět	x ɪ b j ɛ t
chytrák	x ɪ t r aː k
chytrý	x ɪ t r iː
chápat	x aː p a t
chápeš	x aː p ɛ ʃ
cikánština	t s ɪ k aː n ʃ c ɪ n a
citron	t͡s ɪ t r o n
cizinec	t͡s ɪ z ɪ n ɛ t͡s
cizinka	t͡s ɪ z ɪ ŋ k a
cizí	t͡s ɪ z iː
clintonovou	k l ɪ n t ɔ n ɔ v ɔ ʊ̯
clintonová	k l ɪ n t n ɔ v aː
clintonová	k l ɪ n t ɔ n ɔ v aː
clintonovými	k l ɪ n t ɔ n ɔ v iː m ɪ
co	t͡s o
ctirad	t s c ɪ r a t
ctí	t͡s c iː
cuketa	t͡s u k ɛ t a
cukrárna	t͡s u k r aː r n a
cvakat	t s v a k a t
cvičiště	t͡s v ɪ t͡ʃ ɪ ʃ c ɛ
cyklista	t͡s ɪ k l ɪ s t a
cíl	t͡s iː l
cín	t s iː n
cítit	t͡s iː c ɪ t
dala	d a l a
daleko	d a l ɛ k o
další	d a l ʃ iː
dan	d a n
dana	d a n a
dane	d a n ɛ
danech	d a n ɛ x
danem	d a n ɛ m
dani	d a ɲ ɪ
danovi	d a n o v ɪ
danové	d a n o v ɛː
danu	d a n u
dany	d a n ɪ
danům	d a n uː m
dar	d a r
darwinův	d a r v ɪ n uː f
datla	d a t l a
datle	d a t l ɛ
datlech	d a t l ɛ x
datlem	d a t l ɛ m
datlemi	d a t l ɛ m ɪ
datli	d a t l ɪ
datlit	d a t l ɪ t
datlovat	d a t l o v a t
datlovi	d a t l o v ɪ
datlové	d a t l o v ɛː
datlu	d a t l u
datly	d a t l ɪ
datlí	d a t l iː
datlích	d a t l iː x
datlím	d a t l iː m
datlů	d a t l uː
datlům	d a t l uː m
davidův	d a v ɪ d uː f
daň	d a ɲ
debř	d e b r̝
definice	d ɛ f ɪ n ɪ t͡s ɛ
defraudace	d ɛ f r a ʊ̯ d a t͡s ɛ
dehet	d ɛ ɦ ɛ t
deklinace	d ɛ k l ɪ n a t s ɛ
delegace	d ɛ l ɛ ɡ a t͡s ɛ
delt	d ɛ l t
deltami	d ɛ l t a m ɪ
delto	d ɛ l t o
deltou	d ɛ l t o ʊ̯
deltu	d ɛ l t u
delty	d ɛ l t ɪ
deltách	d ɛ l t aː x
deltám	d ɛ l t aː m
den	d ɛ n
deska	d ɛ s k a
desítka	d ɛ s iː t k a
dluh	d l u x
dnami	d n a m ɪ
dnech	d n ɛ x
dnem	d n ɛ m
dnes	d n ɛ s
dnou	d n o ʊ̯
dnové	d n o v ɛː
dnu	d n u
dny	d n ɪ
dnách	d n aː x
dnů	d n uː
dnům	d n uː m
do	d o
doba	d o b a
dobami	d o b a m ɪ
dobou	d o b o ʊ̯
dobra	d o b r a
dobrat	d o b r a t
dobrech	d o b r ɛ x
dobrem	d o b r ɛ m
dobrodruh	d ɔ b r ɔ d r ʊ x
dobru	d o b r u
dobrácky	d ɔ b r aː t s k ɪ
dobrům	d o b r uː m
doby	d o b ɪ
dobách	d o b aː x
dobám	d o b aː m
dobýt	d ɔ b iː t
době	d o b j ɛ
dobře	d o b r̝ ɛ
docházet	d o x aː z ɛ t
dohromady	d o ɦ r o m a d ɪ
dokazovat	d o k a z o v a t
doklad	d ɔ k l a t
dokonce	d ɔ k ɔ ŋ t s ɛ
dokázat	d o k aː z a t
dolet	d o l ɛ t
doleva	d o l ɛ v a
dolní	d o l ɲ iː
doma	d o m a
domácí	d o m aː t͡s iː
domů	d o m uː
don	d o n
dona	d o n a
done	d o n ɛ
donech	d o n ɛ x
donem	d o n ɛ m
dono	d o n o
donou	d o n o ʊ̯
donovi	d o n o v ɪ
donové	d o n o v ɛː
donu	d o n u
dony	d o n ɪ
donách	d o n aː x
donám	d o n aː m
doně	d o ɲ ɛ
donů	d o n uː
donům	d o n uː m
dopis	d o p ɪ s
doporučit	d o p o r u t͡ʃ ɪ t
doporučovat	d o p o r u t͡ʃ o v a t
doprava	d o p r a v a
dopravce	d ɔ p r a f t͡s ɛ
dopravní	d o p r a v ɲ iː
dost	d o s t
dostat	d o s t a t
dostávat	d o s t aː v a t
dotknout	d o t k n o u̯ t
dotýkat	d o t iː k a t
dovča	d ɔ f t͡ʃ a
dragoun	d r a ɡ o ʊ̯ n
dražba	d r a ʒ b a
drek	d r e k
driblovat	d r ɪ b l ɔ v a t
droba	d r o b a
drobami	d r o b a m ɪ
drobech	d r o b ɛ x
drobit	d r o b ɪ t
drobo	d r o b o
drobou	d r o b o ʊ̯
drobu	d r o b u
droby	d r o b ɪ
drobách	d r o b aː x
drobám	d r o b aː m
drobě	d r o b j ɛ
drobů	d r o b uː
drobům	d r o b uː m
drogerie	d r o ɡ ɛ r ɪ j ɛ
drope	d r o p ɛ
dropech	d r o p ɛ x
dropem	d r o p ɛ m
dropi	d r o p ɪ
dropovi	d r o p o v ɪ
dropové	d r o p o v ɛː
dropu	d r o p u
dropy	d r o p ɪ
dropů	d r o p uː
dropům	d r o p uː m
druhořadník	d r u ɦ o r̝ a d ɲ iː k
drůbež	d r uː b ɛ ʃ
država	d r̩ ʒ a v a
držet	d r̩ ʒ ɛ t
duben	d u b ɛ n
duch	d u x
dud	d u t
dudy	d u d ɪ
duha	d u ɦ a
duna	d u n a
dup	d u p
dutý	d u t iː
dvakrát	d v a k r aː t
dveře	d v ɛ r̝ ɛ
dvořák	d v o r̝ aː k
dál	d aː l
dálnice	d aː l ɲ ɪ t͡s ɛ
dám	d aː m
dánech	d aː n ɛ x
dáni	d aː ɲ ɪ
dánové	d aː n o v ɛː
dánsko	d aː n s k o
dárek	d aː r ɛ k
dárky	d aː r k ɪ
délka	d ɛː l k a
dýchat	d iː x a t
dým	d iː m
dědeček	ɟ ɛ d ɛ t͡ʃ ɛ k
dědic	ɟ ɛ ɟ ɪ t͡s
děj	ɟ ɛ j
dějepis	ɟ ɛ j ɛ p ɪ s
děkovat	ɟ ɛ k o v a t
dělba	ɟ ɛ l b a
děláš	ɟ ɛ l aː ʃ
děti	ɟ ɛ c ɪ
děvče	ɟ ɛ f t͡ʃ ɛ
děvčátko	ɟ ɛ f t͡ʃ aː t k o
dřevo	d r̝ ɛ v ɔ
dřeň	d r̝ ɛ ɲ
dřík	d r̝ iː k
důležitý	d uː l ɛ ʒ ɪ t iː
důstojník	d uː s t o j ɲ iː k
džíny	d͡ʒ iː n ɪ
ebonit	ɛ b o n ɪ t
echo	ɛ x o
eda	ɛ d a
edém	ɛ d ɛː m
ego	ɛ ɡ o
ekonom	ɛ k o n o m
elektron	ɛ l ɛ k t r ɔ n
elektrárna	ɛ l ɛ k t r aː r n a
eliška	ɛ l ɪ ʃ k a
energie	ɛ n ɛ r ɡ ɪ j ɛ
esa	ɛ s a
esemeska	ɛ s ɛ m ɛ s k a
esesák	ˀɛ s ɛ s aː k
eso	ɛ s ɔ
esu	ɛ s u
esy	ɛ s ɪ
eva	ʔ ɛ v a
ezofagitida	ʔ ɛ z ɔ f a ɡ ɪ t ɪ d a
fakulta	f a k ʊ l t a
fanoušek	f a n ɔ ʊ̯ ʃ ɛ k
fantasie	f a n t a z ɪ j e
fanynka	f a n ɪ ŋ k a
farao	f a r a o
farní	f a r ɲ iː
faul	f a u̯ l
fazole	f a z o l ɛ
fašistický	f a ʃ ɪ s t ɪ t͡s k iː
fenek	f ɛ n ɛ k
fenykl	f ɛ n ɪ k l̩
fetiš	f ɛ t ɪ ʃ
fez	f ɛ s
film	f ɪ l m
firma	f ɪ r m a
fleret	f l ɛ r ɛ t
flundra	f l u n d r a
forem	f o r ɛ m
formami	f o r m a m ɪ
formo	f o r m o
formou	f o r m o ʊ̯
formu	f o r m u
formy	f o r m ɪ
formách	f o r m aː x
formám	f o r m aː m
formě	f o r m ɲ ɛ
forward	f o r v a r t
fotbal	f o d b a l
fotbalový	f o d b a l o v iː
fotografa	f o t o ɡ r a f a
fotografu	f o t o ɡ r a f u
františek	f r a n c ɪ ʃ ɛ k
františka	f r a n c ɪ ʃ k a
frekvence	f r ɛ k v ɛ n t͡s ɛ
frigidita	f r ɪ ɡ ɪ d ɪ t a
fuj	f u j
fungovat	f u ŋ ɡ o v a t
fyzika	f ɪ z ɪ k a
fám	f aː m
fér	f ɛː r
fórech	f oː r ɛ x
fórem	f oː r ɛ m
fórum	f oː r u m
fóry	f oː r ɪ
fórů	f oː r uː
fórům	f oː r uː m
galerie	ɡ a l ɛ r ɪ j ɛ
gejzír	ɡ ɛ j z iː r
geologie	ɡ ɛ ɔ l ɔ ɡ ɪ ɛ
germanistika	ɡ ɛ r m a n ɪ s t ɪ k a
germánský	ɡ ɛ r m aː n s k iː
gestapák	ɡ ɛ s t a p aː k
golf	ɡ ɔ l f
golfista	ɡ ɔ l f ɪ s t a
golfistka	ɡ ɔ l f ɪ s t k a
grín	ɡ r iː n
grýn	ɡ r iː n
gum	ɡ u m
guma	ɡ u m a
gumma	ɡ u m a
gummata	ɡ u m a t a
gumu	ɡ u m u
gymnastický	ɡ ɪ m n a s t ɪ t͡s k iː
gól	ɡ oː l
h	h aː
hacník	ɦ a t͡s ɲ iː k
hadrosaurus	ɦ a d r ɔ s a ʊ̯ r ʊ s
harfa	ɦ a r f a
hazard	ɦ a z a r t
hedvábí	ɦ ɛ d v aː b iː
herec	ɦ ɛ r ɛ t͡s
herní	ɦ ɛ r ɲ iː
hezký	ɦ ɛ s k iː
hezoun	ɦ ɛ z o u̯ n
hit	h ɪ t
hlad	ɦ l a t
hlava	ɦ l a v a
hlavička	ɦ l a v ɪ t ʃ k a
hledat	ɦ l ɛ d a t
hloubka	ɦ l ɔ ʊ̯ p k a
hloupý	ɦ l o u̯ p iː
hlubokomořský	ɦ l u b o k o m o r̝̊ s k iː
hluboký	ɦ l u b o k iː
hlupáček	ɦ l ʊ p aː t͡ʃ ɛ k
hlíva	ɦ l iː v a
hlíza	ɦ l iː z a
hmota	ɦ m ɔ t a
hmotař	ɦ m ɔ t a r̝̊
hmotnost	ɦ m o t n o s t
hmotný	ɦ m ɔ t n iː
hnidopich	h ɲ ɪ d o p ɪ x
hniloba	ɦ ɲ ɪ l ɔ b a
hnědý	ɦ ɲ ɛ d iː
hněv	ɦ ɲ ɛ f
hoboj	ɦ ɔ b ɔ j
hochštapler	ɦ ɔ x ʃ t a p l ɛ r
hod	ɦ o t
hodina	ɦ o ɟ ɪ n a
hodiny	ɦ o ɟ ɪ n ɪ
hodit	ɦ o ɟ ɪ t
hodně	ɦ o d ɲ ɛ
hokej	ɦ o k ɛ j
holek	ɦ o l ɛ k
holeň	h ɔ l ɛ ɲ
holka	ɦ o l k a
holomouc	h o l o m o u̯ t͡s
holínka	ɦ o l iː ŋ k a
holínky	ɦ o l iː ŋ k ɪ
holý	ɦ o l iː
honba	ɦ ɔ n b a
hora	ɦ o r a
horko	ɦ o r k o
horký	ɦ o r k iː
hornictví	ɦ ɔ r ɲ ɪ t s t v iː
hornina	ɦ ɔ r ɲ ɪ n a
horní	ɦ o r ɲ iː
horoskop	ɦ o r o s k o p
hospoda	ɦ o s p o d a
hotel	ɦ o t ɛ l
houba	ɦ o ʊ̯ b a
houbami	ɦ o ʊ̯ b a m ɪ
houbařský	ɦ ɔ ʊ̯ b a r̝̊ s k iː
houbo	ɦ o ʊ̯ b o
houbou	ɦ o ʊ̯ b o ʊ̯
houbu	ɦ o ʊ̯ b u
houby	ɦ o ʊ̯ b ɪ
houbách	ɦ o ʊ̯ b aː x
houbám	ɦ o ʊ̯ b aː m
houbě	ɦ o ʊ̯ b j ɛ
houska	ɦ o u̯ s k a
housle	ɦ o u̯ s l ɛ
housličky	ɦ o u̯ s l ɪ t͡ʃ k ɪ
hovor	ɦ o v o r
hovězí	ɦ o v j ɛ z iː
hoření	ɦ ɔ r̝ ɛ ɲ iː
hra	ɦ r a
hraniční	ɦ r a ɲ ɪ t͡ʃ ɲ iː
hrobař	ɦ r ɔ b a r̝̊
hroch	ɦ r o x
hrozba	ɦ r ɔ z b a
hrtan	ɦ r̩ t a n
hrubě	ɦ r ʊ b j ɛ
hrávat	ɦ r aː v a t
hub	ɦ u p
huba	ɦ u b a
hubeňour	ɦ ʊ b ɛ ɲ ɔ ʊ̯ r
hubo	ɦ u b o
hudba	ɦ u d b a
hup	ɦ u p
huspenitý	h u s p ɛ ɲ ɪ t iː
hvězdárna	ɦ v j ɛ z d aː r n a
hymna	ɦ ɪ m n a
háj	ɦ aː j
hák	ɦ aː k
háčky	ɦ aː t͡ʃ k ɪ
hřeben	ɦ r̝ ɛ b ɛ n
hřebíček	ɦ r̝ ɛ b iː t͡ʃ ɛ k
hřib	ɦ r̝ ɪ p
hřiště	ɦ r̝ ɪ ʃ c ɛ
hřích	ɦ r̝ iː x
hříva	ɦ r̝ iː v a
hříšník	ɦ r̝ iː ʃ ɲ iː k
hůl	ɦ uː l
ibišek	ɪ b ɪ ʃ ɛ k
idea	ɪ d ɛ a
ilustrace	ʔ ɪ l ʊ s t r a t͡s ɛ
iluze	ʔ ɪ l ʊ z ɛ
imunita	ʔ ɪ m ʊ n ɪ t a
ind	ɪ n t
inde	ɪ n d ɛ
indián	ɪ n d ɪ j aː n
indka	ɪ n t k a
indonésie	ɪ n d o n ɛː s ɪ j ɛ
indonéština	ɪ n d o n ɛː ʃ c ɪ n a
indy	ɪ n d ɪ
infantilní	ɪ n f a n t ɪ l ɲ iː
infarkt	ɪ n f a r k t
inflamatorní	ʔ ɪ n f l a m a t o r ɲ iː
informace	ɪ n f o r m a t͡s ɛ
inspirace	ʔ ɪ n s p ɪ r a t͡s ɛ
inženýr	ɪ n ʒ ɛ n iː r
islamizace	ɪ s l a m ɪ z a t͡s ɛ
jaderný	j a d ɛ r n iː
jahoda	j a ɦ o d a
jak	j a k
jakmile	j a k m ɪ l ɛ
jako	j a k o
jakoby	j a k o b ɪ
jaký	j a k iː
japonce	j a p o n t͡s ɛ
japonka	j a p o ŋ k a
japonkami	j a p o ŋ k a m ɪ
japonko	j a p o ŋ k o
japonkou	j a p o ŋ k o u̯
japonku	j a p o ŋ k u
japonky	j a p o ŋ k ɪ
japonkách	j a p o ŋ k aː x
japonkám	j a p o ŋ k aː m
jarní	j a r ɲ iː
jaro	j a r o
jas	j a s
javor	j a v o r
jda	j d a
jdeš	d ɛ ʃ
jdeš	j d ɛ ʃ
jdouc	j d o ʊ̯ t͡s
jdouce	j d o ʊ̯ t͡s ɛ
jdu	d u
jdu	j d u
jebat	j ɛ b a t
jed	j ɛ t
jediný	j ɛ ɟ ɪ n iː
jednoaktovka	j ɛ d n o a k t o f k a
jednodolarovka	j ɛ d n o d o l a r o f k a
jednooký	j ɛ d n o ʔ o k iː
jednotka	j ɛ d n o t k a
jednou	j ɛ d n o u̯
jehněčí	j ɛ ɦ ɲ ɛ t͡ʃ iː
jeho	j ɛ ɦ o
její	j ɛ j iː
jelen	j ɛ l ɛ n
jeleni	j ɛ l ɛ ɲ ɪ
jelenka	j ɛ l ɛ ŋ k a
jenž	j ɛ n ʃ
jeptiška	j ɛ p c ɪ ʃ k a
jesle	j ɛ s l ɛ
jestli	j ɛ s t l ɪ
jet	j ɛ t
jev	j ɛ v
jeviště	j ɛ v ɪ ʃ c ɛ
jezdit	j ɛ z ɟ ɪ t
jezero	j ɛ z ɛ r o
jho	j ɦ o
jidášovi	j ɪ d aː ʃ o v ɪ
jih	j ɪ x
jinam	j ɪ n a m
jinde	j ɪ n d ɛ
jindřiška	j ɪ n d r̝ ɪ ʃ k a
jinudy	j ɪ n ʊ d ɪ
jiný	j ɪ n iː
jizva	ɪ̯ ɪ z v a
jižní	j ɪ ʒ ɲ iː
jmenovat	j m ɛ n o v a t
jméno	j m ɛː n o
jogurt	j o x œ r t
jogurt	j o ɡ u r t
jolek	j o l ɛ k
jseš	j s ɛ ʃ
jsu	s u
jurčík	j u r t ʃ iː k
jáchym	j aː x ɪ m
jí	j iː
jídlo	j iː d l o
jít	j iː t
jízda	j iː z d a
jízdenka	j iː z d ɛ ŋ k a
jízdné	j iː z d n ɛː
jízdní	j iː z d ɲ iː
kabel	k a b ɛ l
kafrat	k a f r a t
kajuta	k a j u t a
kalhotky	k a l ɦ ɔ t k ɪ
kalhoty	k a l ɦ o t ɪ
kalifornium	k a l ɪ f o r n ɪ j ʊ m
kališník	k a l ɪ ʃ ɲ iː k
kalk	k a l k
kam	k a m
kamarád	k a m a r aː t
kamarádka	k a m a r aː t k a
kamenný	k a m ɛ n iː
kamer	k a m ɛ r
kamera	k a m ɛ r a
kamero	k a m ɛ r o
kameru	k a m ɛ r ʊ
kancelář	k a n t͡s ɛ l aː r̝̊
kanec	k a n ɛ t͡s
kapitán	k a p ɪ t aː n
kapusta	k a p u s t a
kari	k a r ɪ
karta	k a r t a
kas	k a s
kateder	k a t ɛ d ɛ r
katedra	k a t ɛ d r a
katolička	k a t ɔ l ɪ t ʃ k a
kaviár	k a v ɪ j aː r
kavárna	k a v aː r n a
kaz	k a s
kaštan	k a ʃ t a n
kašubština	k a ʃ ʊ p ʃ c ɪ n a
každoroční	k a ʒ d ɔ r ɔ t ʃ ɲ iː
každoročně	k a ʒ d ɔ r ɔ t ʃ ɲ ɛ
kde	ɡ d ɛ
kdekoli	ɡ d ɛ k o l ɪ
kdežto	ɡ d ɛ ʃ t o
kdo	ɡ d o
kdy	ɡ d ɪ
kdyby	ɡ d ɪ b ɪ
když	ɡ d ɪ ʃ
kenotaf	k ɛ n ɔ t a f
ker	k ɛ r
kečup	k ɛ t͡ʃ u p
keňa	k ɛ ɲ a
kilometr	k ɪ l o m ɛ t r̩
kino	k ɪ n o
kiwi	k ɪ v ɪ
klad	k l a t
klade	k l a d ɛ
klasický	k l a s ɪ t͡s k iː
klenotník	k l ɛ n ɔ t ɲ iː k
klimatizace	k l ɪ m a t ɪ z a t͡s ɛ
kluziště	k l ʊ z ɪ ʃ c ɛ
kmín	k m iː n
knedlík	k n ɛ d l iː k
knihovna	k ɲ ɪ ɦ o v n a
knír	k ɲ iː r
kobliha	k o b l ɪ ɦ a
kobra	k ɔ b r a
koherence	k ɔ ɦ ɛ r ɛ n t͡s ɛ
koheze	k ɔ ɦ ɛ z ɛ
kojot	k o j o t
kokos	k o k o s
kokot	k o k o t
koks	k ɔ k s
kolaudace	k ɔ l a ʊ̯ d a t͡s ɛ
kolega	k o l ɛ ɡ a
kolegyně	k o l ɛ ɡ ɪ ɲ ɛ
kolej	k o l ɛ j
kolek	k o l ɛ k
koleno	k o l ɛ n o
kolik	k o l ɪ k
kolikátý	k ɔ l ɪ k aː t iː
kolo	k o l o
koláč	k o l aː t͡ʃ
komparace	k o m p a r a t͡s ɛ
kompatriot	k ɔ m p a t r ɪʲ ɔ t
koncern	k o n t͡s ɛ r n
koncernu	k o n t͡s ɛ r n u
konec	k o n ɛ t͡s
konečně	k o n ɛ t͡ʃ ɲ ɛ
konfese	k ɔ n f ɛ s ɛ
kontext	k ɔ n t ɛ k s t
kontraband	k ɔ n t r a b a n t
kontrola	k o n t r o l a
konvalinka	k o n v a l ɪ ŋ k a
končit	k o n t͡ʃ ɪ t
kopec	k o p ɛ t͡s
kopecká	k o p ɛ t͡s k aː
kopeček	k o p ɛ t͡ʃ ɛ k
kopretina	k o p r ɛ c ɪ n a
kopu	k ɔ p ʊ
kopátko	k ɔ p aː t k ɔ
kopáč	k o p aː t͡ʃ
korb	k oː r b
kord	k ɔ r t
korea	k o r e a
koriandr	k o r ɪ j a n d r̩
koruna	k o r u n a
kosatka	k ɔ s a t k a
kosi	k o s ɪ
kostel	k o s t ɛ l
kotviště	k ɔ t v ɪ ʃ c ɛ
kotě	k o c ɛ
koukat	k ɔ ʊ̯ k a t
koule	k o ʊ̯ l ɛ
koupaliště	k ɔ ʊ̯ p a l ɪ ʃ c ɛ
kouřit	k o u̯ r̝ ɪ t
kov	k o v
kování	k ɔ v aː ɲ iː
koza	k o z a
kozami	k o z a m ɪ
koze	k o z ɛ
kozo	k o z o
kozou	k o z o u̯
kozu	k o z u
kozy	k o z ɪ
kozách	k o z aː x
kozám	k o z aː m
kočce	k o t͡ʃ t͡s ɛ
koček	k o t͡ʃ ɛ k
kočko	k o t͡ʃ k o
kočkou	k o t͡ʃ k o ʊ̯
kočku	k o t͡ʃ k u
kočky	k o t͡ʃ k ɪ
kočkách	k o t͡ʃ k aː x
kočkám	k o t͡ʃ k aː m
koření	k o r̝ ɛ ɲ iː
košár	k o ʃ aː r
kra	k r a
krab	k r a p
kradete	k r a d ɛ t ɛ
kraj	k r a j
kravata	k r a v a t a
krb	k r̩ p
kresba	k r ɛ z b a
kreveta	k r ɛ v ɛ t a
krise	k r ɪ z ɛ
kritik	k r ɪ t ɪ k
krkatý	k r k a t iː
krokodýl	k r o k o d iː l
kromě	k r o m ɲ ɛ
kroupa	k r o ʊ̯ p a
kroupami	k r o ʊ̯ p a m ɪ
kroupo	k r o ʊ̯ p o
kroupou	k r o ʊ̯ p o ʊ̯
kroupu	k r o ʊ̯ p u
kroupy	k r o ʊ̯ p ɪ
kroupách	k r o ʊ̯ p aː x
kroupám	k r o ʊ̯ p aː m
kroupě	k r o ʊ̯ p j ɛ
kroužek	k r o u̯ ʒ ɛ k
kroužky	k r o u̯ ʒ k ɪ
krtek	k r̩ t ɛ k
kruh	k r u x
kruhový	k r u ɦ o v iː
kruhy	k r u ɦ ɪ
krup	k r u p
krysař	k r ɪ s a r̝̊
kryt	k r ɪ t
králík	k r aː l iː k
krásný	k r aː s n iː
krásti	k r aː s c ɪ
krát	k r aː t
krátký	k r aː t k iː
krém	k r ɛː m
který	k t ɛ r iː
kuchař	k ʊ x a r̝̊
kuchyně	k u x ɪ ɲ ɛ
kudy	k ʊ d ɪ
kufr	k u f r̩
kukuřice	k u k u r̝ ɪ t͡s ɛ
kultura	k u l t u r a
kunda	k u n d a
kure	k u r ɛ
kurkuma	k u r k u m a
kuru	k u r u
kuř	k ʊ r̝̊
kuřačka	k ʊ r̝ a t͡ʃ k a
kuřák	k ʊ r̝ aː k
kuše	k ʊ ʃ ɛ
kverulant	k v ɛ r ʊ l a n t
květák	k v j ɛ t aː k
kvůli	k v uː l ɪ
kybernetika	k ɪ b ɛ r n ɛ t ɪ k a
kyslík	k ɪ s l iː k
kámen	k aː m ɛ n
káva	k aː v a
káď	k aː c
kéž	k ɛː ʃ
kód	k oː t
kór	k ɔː r
kře	k r̝̊ ɛ
křehký	k r̝̊ ɛ x k iː
křen	k r̝̊ ɛ n
křest	k r̝̊ ɛ s t
křičet	k r̝̊ ɪ t͡ʃ ɛ t
křída	k r̝̊ iː d a
křídlo	k r̝̊ iː d l o
kříž	k r̝̊ iː ʃ
laboratoř	l a b o r a t o r̝̊
laktóza	l a k t oː z a
lampa	l a m p a
langusta	l a ŋ ɡ u s t a
lanthan	l a n t a n
laň	l a ɲ
lebeční	l ɛ b ɛ t ʃ ɲ iː
leden	l ɛ d ɛ n
lednice	l ɛ d ɲ ɪ t͡s ɛ
lednička	l ɛ d ɲ ɪ t͡ʃ k a
ledoborec	l ɛ d ɔ b ɔ r ɛ t s
ledovka	l ɛ d ɔ f k a
legie	l ɛ ɡ ɪ j ɛ
legionář	l ɛ ɡ ɪʲ ɔ n aː r̝̊
legrační	l ɛ ɡ r a t͡ʃ ɲ iː
lehký	l ɛ x k iː
leknín	l ɛ k ɲ iː n
lempl	l ɛ m p l̩
lest	l ɛ s t
letadlo	l ɛ t a d l o
letargie	l ɛ t a r ɡ ɪ j ɛ
letargiemi	l ɛ t a r ɡ ɪ j ɛ m ɪ
letargii	l ɛ t a r ɡ ɪ j ɪ
letargií	l ɛ t a r ɡ ɪ j iː
letargiích	l ɛ t a r ɡ ɪ j iː x
letargiím	l ɛ t a r ɡ ɪ j iː m
letoun	l ɛ t ɔ ʊ̯ n
letět	l ɛ c ɛ t
lev	l ɛ f
levandule	l ɛ v a n d ʊ l ɛ
levný	l ɛ v n iː
levý	l ɛ v iː
lez	l ɛ s
lež	l ɛ ʃ
ležet	l ɛ ʒ ɛ t
ležák	l ɛ ʒ aː k
liber	l ɪ b ɛ r
libovolný	l ɪ b ɔ v ɔ l n iː
licence	l ɪ t s e n t s e
likér	l ɪ k ɛː r
limetka	l ɪ m ɛ t k a
lino	l ɪ n ɔ
linoleum	l ɪ n ɔ l ɛ ʊ̯ m
lir	l ɪ r
lira	l ɪ r a
lirami	l ɪ r a m ɪ
liro	l ɪ r o
lirou	l ɪ r o ʊ̯
liru	l ɪ r u
liry	l ɪ r ɪ
lirách	l ɪ r aː x
lirám	l ɪ r aː m
listopad	l ɪ s t o p a t
liře	l ɪ r̝ ɛ
lišce	l ɪ ʃ t͡s ɛ
lišek	l ɪ ʃ ɛ k
liškami	l ɪ ʃ k a m ɪ
liško	l ɪ ʃ k o
liškou	l ɪ ʃ k o u̯
lišku	l ɪ ʃ k u
lišky	l ɪ ʃ k ɪ
liškách	l ɪ ʃ k aː x
liškám	l ɪ ʃ k aː m
lišácký	l ɪ ʃ aː t͡s k iː
lišák	l ɪ ʃ aː k
lišáčtější	l ɪ ʃ aː t͡ʃ c ɛ j ʃ iː
lom	l o m
losos	l o s o s
lotr	l o t r̩
lov	l ɔ f
loviště	l ɔ v ɪ ʃ c ɛ
loď	l o c
lošák	l o ʃ aː k
ložnice	l o ʒ ɲ ɪ t͡s ɛ
lstiví	l s c ɪ v iː
lstivý	l s c ɪ v iː
lstivější	l s c ɪ v j ɛ j ʃ iː
lucemburk	l ʊ t s ɛ m b ʊ r k
lupy	l ʊ p ɪ
lustrace	l ʊ s t r a t͡s ɛ
lutecium	l ʊ t ɛː t s ɪ j ʊ m
lyr	l ɪ r
lyra	l ɪ r a
lyrami	l ɪ r a m ɪ
lyro	l ɪ r o
lyrou	l ɪ r o ʊ̯
lyru	l ɪ r u
lyry	l ɪ r ɪ
lyrách	l ɪ r aː x
lyrám	l ɪ r aː m
lyře	l ɪ r̝ ɛ
láska	l aː s k a
látka	l aː t k a
lékárna	l ɛː k aː r n a
léto	l ɛː t o
léčba	l ɛː d͡ʒ b a
líbat	l iː b a t
líbesbríf	l iː b ɛ z b r iː f
líný	l iː n iː
lístek	l iː s t ɛ k
majonéza	m a j o n ɛː z a
majoránka	m a j o r aː ŋ k a
makrela	m a k r ɛ l a
malba	m a l b a
malovat	m a l o v a t
malíř	m a l iː r̝̊
malý	m a l iː
mamrd	m a m r t
manažer	m a n a ʒ ɛ r
mandarinka	m a n d a r ɪ ŋ k a
mandle	m a n d l ɛ
mango	m a ŋ ɡ o
manželka	m a n ʒ ɛ l k a
manželství	m a n ʒ ɛ l s t v iː
mapa	m a p a
margarín	m a r ɡ a r iː n
marnotratný	m a r n ɔ t r ʌ t n iː
maršalština	m a r ʃ a l ʃ c ɪ n a
maska	m a s k a
mat	m a t
matematicky	m a t ɛ m a t ɪ t s k ɪ
matka	m a t k a
mazaný	m a z a n iː
mazanější	m a z a ɲ ɛ j ʃ iː
mazánek	m a z aː n ɛ k
mašina	m a ʃ ɪ n a
mdloba	m d l ɔ b a
mdlý	m d l iː
mech	m ɛ x
mechovka	m ɛ x o f k a
medvěd	m ɛ d v j ɛ t
medvědice	m ɛ d v j ɛ ɟ ɪ t s ɛ
mela	m e l a
meloun	m ɛ l o u̯ n
mendělejev	m ɛ n ɟ ɛ l ɛ j ɛ f
meningitida	m ɛ n ɪ ŋ ɡ ɪ t iː d a
meningitida	m ɛ n ɪ ŋ ɡ ɪ t ɪ d a
menu	m ɛ n ʊ
menší	m ɛ n ʃ iː
merkelovou	m ɛ r k l ɔ v ɔ ʊ̯
meruňka	m ɛ r u ɲ k a
met	m ɛ t
meta	m ɛ t a
metař	m ɛ t a r̝̊
metla	m e t l a
metr	m ɛ t r̩
metro	m ɛ t r o
mez	m ɛ s
mezi	m ɛ z ɪ
mezinárodní	m ɛ z ɪ n aː r o d ɲ iː
milovat	m ɪ l o v a t
miláček	m ɪ l aː t͡ʃ ɛ k
mimoolomoucký	m ɪ m o ʔ o l o m o u̯ t͡s k iː
mimoolomoučtí	m ɪ m o ʔ o l o m o u̯ t͡ʃ c iː
mince	m ɪ n t͡s ɛ
minolovka	m ɪ n ɔ l ɔ f k a
minutka	m ɪ n ʊ t k a
misionář	m ɪ s ɪ j ɔ n aː r̝̊
miso	m i s o
mitra	m i t r a
mletý	m l ɛ t iː
mluviti	m l u v ɪ c ɪ
mluvčí	m l u v t͡ʃ iː
mlýnovka	m l iː n o f k a
mlčeti	m l̩ t͡ʃ ɛ c ɪ
mlž	m l̩ ʃ
mnohem	m n o ɦ ɛ m
mobil	m o b ɪ l
moderní	m o d ɛ r ɲ iː
mohl	m ɔ ɦ l̩
mojžíš	m ɔ j ʒ iː ʃ
mokrý	m o k r iː
molybden	m o l ɪ b d e n
monopol	m o n o p o l
monopole	m o n o p o l ɛ
monopól	m o n o p oː l
morava	m o r a v a
motor	m o t o r
motorka	m o t o r k a
motýl	m o t iː l
moure	m o ʊ̯ r ɛ
mourem	m o ʊ̯ r ɛ m
mozkomor	m o s k o m o r
močůvka	m o t͡ʃ uː f k a
mořit	m o r̝ ɪ t
mořský	m o r̝̊ s k iː
možná	m o ʒ n aː
možný	m o ʒ n iː
mrak	m r a k
mramor	m r a m ɔ r
mrkat	m r̩ k a t
mrkev	m r̩ k ɛ v
mrtvý	m r̩ t v iː
mrznout	m r̩ z n ɔ ʊ̯ t
mráz	m r aː s
mstivý	m s c ɪ v iː
mstít	m s c iː t
much	m u x
mulat	m u l a t
muset	m u s ɛ t
musit	m u s ɪ t
musíme	m ʊ s iː m ɛ
musíš	m ʊ s iː ʃ
muži	m ʊ ʒ ɪ
mužský	m u ʃ s k iː
my	m ɪ
myslet	m ɪ s l ɛ t
mysli	m ɪ s l ɪ
myslit	m ɪ s l̩ ɪ t
myslíš	m ɪ s l iː ʃ
myška	m ɪ ʃ k a
má	m aː
mág	m aː k
máma	m aː m a
máslo	m aː s l o
máť	m aː c
mého	m ɛː ɦ o
mést	m ɛː s t
mír	m iː r
místnost	m iː s t n o s t
místní	m iː s t ɲ iː
místo	m iː s t o
mívat	m iː v a t
míč	m iː t͡ʃ
müsli	m ɪ s l ɪ
mýdlo	m iː d l o
mě	m ɲ ɛ
měnit	m ɲ ɛ ɲ ɪ t
měď	m ɲ ɛ c
měřit	m ɲ ɛ r̝ ɪ t
můstek	m uː s t ɛ k
může	m uː ʒ ɛ
můžeš	m uː ʒ ɛ ʃ
na	n a
nabídnout	n a b iː d n o u̯ t
nabízet	n a b iː z ɛ t
nadat	n a d a t
nader	n a d ɛ r
nadměrný	n a d m ɲ ɛ r n iː
nadměrně	n a d m ɲ ɛ r ɲ ɛ
nadtřída	n a t t r̝̊ iː d a
nadále	n a d aː l ɛ
nadšený	n a t ʃ ɛ n iː
nahrávač	n a ɦ r aː v a t ʃ
najít	n a j iː t
nakažlivost	n a k a ʒ l ɪ v ɔ s t
nakupovat	n a k u p o v a t
namyšlenost	n a m ɪ ʃ l ɛ n ɔ s t
naposledy	n a p o s l ɛ d ɪ
naproti	n a p r o c ɪ
například	n a p r̝̊ iː k l a t
narcis	n a r t͡s ɪ s
narodit	n a r o ɟ ɪ t
narozeniny	n a r o z ɛ ɲ ɪ n ɪ
narvat	n a r v a t
nastavení	n a s t a v ɛ ɲ iː
nastoupit	n a s t o u̯ p ɪ t
nastupovat	n a s t u p o v a t
naučit	n a u t͡ʃ ɪ t
navzdory	n a v z d o r ɪ
navzájem	n a v z aː j ɛ m
navštívit	n a v ʃ c iː v ɪ t
navštěvovat	n a v ʃ c ɛ v o v a t
navždy	n a v ʒ d ɪ
naše	n a ʃ ɛ
našed	n a ʃ ɛ t
našedši	n a ʃ ɛ t ʃ ɪ
naštvaný	n a ʃ t v a n iː
neapol	n ɛ a p o l
nebe	n ɛ b ɛ
nebezpečný	n ɛ b ɛ s p ɛ t͡ʃ n iː
nebezpečí	n ɛ b ɛ s p ɛ t ʃ iː
nebo	n ɛ b o
nech	n ɛ x
nechat	n ɛ x a t
nechtít	n ɛ x c iː t
nechávat	n ɛ x aː v a t
nedostatek	n ɛ d o s t a t ɛ k
nedostatečně	n ɛ d ɔ s t a t ɛ t ʃ ɲ ɛ
nejlepší	n ɛ j l ɛ p ʃ iː
nejlišáčtější	n ɛ j l ɪ ʃ aː t͡ʃ c ɛ j ʃ iː
nejlstivější	n ɛ j l s c ɪ v j ɛ j ʃ iː
nejmazanější	n ɛ j m a z a ɲ ɛ j ʃ iː
nejnovější	n ɛ j n o v j ɛ j ʃ iː
nejobecnější	n ɛ j o b ɛ t͡s ɲ ɛ j ʃ iː
nejpodšitější	n ɛ j p o t ʃ ɪ c ɛ j ʃ iː
nejprohnanější	n ɛ j p r o ɦ n a ɲ ɛ j ʃ iː
nejsametovější	n ɛ j s a m ɛ t o v j ɛ j ʃ iː
nekonečný	n ɛ k o n ɛ t͡ʃ n iː
nemluvě	n ɛ m l ʊ v j ɛ
nemít	n ɛ m iː t
nenávidět	n ɛ n aː v ɪ ɟ ɛ t
nenávist	n ɛ n aː v ɪ s t
neobyčejný	n ɛ ʔ o b ɪ t͡ʃ ɛ j n iː
neolomoucký	n ɛ ʔ o l o m o u̯ t͡s k iː
nerozhodný	n ɛ r o z ɦ o d n iː
nesmysl	n ɛ s m ɪ s l
netopýr	n ɛ t o p iː r
neutrino	n ɛ ʊ̯ t r iː n ɔ
nevina	n ɛ v ɪ n a
nevinen	n ɛ v ɪ n ɛ n
nevinna	n ɛ v ɪ n a
neziskovka	n ɛ z ɪ s k o f k a
neúspěšně	n ɛ uː s p j ɛ ʃ ɲ ɛ
než	n ɛ ʃ
nika	n ɪ k a
nikam	ɲ ɪ k a m
nikde	ɲ ɪ ɡ d ɛ
nikdo	ɲ ɪ ɡ d o
nikdy	ɲ ɪ ɡ d ɪ
nizozemština	ɲ ɪ z o z ɛ m ʃ c ɪ n a
ničit	ɲ ɪ t͡ʃ ɪ t
ničí	ɲ ɪ t͡ʃ iː
noc	n o t͡s
nominativ	n o m ɪ n a t ɪ f
nor	n o r
norsko	n o r s k o
norština	n o r ʃ c ɪ n a
nosit	n o s ɪ t
nosič	n o s ɪ t͡ʃ
notabene	n o t a b ɛ n ɛ
noviny	n o v ɪ n ɪ
novákových	n ɔ v aː k ɔ v iː x
nový	n o v iː
novější	n o v j ɛ j ʃ iː
noční	n o t͡ʃ ɲ iː
nočník	n o t͡ʃ ɲ iː k
nudit	n u ɟ ɪ t
nutit	n ʊ c ɪ t
nádherný	n aː d ɦ ɛ r n iː
nádraží	n aː d r a ʒ iː
nádrž	n aː d r̩ ʃ
náhradní	n aː ɦ r a d ɲ iː
náhradník	n aː ɦ r a d ɲ iː k
nálad	n aː l a t
nález	n aː l ɛ s
nám	n aː m
náměstí	n aː m ɲ ɛ s c iː
náměstíčko	n aː m ɲ ɛ s c iː t͡ʃ k o
nárazník	n aː r a z ɲ iː k
nástroj	n aː s t r o j
nástupiště	n aː s t u p ɪ ʃ c ɛ
názoru	n aː z o r u
náš	n aː ʃ
nést	n ɛː s t
nízkorozpočtový	ɲ iː s k ɔ r ɔ s p ɔ t ʃ t ɔ v iː
něco	ɲ ɛ t͡s o
něj	ɲ ɛ j
nějak	ɲ ɛ j a k
nějaký	ɲ ɛ j a k iː
někam	ɲ ɛ k a m
někde	ɲ ɛ ɡ d ɛ
někdo	ɲ ɛ ɡ d o
někdy	ɲ ɛ ɡ d ɪ
některý	ɲ ɛ k t ɛ r iː
někudy	ɲ ɛ k ʊ d ɪ
německo	ɲ ɛ m ɛ t͡s k o
německý	ɲ ɛ m ɛ t͡s k iː
němka	ɲ ɛ m k a
němčina	ɲ ɛ m t͡ʃ ɪ n a
něčí	ɲ ɛ t͡ʃ iː
oba	o b a
obchod	o p x o t
obdivovat	o b ɟ ɪ v o v a t
obecná	o b ɛ t͡s n aː
obecní	o b ɛ t͡s ɲ iː
obecný	o b ɛ t͡s n iː
obecnější	o b ɛ t͡s ɲ ɛ j ʃ iː
objednat	o b j ɛ d n a t
objem	o b j ɛ m
objevit	o b j ɛ v ɪ t
objevovat	o b j ɛ v o v a t
oblak	o b l a k
oblek	o b l ɛ k
obleva	ʔ ɔ b l ɛ v a
oblečení	o b l ɛ t͡ʃ ɛ ɲ iː
obličej	o b l ɪ t͡ʃ ɛ j
oblíbený	o b l iː b ɛ n iː
obnovitelný	o b n o v ɪ t e l n iː
obor	o b o r
obra	o b r a
obrana	o b r a n a
obraz	o b r a s
obrech	o b r ɛ x
obrem	o b r ɛ
obrovi	o b r o v ɪ
obrovský	o b r o v s k iː
obrové	o b r o v ɛː
obru	o b r u
obruč	ɔ b r ʊ t ʃ
obry	o b r ɪ
obrů	o b r uː
obrům	o b r uː m
obsah	o p s a x
obsahovat	o p s a ɦ o v a t
obtěžování	ɔ p c ɛ ʒ ɔ v aː ɲ iː
obvykle	o b v ɪ k l ɛ
obzvlášť	ɔ b z v l aː ʃ c
obézní	ɔ b ɛː z ɲ iː
obývák	o b iː v aː k
oběd	o b j ɛ t
obře	o b r̝ ɛ
obři	o b r̩ ɪ
oceánie	ɔ t͡s ɛ aː n ɪ j ɛ
ochutnat	o x u t n a t
ocílka	ɔ t s iː l k a
od	o t
odbor	ɔ d b ɔ r
odbornice	o d b o r ɲ ɪ t͡s ɛ
odborník	o d b o r ɲ iː k
odbory	ɔ d b ɔ r ɪ
odbočit	o d b o t͡ʃ ɪ t
odbočka	o d b o t͡ʃ k a
odbytiště	ʔ ɔ d b i c ɪ ʃ c ɛ
odbíjená	ɔ d b iː j ɛ n aː
odcházet	o t x aː z ɛ t
odhodlaný	ɔ d ɦ ɔ d l a n iː
odjet	o d j ɛ t
odjezd	o d j ɛ z d
odjinud	ɔ d j ɪ n ʊ t
odjinud	ɔ ɟ ɪ n ʊ t
odjíždět	o d j iː ʒ ɟ ɛ t
odkud	o t k u t
odlet	o d l ɛ t
odněkud	ɔ d ɲ ɛ k ʊ t
odpad	o t p a t
odpar	o t p a r
odpare	o t p a r ɛ
odparech	o t p a r ɛ x
odparem	o t p a r ɛ m
odparu	o t p a r u
odpary	o t p a r ɪ
odparů	o t p a r uː
odparům	o t p a r uː m
odpoledne	o t p o l ɛ d n ɛ
odpovídat	o t p o v iː d a t
odpovědět	o t p o v j ɛ ɟ ɛ t
odpověď	o t p o v j ɛ c
odstranit	ɔ t s t r a ɲ ɪ t
odsud	o t s u t
odtud	ɔ t t ʊ t
odvážejíc	ʔ ɔ d v aː ʒ ɛ j iː t͡s
odzbrojit	ˀɔ d z b r ɔ j ɪ t
odřenina	ɔ d r̝ ɛ ɲ ɪ n a
ofensiva	o f ɛ n z iː v a
ofensiva	o f ɛ n z ɪ v a
ofenziva	o f ɛ n z iː v a
ofenziva	o f ɛ n z ɪ v a
ofsajd	ɔ f s a j t
okluziva	o k l u z iː v a
okluziva	o k l u z ɪ v a
okotěška	o k o c ɛ ʃ k a
okuj	ɔ k u j
okupace	ʔ o k u p a t͡s ɛ
okurka	o k u r k a
oldřiška	o l d r̝ ɪ ʃ k a
olej	o l ɛ j
oliv	o l ɪ v
oliva	o l ɪ v a
olivo	o l ɪ v o
olivový	o l ɪ v o v iː
olomoucin	o l o m o u̯ t͡s ɪ n
olomoucine	o l o m o u̯ t͡s ɪ n ɛ
olomoučan	o l o m o u̯ t͡ʃ a n
olomoučanka	o l o m o u̯ t͡ʃ a ŋ k a
olomoučačka	o l o m o u̯ t͡ʃ a t͡ʃ k a
olomoučák	o l o m o u̯ t͡ʃ aː k
olomucký	o l o m u t͡s k iː
ombudsman	ɔ m b ʊ t s m a n
omlouvat	o m l o u̯ v a t
omluvit	o m l u v ɪ t
omrdat	ʔ ɔ m r̩ d a t
on	o n
onde	o n d ɛ
ondy	o n d ɪ
oni	o ɲ ɪ
ono	o n o
opatrně	o p a t r ɲ ɛ
opice	o p ɪ t͡s ɛ
opravdový	o p r a v d o v iː
opravdu	o p r a v d u
opylovač	o p ɪ l o v a t͡ʃ
oranžový	o r a n ʒ o v iː
orba	o r b a
orbami	o r b a m ɪ
orbo	o r b o
orbou	o r b o ʊ̯
orbu	o r b u
orby	o r b ɪ
orbách	o r b aː x
orbám	o r b aː m
orbě	o r b j ɛ
orgán	o r ɡ aː n
orla	o r l a
orlech	o r l ɛ x
orli	o r l ɪ
orloj	ɔ r l ɔ j
orlovi	o r l o v ɪ
orlové	o r l o v ɛː
orlu	o r l u
orly	o r l ɪ
orlí	o r l iː
orlů	o r l uː
orlům	o r l uː m
osahávat	ʔ o s a ɦ aː v a t
osel	o s ɛ l
oset	ɔ s ɛ t
osoba	o s o b a
ospalý	o s p a l iː
ostroretka	o s t r o r ɛ t k a
osud	o s u t
osvětim	ɔ s v j ɛ c ɪ m
otec	o t ɛ t͡s
otevírat	o t ɛ v iː r a t
otevřený	o t ɛ v r̝ ɛ n iː
otevřít	o t ɛ v r̝ iː t
otázka	o t aː s k a
ovesný	o v ɛ s n iː
ovladač	o v l a d a t͡ʃ
ovoce	o v o t͡s ɛ
oxid	o k s ɪ t
oznamovat	o z n a m o v a t
oznámit	o z n aː m ɪ t
oř	o r̝̊
ořech	o r̝ ɛ x
ošklivý	o ʃ k l ɪ v iː
pakáž	p a k aː ʃ
palba	p a l b a
palci	p a l t͡s ɪ
palec	p a l ɛ t͡s
paluba	p a l u b a
pamatovat	p a m a t o v a t
pampeliška	p a m p ɛ l ɪ ʃ k a
panda	p a n d a
panák	p a n aː k
paprika	p a p r ɪ k a
papír	p a p iː r
papírna	p a p iː r n a
parkovat	p a r k o v a t
parkoviště	p a r k o v ɪ ʃ c ɛ
pas	p a s
pasiv	p a s iː f
pasiv	p a s ɪ f
pasiva	p a s iː v a
pasiva	p a s ɪ v a
past	p a s t
pat	p a t
pata	p a t a
pate	p a t ɛ
patě	p a c ɛ
pavouk	p a v o u̯ k
pazneht	p a z n ɛ x t
pec	p ɛ t s
pece	p ɛ t͡s ɛ
peci	p ɛ t͡s ɪ
pejorativní	p ɛ j ɔ r a t ɪ v ɲ iː
pejorativum	p ɛ j o r a t iː v ʊ m
pejorativum	p ɛ j o r a t ɪ v ʊ m
pekárna	p ɛ k aː r n a
penalta	p ɛ n a l t a
penis	p ɛ n ɪ s
penze	p ɛ n z ɛ
peníze	p ɛ ɲ iː z ɛ
penízovka	p ɛ ɲ iː z o f k a
penězokaz	p ɛ ɲ ɛ z o k a s
peněženka	p ɛ ɲ ɛ ʒ ɛ ŋ k a
peněžní	p ɛ ɲ ɛ ʒ ɲ iː
pepř	p ɛ p r̝̊
perlorodka	p ɛ r l o r o t k a
perník	p ɛ r ɲ iː k
personál	p ɛ r s o n aː l
petr	p ɛ t r̩
petržel	p ɛ t r̩ ʒ ɛ l
pevný	p ɛ v n iː
pečený	p ɛ t͡ʃ ɛ n iː
pečetě	p ɛ t͡ʃ ɛ c ɛ
pečeť	p ɛ t͡ʃ ɛ c
pečárka	p ɛ t͡ʃ aː r k a
pečárkotvaré	p ɛ t͡ʃ aː r k o t v a r ɛː
pečárkovité	p ɛ t͡ʃ aː r k o v ɪ t ɛː
piko	p i k o
pili	p ɪ l ɪ
pilka	p ɪ l k a
pilný	p ɪ l n iː
pindík	p ɪ n ɟ iː k
pingo	p ɪ ŋ ɡ o
pistácie	p ɪ s t aː t͡s ɪ j ɛ
pití	p ɪ c iː
plakát	p l a k aː t
plakát	p l a ɡ aː t
planeta	p l a n ɛ t a
planetárium	p l a n ɛ t aː r ɪ j ʊ m
planš	p l a n ʃ
plat	p l a t
platan	p l a t a n
platit	p l a c ɪ t
plavat	p l a v a t
plazmid	p l a z m ɪ t
plať	p l a c
plen	p l ɛ n
plena	p l ɛ n a
plný	p l̩ n iː
plod	p l o t
plodný	p l ɔ d n iː
plotice	p l ɔ c ɪ t s ɛ
plurál	p l ʊ r aː l
plyn	p l ɪ n
plynový	p l ɪ n o v iː
plynárna	p l ɪ n aː r n a
plánovač	p l aː n o v a t͡ʃ
plát	p l aː t
pláču	p l aː t͡ʃ u
pláž	p l aː ʃ
plíseň	p l iː s ɛ ɲ
plž	p l̩ ʃ
poblíž	p o b l iː ʃ
pochod	p o x o t
pochopit	p o x o p ɪ t
pocházet	p o x aː z ɛ t
pod	p o t
podnikatel	p o d ɲ ɪ k a t ɛ l
podnikatelka	p o d ɲ ɪ k a t ɛ l k a
podobný	p o d o b n iː
podplukovník	p ɔ t p l u k ɔ v ɲ iː k
podpora	p o t p o r a
podtřída	p o t t r̝̊ iː d a
podzim	p o d z ɪ m
podzvukový	p ɔ d z v ʊ k ɔ v iː
podívat	p o ɟ iː v a t
poděkovat	p o ɟ ɛ k o v a t
podšitá	p o t ʃ ɪ t aː
podšitý	p o t ʃ ɪ t iː
podšitější	p o t ʃ ɪ c ɛ j ʃ iː
podšít	p o t ʃ iː t
pohled	p o ɦ l ɛ t
pohlednice	p o ɦ l ɛ d ɲ ɪ t͡s ɛ
pohovka	p o ɦ o v k a
pohádka	p o ɦ aː t k a
pohár	p o ɦ aː r
pohřeb	p o ɦ r̝ ɛ p
pojištění	p o j ɪ ʃ c ɛ ɲ iː
pojištěný	p o j ɪ ʃ c ɛ n iː
pokoj	p o k o j
pokojská	p o k o j s k aː
pokračovat	p o k r a t͡ʃ o v a t
pokrytkyně	p o k r ɪ t k ɪ ɲ ɛ
pokud	p o k u t
pokus	p o k u s
pokuta	p o k u t a
polek	p o l ɛ k
police	p o l ɪ t͡s ɛ
policista	p o l ɪ t͡s ɪ s t a
politik	p o l ɪ t ɪ k
politika	p o l ɪ t ɪ k a
polka	p o l k a
polopenze	p o l o p ɛ n z ɛ
poločas	p ɔ l ɔ t ʃ a s
polsko	p o l s k o
polský	p o l s k iː
polák	p o l aː k
políbit	p o l iː b ɪ t
polština	p o l ʃ c ɪ n a
pomalu	p o m a l u
pomalý	p o m a l iː
pomeranč	p o m ɛ r a n t͡ʃ
pomlázka	p ɔ m l aː s k a
pomocník	p ɔ m ɔ t s ɲ iː k
pomstít	p o m s c iː t
pomáhat	p o m aː ɦ a t
ponožka	p o n o ʃ k a
poočku	p o ʔ o t͡ʃ k u
popisovat	p o p ɪ s o v a t
popsat	p o p s a t
porada	p o r a d a
poradami	p o r a d a m ɪ
porado	p o r a d o
poradou	p o r a d o ʊ̯
poradu	p o r a d u
porady	p o r a d ɪ
poradách	p o r a d aː x
poradám	p o r a d aː m
poradě	p o r a ɟ ɛ
porazit	p o r a z ɪ t
portrét	p o r t r ɛː t
poslat	p o s l a t
poslechnout	p o s l ɛ x n o u̯ t
poslední	p o s l e d ɲ iː
poslouchat	p o s l o u̯ x a t
posluchač	p o s l ʊ x a t͡ʃ
pospíšil	p o s p iː ʃ ɪ l
pospíšilová	p o s p iː ʃ ɪ l o v aː
postavit	p o s t a v ɪ t
posílat	p o s iː l a t
pot	p o t
potom	p o t o m
potravina	p o t r a v ɪ n a
potřebovat	p o t r̝̊ ɛ b o v a t
pouze	p o u̯ z ɛ
používat	p o u ʒ iː v a t
považovat	p o v a ʒ o v a t
povidla	p ɔ v ɪ d l a
povstalec	p ɔ f s t a l ɛ t͡s
povstání	p ɔ f s t aː ɲ iː
poznat	p o z n a t
poznávat	p o z n aː v a t
pozor	p o z o r
pozorovat	p o z o r o v a t
pozvat	p o z v a t
počasí	p o t͡ʃ a s iː
počitkový	p ɔ t ʃ ɪ t k ɔ v iː
počkat	p o t͡ʃ k a t
počítač	p o t͡ʃ iː t a t͡ʃ
pořádek	p o r̝ aː d ɛ k
pošta	p o ʃ t a
požádat	p o ʒ aː d a t
požárník	p ɔ ʒ aː r ɲ iː k
pracovat	p r a t͡s o v a t
pracovník	p r a t s ɔ v ɲ iː k
pracujou	p r a t͡s ʊ ɪ̯ ɔ ʊ̯
prak	p r a k
prase	p r a s ɛ
praseodym	p r a s ɛ o d ɪ m
praseodym	p r a z ɛ o d ɪ m
pravda	p r a v d a
pravdu	p r a v d u
pravděpodobně	p r a v ɟ ɛ p ɔ d ɔ b ɲ ɛ
pravidelně	p r a v ɪ d ɛ l ɲ ɛ
pravnučka	p r a v n ʊ t ʃ k a
pravopis	p r a v o p ɪ s
pravý	p r a v iː
pračeština	p r a t͡ʃ ɛ ʃ c ɪ n a
pražák	p r a ʒ aː k
prcat	p r t s a t
pro	p r o
problém	p r o b l ɛː m
prodat	p r o d a t
prodavač	p r o d a v a t͡ʃ
prodavačka	p r o d a v a t͡ʃ k a
prodloužení	p r ɔ d l ɔ ʊ̯ ʒ ɛ ɲ iː
prodávat	p r o d aː v a t
profes	p r o f ɛː s
programátor	p r o ɡ r a m aː t o r
prohnaný	p r o ɦ n a n iː
prohnanější	p r o ɦ n a ɲ ɛ j ʃ iː
prohrát	p r o ɦ r aː t
prohrávat	p r o ɦ r aː v a t
prominout	p r o m ɪ n o u̯ t
promiň	p ɾ o m i ɲ
propadliště	p r ɔ p a d l ɪ ʃ c ɛ
prosinec	p r o s ɪ n ɛ t͡s
prosím	p ɾ o s iː m
protaktinium	p r o t a k t iː n ɪ u m
proti	p r o c ɪ
proto	p r o t o
protože	p r o t o ʒ ɛ
provaziště	p r ɔ v a z ɪ ʃ c ɛ
provize	p r o v ɪ z ɛ
provoz	p r o v o s
provádět	p r o v aː ɟ ɛ t
provést	p r o v ɛː s t
prse	p r̩ s ɛ
prsech	p r̩ s ɛ x
prsem	p r̩ s ɛ m
prsten	p r̩ s t ɛ n
prsu	p r̩ s u
prsy	p r̩ s ɪ
prsů	p r̩ s uː
prsům	p r̩ s uː m
prudký	p r u d k iː
pruh	p r u x
prvek	p r̩ v ɛ k
práce	p r aː t͡s ɛ
práci	p r aː t͡s ɪ
prádelna	p r aː d ɛ l n a
práskač	p r aː s k a t͡ʃ
prát	p r aː t
právě	p r aː v j ɛ
prázdný	p r aː z d n iː
pršet	p r̩ ʃ ɛ t
prť	p r̩ c
průvodčí	p r uː v o t t͡ʃ iː
psa	p s a
pstruh	p s t r u x
psychóza	p s ɪ x oː z a
ptakopysk	p t a k o p ɪ s k
ptát	p t aː t
publikum	p u b l ɪ k u m
pumpa	p u m p a
punčocha	p ʊ ɳ t͡ʃ ɔ x a
pupkáč	p ʊ p k aː t͡ʃ
puzzly	p a z l ɪ
puzzly	p u t͡s l ɪ
puška	p u ʃ k a
pád	p aː t
páka	p aː k a
pálka	p aː l k a
pánev	p aː n ɛ f
párek	p aː r ɛ k
pás	p aː s
pátek	p aː t ɛ k
péci	p ɛː t͡s ɪ
píchat	p iː x a t
pískat	p iː s k a t
písmolijec	p iː s m o l i j ɛ t͡s
písnička	p iː s ɲ ɪ t ʃ k a
pít	p iː t
píča	p iː t͡ʃ a
pódium	p ɔː d ɪ j u m
pýchavka	p iː x a f k a
pěkný	p j ɛ k n iː
pěna	p j ɛ n a
pětka	p j ɛ t k a
pětkami	p j ɛ t k a m ɪ
pětku	p j ɛ t k u
pěšky	p j ɛ ʃ k ɪ
pěší	p j ɛ ʃ iː
přechod	p r̝̊ ɛ x o t
předevčírem	p r̝̊ ɛ d ɛ v t͡ʃ iː r ɛ m
předhoz	p r̝̊ ɛ d ɦ o s
předmět	p r̝̊ ɛ d m ɲ ɛ t
přednost	p r̝̊ ɛ d n o s t
přední	p r̝̊ ɛ d ɲ iː
předpis	p r̝̊ ɛ t p ɪ s
předpokládat	p r̝̊ ɛ t p o k l aː d a t
předstihovat	p r̝̊ ɛ t s c ɪ ɦ ɔ v a t
předstírat	p r̝̊ ɛ t s c iː r a t
přeinstalovat	p r̝̊ ɛ j ɪ n s t a l ɔ v a t
přeinstalovat	p r̝̊ ɛ ʔ ɪ n s t a l ɔ v a t
překlad	p r̝̊ ɛ k l a t
překližka	p r̝ ɛ k l ɪ ʃ k a
překládat	p r̝̊ ɛ k l aː d a t
překvapený	p r̝̊ ɛ k v a p ɛ n iː
překvapit	p r̝̊ ɛ k v a p ɪ t
překážka	p r̝̊ ɛ k aː ʃ k a
přeložit	p r̝̊ ɛ l o ʒ ɪ t
přeposlat	p r̝̊ ɛ p ɔ s l a t
přeprava	p r̝̊ ɛ p r a v a
přes	p r̝̊ ɛ s
přeslička	p r̝̊ ɛ s l ɪ t ʃ k a
přesně	p r̝̊ ɛ s ɲ ɛ
přestat	p r̝̊ ɛ s t a t
přesto	p r̝̊ ɛ s t o
přestože	p r̝̊ ɛ s t o ʒ ɛ
přestávat	p r̝̊ ɛ s t aː v a t
přesvědčivý	p r̝̊ ɛ s v j ɛ t t͡ʃ ɪ v iː
přetavit	p r̝̊ ɛ t a v ɪ t
přečíst	p r̝̊ ɛ t͡ʃ iː s t
přeříznout	p r̝̊ ɛ r̝ iː z n ɔ ʊ̯ t
přežít	p r̝̊ ɛ ʒ iː t
při	p r̝̊ ɪ
přicházet	p r̝̊ ɪ x aː z ɛ t
přidat	p r̝̊ ɪ d a t
přidávat	p r̝̊ ɪ d aː v a t
přijet	p r̝̊ ɪ j ɛ t
přijmout	p r̝̊ ɪ j m o u̯ t
přijímat	p r̝̊ ɪ j iː m a t
přikázat	p r̝̊ ɪ k aː z a t
přilba	p r̝ ɪ l b a
přinášet	p r̝̊ ɪ n aː ʃ ɛ t
přinést	p r̝̊ ɪ n ɛː s t
připadat	p r̝̊ ɪ p a d a t
připadnout	p r̝̊ ɪ p a d n o u̯ t
připravit	p r̝̊ ɪ p r a v ɪ t
připravovat	p r̝̊ ɪ p r a v o v a t
přiskřípnout	p r̝̊ i s k r̝̊ iː p n o ʊ̯ t
přivedeme	p r̝̊ ɪ v ɛ d ɛ m ɛ
přání	p r̝̊ aː ɲ iː
přát	p r̝̊ aː t
příbramský	p r̝̊ iː b r a m s k iː
příběh	p r̝̊ iː b j ɛ x
příjem	p r̝̊ iː j ɛ m
příjezd	p r̝̊ iː j ɛ s t
přílet	p r̝̊ iː l ɛ t
příliš	p r̝̊ iː l ɪ ʃ
případ	p r̝̊ iː p a t
příroda	p r̝̊ iː r o d a
příslušník	p r iː s l ʊ ʃ ɲ iː k
přístaviště	p r̝̊ iː s t a v ɪ ʃ c ɛ
přístup	p r̝̊ iː s t u p
přítel	p r̝̊ iː t ɛ l
přítelkyně	p r̝̊ iː t ɛ l k ɪ ɲ ɛ
příze	p r̝̊ iː z ɛ
přízvuk	p r̝̊ iː z v ʊ k
příští	p r̝̊ iː ʃ c iː
půjčit	p uː j t͡ʃ ɪ t
půjčovat	p uː j t͡ʃ o v a t
rabín	r a b iː n
radost	r a d o s t
raft	r a f t
rafty	r a f t ɪ
ragby	r a ɡ b ɪ
rajče	r a j t͡ʃ ɛ
rak	r a k
raket	r a k ɛ t
raketoplán	r a k ɛ t ɔ p l aː n
rakousko	r a k o ʊ̯ s k o
rampouch	r a m p o u x
rande	r a n d ɛ
rašeliniště	r a ʃ ɛ l ɪ ɲ ɪ ʃ c ɛ
rebarbora	r ɛ b a r b o r a
rebelie	r ɛ b eː l ɪ j ɛ
recenze	r ɛ t͡s ɛ n z ɛ
recepce	r ɛ t͡s ɛ p t͡s ɛ
reflexiv	r ɛ f l ɛ k s iː f
reflexiv	r ɛ f l ɛ k s ɪ f
reflexiva	r ɛ f l ɛ k s iː v a
reflexiva	r ɛ f l ɛ k s ɪ v a
reflexivem	r ɛ f l ɛ k s iː v ɛ m
reflexivem	r ɛ f l ɛ k s ɪ v ɛ m
reflexivum	r ɛ f l ɛ k s iː v u m
reflexivum	r ɛ f l ɛ k s ɪ v u m
reinstalovat	r ɛ j ɪ n s t a l ɔ v a t
reinstalovat	r ɛ ʔ ɪ n s t a l ɔ v a t
rejda	r ɛ j d a
reklama	r ɛ k l a m a
respektovat	r ɛ s p ɛ k t o v a t
restaurace	r ɛ s t a u̯ r a t͡s ɛ
ret	r ɛ t
rezervovat	r ɛ z ɛ r v o v a t
rezignovat	r ɛ z ɪ ɡ n ɔ v a t
rigidní	r ɪ ɡ ɪ d ɲ iː
ring	r ɪ ŋ k
rob	r o p
roba	r o b a
robat	r o b a t
robata	r o b a t a
robatech	r o b a t ɛ x
robaty	r o b a t ɪ
robatům	r o b a t uː m
robe	r o b ɛ
robech	r o b ɛ x
robem	r o b ɛ m
robi	r o b ɪ
robit	r o b ɪ t
robovi	r o b o v ɪ
robové	r o b o v ɛː
robte	r o b t ɛ
robu	r o b u
roby	r o b ɪ
robátko	r o b aː t k o
robě	r o b j ɛ
roběte	r o b j ɛ t ɛ
robětem	r o b j ɛ t ɛ m
roběti	r o b j ɛ c ɪ
robů	r o b uː
robům	r o b uː m
rodina	r o ɟ ɪ n a
rodič	r o ɟ ɪ t͡ʃ
rodiště	r ɔ ɟ ɪ ʃ c ɛ
rohlík	r o ɦ l iː k
rok	r o k
rolemi	r o l ɛ m ɪ
roli	r o l ɪ
rolí	r o l iː
rolích	r o l iː x
rolím	r o l iː m
rop	r o p
ropo	r o p o
ropy	r o p ɪ
rosolozub	r o s o l o z u p
rozbitý	r o z b ɪ t iː
rozdíl	r o z ɟ iː l
rozhlas	r ɔ z ɦ l a s
rozhodopádně	r o z ɦ o d o p aː d ɲ ɛ
rozhodčí	r ɔ z ɦ ɔ t ʃ iː
rozinka	r o z ɪ ŋ k a
rozkazovací	r o s k a z o v a t s iː
rozkoukat	r ɔ s k ɔ ʊ̯ k a t
rozměrný	r ɔ z m ɲ ɛ r n iː
rozostřit	r ɔ zˀ ɔ s t r̝ ɪ t
rozostřovat	r ɔ zˀ ɔ s t r̝ ɔ v a t
rozpočet	r ɔ s p ɔ t ʃ ɛ t
rozsáhlý	r ɔ sː aː ɦ l iː
roztavit	r ɔ s t a v ɪ t
rozumět	r o z u m ɲ ɛ t
rozzlobit	r o z z l o b ɪ t
rošáda	r o ʃ aː d a
rtěnka	r c ɛ ŋ k a
rub	r u p
rugby	r a ɡ b ɪ
rum	r u m
rumunce	r u m u n t͡s ɛ
rumunka	r u m u ŋ k a
rumunkami	r u m u ŋ k a m ɪ
rumunko	r u m u ŋ k o
rumunkou	r u m u ŋ k o u̯
rumunku	r u m u ŋ k u
rumunky	r u m u ŋ k ɪ
rumunkách	r u m u ŋ k aː x
rumunkám	r u m u ŋ k aː m
rup	r u p
ruční	r u t͡ʃ ɲ iː
ruština	r u ʃ c ɪ n a
rváček	r v aː t͡ʃ ɛ k
ryba	r ɪ b a
rybníček	r ɪ b ɲ iː t͡ʃ ɛ k
rychle	r ɪ x l ɛ
rychlobruslení	r ɪ x l ɔ b r ʊ s l ɛ ɲ iː
rychlost	r ɪ x l o s t
rychlík	r ɪ x l iː k
rychlý	r ɪ x l iː
ryl	r ɪ l
ryla	r ɪ l a
ryli	r ɪ l ɪ
rylo	r ɪ l o
ryly	r ɪ l ɪ
rynecký	r ɪ n ɛ t͡s k iː
ryneček	r ɪ n ɛ t͡ʃ ɛ k
rynk	r ɪ ŋ k
rád	r aː t
rádiový	r aː d ɪ j ɔ v iː
ráj	r aː j
ráno	r aː n o
ráz	r aː s
ríša	r iː ʃ a
róba	r oː b a
róbami	r oː b a m ɪ
róbo	r oː b o
róbou	r oː b o ʊ̯
róbu	r oː b u
róby	r oː b ɪ
róbách	r oː b aː x
róbám	r oː b aː m
róbě	r oː b j ɛ
růžový	r uː ʒ o v iː
s	s
sako	s a k ɔ
salto	s a l t ɔ
salám	s a l aː m
salát	s a l aː t
samet	s a m ɛ t
sametonohá	s a m ɛ t o n o ɦ aː
sametoví	s a m ɛ t o v iː
sametový	s a m ɛ t o v iː
sametovější	s a m ɛ t o v j ɛ j ʃ iː
samoobsluha	s a m o ʔ o p s l u ɦ a
samota	s a m ɔ t a
samozřejmě	s a m ɔ z r̝ ɛ j m ɲ ɛ
sandr	s a n d r
sankce	s a ŋ k t͡s ɛ
sbírat	z b iː r a t
sběrač	z b j ɛ r a t ʃ
schránka	s x r aː ŋ k a
scházet	s x aː z ɛ t
schůze	s x uː z ɛ
scénárista	s t͡s ɛː n aː r ɪ s t a
se	s ɛ
sebevražedný	s ɛ b ɛ v r a ʒ ɛ d n iː
sebou	s e b o u
sebrat	s ɛ b r a t
secese	s ɛ t͡s ɛ s ɛ
sedadlo	s ɛ d a d l o
sedmispáč	s ɛ d m ɪ s p aː t͡ʃ
sekretář	s ɛ k r ɛ t aː r̝̊
sekta	s ɛ k t a
sele	s ɛ l ɛ
sem	s ɛ m
senzitivní	s ɛ ŋ z ɪ t ɪ v ɲ iː
separace	s ɛ p a r a t͡s ɛ
serenáda	s ɛ r ɛ n aː d a
serotonin	s ɛ r ɔ t ɔ ɲ ɪ n
servat	s ɛ r v a t
servírka	s ɛ r v iː r k a
ses	s ɛ s
sestra	s ɛ s t r a
sestřenice	s ɛ s t r̝̊ ɛ ɲ ɪ t͡s ɛ
set	s ɛ t
setr	s ɛ t r̩
setru	s ɛ t r ʊ
setřu	s ɛ t r̝ ʊ
setřít	s ɛ t r̝ iː t
severní	s ɛ v ɛ r ɲ iː
seznam	s ɛ z n a m
seš	s ɛ ʃ
sešit	s ɛ ʃ ɪ t
sešívačka	s ɛ ʃ iː v a t͡ʃ k a
shledat	s x l ɛ d a t
shledat	z ɦ l ɛ d a t
shledav	s x l ɛ d a f
shledav	z ɦ l ɛ d a f
shledávaje	s x l ɛ d aː v a j ɛ
shledávaje	z ɦ l ɛ d aː v a j ɛ
si	s ɪ
silnice	s ɪ l ɲ ɪ t͡s ɛ
silný	s ɪ l n iː
singulár	s ɪ ŋ ɡ u l aː r
sinusovka	s ɪ n u s o f k a
sirup	s ɪ r ʊ p
sis	s ɪ s
situace	s ɪ t u a t͡s ɛ
skandium	s k a n d ɪ j ʊ m
skifař	s k ɪ f a r̝̊
sklenice	s k l ɛ ɲ ɪ t͡s ɛ
sklo	s k l o
skládat	s k l aː d a t
skončit	s k o n t͡ʃ ɪ t
skopec	s k ɔ p ɛ t s
skopec	s k ɔ p ɛ t͡s
skotsko	s k o t s k o
skořice	s k o r̝ ɪ t͡s ɛ
skrýš	s k r iː ʃ
skupina	s k u p ɪ n a
skvělý	s k v j ɛ l iː
skřípnout	s k r̝̊ iː p n o ʊ̯ t
slabý	s l a b iː
slanina	s l a ɲ ɪ n a
slaný	s l a n iː
sleva	s l ɛ v a
slez	s l ɛ s
slečna	s l ɛ t͡ʃ n a
sleď	s l ɛ c
slib	s l ɪ p
slibovat	s l ɪ b o v a t
slily	s l ɪ l ɪ
slipy	s l ɪ p ɪ
slivovice	s l ɪ v o v ɪ t s e
slon	s l o n
sloupek	s l ɔ ʊ̯ p ɛ k
slovenka	s l o v ɛ ŋ k a
slovenský	s l o v ɛ n s k iː
slovenština	s l o v ɛ n ʃ c ɪ n a
slovinec	s l o v ɪ n ɛ t s
slovo	s l o v o
slovák	s l o v aː k
složit	s l o ʒ ɪ t
sluchátka	s l u x aː t k a
slunečnice	s l u n ɛ t͡ʃ ɲ ɪ t͡s ɛ
slunečno	s l u n ɛ t͡ʃ n o
slyšet	s l ɪ ʃ ɛ t
sléz	s l ɛː s
slíbit	s l iː b ɪ t
slída	s l iː d a
slíva	s l iː v a
smažený	s m a ʒ ɛ n iː
smetana	s m ɛ t a n a
smetiště	s m ɛ c ɪ ʃ c ɛ
smeč	s m ɛ t ʃ
smečař	s m ɛ t ʃ a r̝̊
smlouva	s m l o u̯ v a
smradlavý	s m r a d l a v iː
smrdět	s m r̩ ɟ ɛ t
smrž	s m r ʃ
smysl	s m ɪ s l
smích	s m iː x
smíchov	s m iː x ɔ v
směnárna	s m j ɛ n aː r n a
směr	s m ɲ ɛ r
směrovka	s m j ɛ r o v k a
smět	s m ɲ ɛ t
smůla	s m uː l a
snažit	s n a ʒ ɪ t
snoubenka	s n o u̯ b ɛ ŋ k a
sníh	s ɲ iː x
sněhulák	s ɲ ɛ ɦ ʊ l aː k
sněžit	s ɲ ɛ ʒ ɪ t
sněžnice	s ɲ ɛ ʒ ɲ ɪ t s ɛ
sob	s o p
sobě	s ɔ b j ɛ
socha	s o x a
sochař	s o x a r̝̊
souboj	s ɔ ʊ̯ b ɔ j
soucit	s ɔ ʊ̯ t s ɪ t
soud	s ɔ ʊ̯ t
soudce	s o u̯ t t͡s ɛ
souhlasit	s o u̯ ɦ l a s ɪ t
souhláska	s ɔ ʊ̯ ɦ l aː s k a
soulož	s ɔ ʊ̯ l ɔ ʃ
soused	s o u̯ s ɛ t
součástka	s ɔ ʊ̯ t ʃ aː s t k a
spadat	s p a d a t
spirální	s p ɪ r aː l ɲ iː
spirálný	s p ɪ r aː l n iː
spisovatel	s p ɪ s o v a t ɛ l
splatit	s p l a c ɪ t
splatitelný	s p l a c ɪ t ɛ l n iː
splácet	s p l aː t͡s ɛ t
splést	s p l ɛː s t
spojení	s p o j ɛ ɲ iː
spojený	s p o j ɛ n iː
spojka	s p o j k a
spojovatel	s p o j o v a t ɛ l
spokojený	s p o k o j ɛ n iː
společně	s p ɔ l ɛ t ʃ ɲ ɛ
sporák	s p o r aː k
spočítat	s p o t͡ʃ iː t a t
spořilov	s p ɔ r̝ ɪ l ɔ v
sprcha	s p r̩ x a
správa	s p r aː v a
správce	s p r aː v t͡s ɛ
správný	s p r aː v n iː
správně	s p r aː v ɲ ɛ
spáč	s p aː t͡ʃ
spíme	s p iː m ɛ
spíš	s p iː ʃ
spíše	s p iː ʃ ɛ
srpen	s r̩ p ɛ n
srst	s r̩ s t
srát	s r aː t
sráč	s r aː t͡ʃ
stanice	s t a ɲ ɪ t͡s ɛ
starat	s t a r a t
starý	s t a r iː
starších	s t a r ʃ iː x
starším	s t a r ʃ iː m
statici	s t a t ɪ t͡s ɪ
statik	s t a t ɪ k
status	s t a t u s
staveniště	s t a v ɛ ɲ ɪ ʃ c ɛ
stavět	s t a v j ɛ t
stačit	s t a t͡ʃ ɪ t
stať	s t a c
stažený	s t a ʒ ɛ n iː
stejně	s t ɛ j ɲ ɛ
step	s t ɛ p
stole	s t o l ɛ
stolech	s t o l ɛ x
stolem	s t o l ɛ m
století	s t o l ɛ c iː
stolu	s t o l u
stoly	s t o l ɪ
stolů	s t o l uː
stolům	s t o l uː m
strdlice	s t r̩ d l ɪ t s ɛ
strom	s t r o m
stroncium	s t r o n t s ɪ j ʊ m
strávit	s t r aː v ɪ t
strýc	s t r iː t͡s
student	s t u d ɛ n t
studený	s t u d ɛ n iː
studovat	s t u d o v a t
stupeň	s t u p ɛ ɲ
stupidita	s t u p ɪ d ɪ t a
stydlivý	s t ɪ d l ɪ v iː
stydět	s t ɪ ɟ ɛ t
stáhnout	s t aː ɦ n ɔ ʊ̯ t
stále	s t aː l ɛ
stárnout	s t aː r n o u̯ t
stávat	s t aː v a t
stíhačka	s c iː ɦ a t͡ʃ k a
stín	s c iː n
stírat	s c iː r a t
stěžovat	s c ɛ ʒ o v a t
střed	s t r̝̊ ɛ t
střela	s t r̝̊ ɛ l a
střep	s t r̝̊ ɛ p
střevo	s t r̝̊ ɛ v o
stříbro	s t r̝̊ iː b r o
stůl	s t uː l
su	s u
sudetský	s ʊ d ɛ t s k iː
sukně	s u k ɲ ɛ
supercela	s ʊ p ɛ r t s e l a
suvenýr	s u v e n iː r
suši	s ʊ ʃ i
sušička	s u ʃ ɪ t͡ʃ k a
svatba	s v a d b a
svatokopecká	s v a t o k o p ɛ t͡s k aː
svatokopecký	s v a t o k o p ɛ t͡s k iː
svoboda	s v ɔ b ɔ d a
svobodný	s v ɔ b ɔ d n iː
svorkovač	s v ɔ r k ɔ v a t͡ʃ
své	s v ɛː
svítil	s v iː c ɪ l
svítit	s v iː c ɪ t
svět	s v j ɛ t
světlý	s v j ɛ t l iː
svůj	s v uː j
sál	s aː l
sám	s aː m
sídlit	s iː d l ɪ t
sója	s oː j a
sójový	s oː j o v iː
sýr	s iː r
sýrie	s iː r ɪ j ɛ
sčítat	s t͡ʃ ɪ t a t
ta	t a
tacháč	t a x aː t͡ʃ
tady	t a d ɪ
tahák	t a ɦ aː k
taj	t a j
tak	t a k
takový	t a k o v iː
také	t a k ɛː
tam	t a m
tamten	t a m t ɛ n
tancovat	t a n t͡s o v a t
tanec	t a n ɛ t s
tanju	t a n j u
tantal	t a n t a l
tančit	t a n t͡ʃ ɪ t
taška	t a ʃ k a
tchoř	t x o r̝̊
tchyně	t x iː ɲ ɛ
tchyně	t x ɪ ɲ ɛ
technecium	t ɛ x n ɛː t s ɪ j ʊ m
tehdy	t ɛ ɦ d ɪ
tekutý	t ɛ k u t iː
telecí	t ɛ l ɛ t͡s iː
telefon	t ɛ l ɛ f o n
telefonní	t ɛ l ɛ f o ɲː iː
telegraf	t ɛ l ɛ ɡ r a f
telegrafe	t ɛ l ɛ ɡ r a f ɛ
telegrafech	t ɛ l ɛ ɡ r a f ɛ x
telegrafem	t ɛ l ɛ ɡ r a f ɛ m
telegrafu	t ɛ l ɛ ɡ r a f u
telegrafy	t ɛ l ɛ ɡ r a f ɪ
telegrafů	t ɛ l ɛ ɡ r a f uː
telegrafům	t ɛ l ɛ ɡ r a f uː m
televize	t ɛ l ɛ v ɪ z ɛ
televizor	t ɛ l ɛ v ɪ z o r
tellur	t ɛ l u r
templář	t ɛ m p l aː r̝̊
tenhle	t ɛ n ɦ l ɛ
teplo	t ɛ p l o
teplota	t ɛ p l o t a
teplý	t ɛ p l iː
termitiště	t ɛ r m ɪ c ɪ ʃ c ɛ
terorista	t ɛ r o r ɪ s t a
tesák	t ɛ s aː k
teta	t ɛ t a
tečka	t ɛ t͡ʃ k a
tis	c ɪ s
tiskárna	c ɪ s k aː r n a
titr	t ɪ t r̩
titulek	t ɪ t u l ɛ k
tišit	c ɪ ʃ ɪ t
tleskat	t l ɛ s k a t
tmavý	t m a v iː
toaleta	t o a l ɛ t a
tolik	t o l ɪ k
tombola	t ɔ m b ɔ l a
topení	t o p ɛ ɲ iː
topič	t o p ɪ t͡ʃ
torba	t o r b a
torbami	t o r b a m ɪ
torbo	t o r b o
torbou	t o r b o ʊ̯
torbu	t o r b u
torby	t o r b ɪ
torbách	t o r b aː x
torbám	t o r b aː m
torbě	t o r b j ɛ
továrna	t o v aː r n a
tož	t ɔ ʃ
tramvaj	t r a m v a j
tramvaják	t r a m v a j aː k
trauma	t r a ʊ̯ m a
travička	t r a v ɪ t ʃ k a
treska	t r ɛ s k a
trigraf	t r ɪ ɡ r a f
triko	t r ɪ k o
trn	t r̩ n
trochu	t r o x u
trouba	t r o u̯ b a
trsátko	t r̩ s aː t k o
trubec	t r u b ɛ t͡s
trvat	t r̩ v a t
trója	t r oː j a
tu	t u
tudy	t ʊ d ɪ
tulipán	t u l ɪ p aː n
tunel	t u n ɛ l
tupý	t ʊ p iː
turista	t u r ɪ s t a
turistka	t u r ɪ s t k a
turkmence	t u r k m ɛ n t͡s ɛ
turkmenka	t u r k m ɛ ŋ k a
turkmenkami	t u r k m ɛ ŋ k a m ɪ
turkmenko	t u r k m ɛ ŋ k o
turkmenkou	t u r k m ɛ ŋ k o u̯
turkmenku	t u r k m ɛ ŋ k u
turkmenky	t u r k m ɛ ŋ k ɪ
turkmenkách	t u r k m ɛ ŋ k aː x
turkmenkám	t u r k m ɛ ŋ k aː m
turkmenština	t u r k m ɛ n ʃ c ɪ n a
turnaj	t u r n a j
turín	t ʊ r iː n
tuňák	t u ɲ aː k
tužka	t u ʃ k a
tvrdý	t v r̩ d iː
tvář	t v aː r̝̊
tvářit	t v aː r̝ ɪ t
ty	t ɪ
tykev	t ɪ k ɛ v
tymián	t ɪ m ɪ j aː n
typický	t ɪ p ɪ t͡s k iː
tác	t aː t s
tápat	t aː p a t
táta	t aː t a
téci	t ɛː t͡s ɪ
téct	t ɛː t͡s t
téměř	t ɛː m ɲ ɛ r̝̊
tým	t iː m
těžba	c ɛ ʒ b a
těžiště	c ɛ ʒ ɪ ʃ c ɛ
těžký	c ɛ ʃ k iː
třasořitka	t r̝̊ a s ɔ r̝ ɪ t k a
třešně	t r̝̊ ɛ ʃ ɲ ɛ
třikrát	t r̝̊ ɪ k r aː t
třída	t r̝̊ iː d a
třískat	t r̝̊ iː s k a t
třísknout	t r̝̊ iː s k n o ʊ̯ t
třít	t r̝̊ iː t
tůň	t uː ɲ
u	u
ubohý	u b o ɦ iː
ubožák	ʊ b ɔ ʒ aː k
ubrousek	u b r o u̯ s ɛ k
ubrus	u b r u s
ucho	u x o
udavač	ʔ u d a v a t͡ʃ
udělal	u ɟ ɛ l a l
udělat	u ɟ ɛ l a t
uděšený	u ɟ ɛ ʃ ɛ n iː
ukazovat	u k a z o v a t
ukončit	u k o n t͡ʃ ɪ t
ukrást	u k r aː s t
ukázat	u k aː z a t
ulic	u l ɪ t s
ulice	u l ɪ t͡s ɛ
ulici	u l ɪ t͡s ɪ
ulicí	u l ɪ t͡s iː
umírat	u m iː r a t
umýt	u m iː t
umělkyně	u m j ɛ l k ɪ ɲ ɛ
umění	u m ɲ ɛ ɲ iː
umět	u m ɲ ɛ t
univerzál	u n ɪ v ɛ r z aː l
uprostřed	u p r o s t r̝̊ ɛ t
upřímný	u p r̝̊ iː m n iː
urazit	u r a z ɪ t
urbanizace	ʊ r b a n ɪ z a t s ɛ
urážet	u r aː ʒ ɛ t
určitě	u r t͡ʃ ɪ c ɛ
useknout	ʔ ʊ s ɛ k n ɔ ʊ̯ t
utratit	u t r a c ɪ t
utrácet	u t r aː t͡s ɛ t
uvidět	u v ɪ ɟ ɛ t
uvěřit	u v j ɛ r̝ ɪ t
ušák	u ʃ aː k
užitečný	u ʒ ɪ t ɛ t͡ʃ n iː
užší	ʔ ʊ ʃ iː
v	v
vaječný	v a j ɛ t͡ʃ n iː
vajíčko	v a j iː t͡ʃ k o
val	v a l
vana	v a n a
vata	v a t a
vchod	v x o t
ve	v ɛ
vegetarián	v ɛ ɡ ɛ t a r ɪ j aː n
vegetativní	v ɛ ɡ ɛ t a t ɪ v ɲ iː
velikost	v ɛ l ɪ k o s t
veliký	v ɛ l ɪ k iː
velký	v ɛ l k iː
velmi	v ɛ l m ɪ
velodrom	v ɛ l ɔ d r ɔ m
venku	v ɛ ŋ k u
vepř	v ɛ p r̝̊
vepřovice	v ɛ p r̝̊ o v ɪ t͡s ɛ
vepřové	v ɛ p r̝̊ o v ɛː
vepřík	v ɛ p r̝̊ iː k
ves	v ɛ s
veselý	v ɛ s ɛ l iː
vesmír	v ɛ s m iː r
vez	v ɛ s
večer	v ɛ t͡ʃ ɛ r
večerní	v ɛ t͡ʃ ɛ r ɲ iː
večeře	v ɛ t͡ʃ ɛ r̝ ɛ
vhazování	v ɦ a z o v aː ɲ iː
vidle	v ɪ d l ɛ
vidlička	v ɪ d l ɪ t͡ʃ k a
vina	v ɪ n a
vinna	v ɪ n a
viset	v ɪ s ɛ t
višnu	v ɪ ʃ n ʊ
vlak	v l a k
vlas	v l a s
vlastnictví	v l a s t ɲ ɪ t s t v iː
vlastní	v l a s t ɲ iː
vlastník	v l a s t ɲ iː k
vlevo	v l ɛ v o
vloni	v l o ɲ ɪ
vláda	v l aː d a
vměšovat	v m j ɛ ʃ o v a t
vměšování	v m j ɛ ʃ o v aː ɲ iː
vnitrozemský	v ɲ ɪ t r ɔ z ɛ m s k iː
vně	v ɲ ɛ
vodní	v o d ɲ iː
volant	v o l a n t
volat	v o l a t
vole	v ɔ l ɛ
volejbal	v ɔ l ɛ j b a l
volejbalista	v ɔ l ɛ j b a l ɪ s t a
volit	v o l ɪ t
volný	v o l n iː
vonět	v o ɲ ɛ t
voňavý	v ɔ ɲ a v iː
vpravo	v p r a v o
vracet	v r aː t͡s ɛ t
vrátit	v r aː c ɪ t
vstup	f s t u p
vstupenka	f s t u p ɛ ŋ k a
vtipný	v c ɪ p n iː
vy	v ɪ
vybarvit	v ɪ b a r v ɪ t
vybrat	v ɪ b r a t
vybírat	v ɪ b iː r a t
vydělat	v ɪ ɟ ɛ l aː t
vydělávat	v ɪ ɟ ɛ l aː v a t
vyděrač	v ɪ ɟ ɛ r a t ʃ
vyděsit	v ɪ ɟ ɛ s ɪ t
vyhledat	v ɪ ɦ l ɛ d a t
vyhrát	v ɪ ɦ r aː t
vyhrávat	v ɪ ɦ r aː v a t
vyjadřovat	v ɪ j a d r̝ o v a t
vyjádřit	v ɪ j aː d r̝ ɪ t
vykoupivše	v ɪ k ɔ ʊ̯ p ɪ f ʃ ɛ
vynadat	v ɪ n a d a t
vynález	v ɪ n aː l ɛ s
vypadat	v ɪ p a d a t
vypadá	v ɪ p a d aː
vypočítat	v ɪ p o t͡ʃ iː t a t
vypínač	v ɪ p iː n a t͡ʃ
vyrábět	v ɪ r aː b j ɛ t
vysoká	v ɪ s o k aː
vysoký	v ɪ s o k iː
vystavit	v ɪ s t a v ɪ t
vystavovat	v ɪ s t a v ɔ v a t
vystoupiv	v ɪ s t ɔ ʊ̯ p ɪ f
vystupovat	v ɪ s t u p o v a t
vysvědčení	v ɪ s v j ɛ t t͡ʃ ɛ ɲ iː
vysvětlit	v ɪ s v j ɛ t l ɪ t
vytvořit	v ɪ t v o r̝ ɪ t
vytvářet	v ɪ t v aː r̝ ɛ t
vyšetřit	v ɪ ʃ ɛ t r̝̊ ɪ t
vyšetřovat	v ɪ ʃ ɛ t r̝̊ o v a t
vyšetřování	v ɪ ʃ ɛ t r̝̊ o v aː ɲ iː
vzduch	v z d u x
vzpomínka	v s p o m iː ŋ k a
vztah	v s t a x
váha	v aː ɦ a
vánočka	v aː n o t͡ʃ k a
vápno	v aː p n ɔ
váš	v aː ʃ
vážit	v aː ʒ ɪ t
vážný	v aː ʒ n iː
vést	v ɛː s t
víkend	v iː k ɛ n t
víno	v iː n o
víra	v iː r a
víte	v iː t ɛ
vítězit	v iː c ɛ z ɪ t
výborný	v iː b ɔ r n iː
východní	v iː x o d ɲ iː
výfuk	v iː f u k
výplata	v iː p l a t a
výsledek	v iː s l ɛ d ɛ k
výsledovka	v iː s l ɛ d o f k a
výstava	v iː s t a v a
výstižný	v iː s c ɪ ʒ n iː
výtah	v iː t a x
vývěva	v iː v j ɛ v a
výzkum	v iː s k u m
včera	v t͡ʃ ɛ r a
věc	v j ɛ t͡s
věci	v j ɛ t s ɪ
vědec	v j ɛ d ɛ t͡s
vědecký	v j ɛ d ɛ t͡s k iː
vědomě	v j ɛ d ɔ m ɲ ɛ
věk	v j ɛ k
věta	v j ɛ t a
větráček	v j ɛ t r aː k
věřit	v j ɛ r̝ ɪ t
vřeteno	v r̝ ɛ t ɛ n ɔ
vřískat	v r̝̊ iː s k a t
vřísknout	v r̝ iː s k n o ʊ̯ t
vřít	v r̝ iː t
všeobecný	f ʃ ɛ o b ɛ t͡s n iː
všude	v ʃ u d ɛ
vůbec	v uː b ɛ t͡s
vůz	v uː s
vždy	v ʒ d ɪ
z	z
za	z a
zadní	z a d ɲ iː
zadák	z a d aː k
zahajovat	z a ɦ a j o v a t
zahájit	z a ɦ aː j ɪ t
zajímat	z a j iː m a t
zajímavý	z a j iː m a v iː
zamilovaný	z a m ɪ l o v a n iː
zamilovat	z a m ɪ l o v a t
zamykat	z a m ɪ k a t
zaměstnání	z a m j ɛ s t n aː ɲ iː
zanedbatelný	z a n ɛ d b a t ɛ l n iː
zapalování	z a p a l o v aː ɲ iː
zaparkovat	z a p a r k o v a t
zaplatit	z a p l a c ɪ t
zapomínat	z a p o m iː n a t
zase	z a s ɛ
zastavit	z a s t a v ɪ t
zastavovat	z a s t a v o v a t
zastávka	z a s t aː v k a
zastřít	z a s t r̝̊ iː t
zatvářit	z a t v aː r̝ ɪ t
zatímco	z a c iː m t͡s o
zavazadlo	z a v a z a d l o
zavolat	z a v o l a t
zavírat	z a v iː r a t
zavřený	z a v r̝ ɛ n iː
zavřít	z a v r̝ iː t
zazpívat	z a s p iː v a t
začátek	z a t͡ʃ aː t ɛ k
začínat	z a t͡ʃ iː n a t
začít	z a t͡ʃ iː t
zboží	z b o ʒ iː
zbytečný	z b ɪ t ɛ t͡ʃ n iː
zbytečně	z b ɪ t ɛ t͡ʃ ɲ ɛ
zbývat	z b iː v a t
zdarma	z d a r m a
zdeněk	z d ɛ ɲ ɛ k
zdravý	z d r a v iː
zdroj	z d r o j
ze	z ɛ
zebra	z ɛ b r a
zelenina	z ɛ l ɛ ɲ ɪ n a
zelenooký	z ɛ l ɛ n o ʔ o k iː
zelí	z ɛ l iː
zemětřesení	z ɛ m ɲ ɛ t r̝ ɛ s ɛ ɲ iː
zeptat	z ɛ p t a t
zhasnout	z ɦ a s n ɔ ʊ̯ t
zhebnout	z ɦ e b n ɔ ʊ̯ t
zinky	z ɪ n k ɪ
zirkonium	z ɪ r k ɔ n ɪ j ʊ m
zklamaný	s k l a m a n iː
zklamat	s k l a m a t
zkouška	s k o u̯ ʃ k a
zkumavka	s k ʊ m a f k a
zkusit	s k u s ɪ t
zkušený	s k u ʃ ɛ n iː
zlatý	z l a t iː
zlobit	z l o b ɪ t
zmanipulovaný	z m a n ɪ p u l o v a n iː
zmena	s m ɛ n a
zmena	z m ɛ n a
zmrznout	z m r̩ z n ɔ ʊ̯ t
změnit	z m j ɛ ɲ ɪ t
změřit	z m j ɛ r̝ ɪ t
znalost	z n a l o s t
znamenat	z n a m ɛ n a t
značka	z n a t͡ʃ k a
znečištění	z n ɛ t͡ʃ ɪ ʃ c ɛ ɲ iː
zničit	z ɲ ɪ t͡ʃ ɪ t
znova	z n ɔ v a
známka	z n aː m k a
známý	z n aː m iː
znát	z n aː t
znít	z ɲ iː t
zpodstatnění	z p ɔ d s t a ɟ ɛ ɲ iː
zpomalit	s p o m a l ɪ t
zpoždění	s p o ʒ ɟ ɛ ɲ iː
zpráva	s p r aː v a
zpětný	s p j ɛ t n iː
zpěvačka	s p j ɛ v a t͡ʃ k a
zpěvák	s p j ɛ v aː k
zranit	z r a ɲ ɪ t
zrát	z r aː t
ztratit	s t r a c ɪ t
ztrácet	s t r aː t͡s ɛ t
ztráta	s t r aː t a
zub	z u p
zubní	z u b ɲ iː
zuř	z ʊ r̝̊
zvláštní	z v l aː ʃ t ɲ iː
zvlášť	z v l aː ʃ c
zvolání	z v o l aː ɲ iː
zvát	z v aː t
zvítězit	z v iː c ɛ z ɪ t
zvíře	z v iː r̝ ɛ
záchod	z aː x o t
záchranný	z aː x r a nː iː
zácpa	z aː t͡s p a
zákaz	z aː k a s
základní	z aː k l a d ɲ iː
západ	z aː p a t
západní	z aː p a d ɲ iː
zásaditý	z aː s a ɟ ɪ t iː
závojenkovité	z aː v o j ɛ ŋ k o v ɪ t ɛː
zázvor	z aː z v o ɾ
zář	z aː r̝̊
září	z aː r̝ iː
zítra	z iː t r a
zívat	z iː v a t
zívnout	z iː v n o u̯ t
zřejmý	z r̝ ɛ j m iː
zřídka	z r̝ iː t k a
zřídlo	z r̝ iː d l o
zřít	z r̝ iː t
zřítit	z r̝ iː c ɪ t ‿ s ɛ
zůstat	z uː s t a t
zůstávat	z uː s t aː v a t
áčko	aː t ʃ k o
úkol	uː k o l
úkryt	uː k r ɪ t
úlitba	ʔ uː l ɪ d b a
úložiště	ʔ uː l ɔ ʒ ɪ ʃ c ɛ
úmysl	uː m ɪ s l̩
úmyslný	uː m ɪ s l̩ n iː
úmyslně	uː m ɪ s l̩ ɲ ɛ
únor	uː n o r
úplně	uː p l̩ ɲ ɛ
úrokový	uː r ɔ k ɔ v iː
úsměv	uː s m j ɛ v
úspěšný	uː s p j ɛ ʃ n iː
úspěšně	uː s p j ɛ ʃ ɲ ɛ
ústřice	uː s t r̝̊ ɪ t͡s ɛ
útok	uː t o k
útokovka	uː t o k o f k a
útočiště	ʔ u t ɔ t͡ʃ ɪ ʃ c ɛ
úzký	uː s k iː
účet	uː t͡ʃ ɛ t
účetní	uː t͡ʃ ɛ t ɲ iː
čaj	t ʃ a j
čas	t͡ʃ a s
často	t͡ʃ a s t o
čechy	t͡ʃ ɛ x ɪ
čekat	t͡ʃ ɛ k a t
čeká	t͡ʃ ɛ k aː
čekárna	t͡ʃ ɛ k aː r n a
černobílý	t͡ʃ ɛ r n o b iː l iː
červen	t͡ʃ ɛ r v ɛ n
červenec	t͡ʃ ɛ r v ɛ n ɛ t͡s
česky	t͡ʃ ɛ s k ɪ
český	t͡ʃ ɛ s k iː
čeština	t͡ʃ ɛ ʃ c ɪ n a
čirůvka	t͡ʃ ɪ r uː f k a
čirůvkovité	t͡ʃ ɪ r uː f k o v ɪ t ɛː
čistý	t͡ʃ ɪ s t iː
člověk	t͡ʃ l o v j ɛ k
člun	t͡ʃ l u n
čokl	t ʃ o k l̩
čokoláda	t͡ʃ o k o l aː d a
čolek	t͡ʃ o l ɛ k
čoveče	t ʃ ɔ v ɛ t ʃ ɛ
čtyřikrát	t͡ʃ t ɪ r̝ ɪ k r aː t
čučet	t͡ʃ ʊ t͡ʃ ɛ t
čvachtat	t͡ʃ v a χ t a t
čára	t ʃ aː r a
čárka	t͡ʃ aː r k a
čárky	t͡ʃ aː r k ɪ
čéče	t ʃ ɛː t ʃ ɛ
čí	t͡ʃ iː
číslo	t͡ʃ iː s l o
číst	t͡ʃ iː s t
číšník	t͡ʃ iː ʃ ɲ iː k
ň	ɲ
ř	r̝
ř	r̝̊
řada	r̝ a d a
ředitel	r̝ ɛ ɟ ɪ t ɛ l
ředkvička	r̝ ɛ t k v ɪ t͡ʃ k a
řek	r̝ ɛ k
řeka	r̝ ɛ k a
řekl	r̝ ɛ k l̩
řeku	r̝ ɛ k u
řepa	r̝ ɛ p a
řezem	r̝ ɛ z ɛ m
řeznictví	r̝ ɛ z ɲ ɪ t͡s t v iː
řečiště	r̝ ɛ t͡ʃ ɪ ʃ c ɛ
řiditelný	r̝ ɪ ɟ ɪ t ɛ l n iː
řidič	r̝ ɪ ɟ ɪ t͡ʃ
řidičský	r̝ ɪ ɟ ɪ t͡ʃ s k iː
řád	r̝ aː t
řídit	r̝ iː ɟ ɪ t
říjen	r̝ iː j ɛ n
říkal	r̝ iː k a l
říkávat	r̝ iː k aː v a t
šabat	ʃ a b a t
šach	ʃ a x
šafron	ʃ a f r ɔ n
šafrán	ʃ a f r aː n
šalvěj	ʃ a l v j ɛ j
šamšír	ʃ a m ʃ iː r
šapitó	ʃ a p ɪ t ɔː
šarka	ʃ a r k a
šarlatán	ʃ a r l a t aː n
šat	ʃ a t
šaty	ʃ a t ɪ
šavle	ʃ a v l ɛ
šed	ʃ ɛ t
šedše	ʃ ɛ t ʃ ɛ
šedši	ʃ ɛ t ʃ ɪ
šek	ʃ ɛ k
šerm	ʃ ɛ r m
šermovat	ʃ ɛ r m ɔ v a t
šestky	ʃ ɛ s t k ɪ
šetří	ʃ ɛ t r̝ iː
šifra	ʃ ɪ f r a
šikula	ʃ ɪ k u l a
šimitar	ʃ ɪ m ɪ t a r
široký	ʃ ɪ r o k iː
šizuňk	ʃ ɪ z ʊ ɲ k
šiška	ʃ ɪ ʃ k a
škeble	ʃ k ɛ b l ɛ
škodolibý	ʃ k o d o l ɪ b iː
škola	ʃ k o l a
šlapat	ʃ l a p a t
šlápnout	ʃ l aː p n o ʊ̯ t
špatně	ʃ p a t ɲ ɛ
špenát	ʃ p ɛ n aː t
šperk	ʃ p ɛ r k
špinavý	ʃ p ɪ n a v iː
šraf	ʃ r a f
šrafu	ʃ r a f u
šrafy	ʃ r a f ɪ
šroubovák	ʃ r o ʊ̯ b o v aː k
štoudev	ʃ t ɔ ʊ̯ d ɛ f
štrúdl	ʃ t r uː d l̩
štítovka	ʃ c iː t o f k a
štítovkovité	ʃ c iː t o f k o v ɪ t ɛː
štědrovečerní	ʃ c ɛ d r o v ɛ t͡ʃ ɛ r ɲ iː
štětec	ʃ c ɛ t ɛ t͡s
šumafuk	ʃ ʊ m a f ʊ k
šunka	ʃ u ŋ k a
šutr	ʃ u t r̩
švestka	ʃ v ɛ s t k a
švéd	ʃ v ɛː t
švédka	ʃ v ɛː t k a
šáh	ʃ aː x
šálek	ʃ aː l ɛ k
šárka	ʃ aː r k a
šéfka	ʃ ɛː f k a
šťastnou	ʃ c a s t n ɔ ʊ̯
šťastně	ʃ c a s t ɲ ɛ
žampion	ʒ a m p ɪ j o n
žampion	ʒ a m p ɪ j oː n
žampión	ʒ a m p ɪ j oː n
že	ʒ ɛ
žehlička	ʒ ɛ ɦ l ɪ t͡ʃ k a
žehnat	ʒ ɛ ɦ n a t
želva	ʒ ɛ l v a
ženatý	ʒ ɛ n a t iː
žirafa	ʒ ɪ r a f a
živý	ʒ ɪ v iː
žižkov	ʒ ɪ ʒ k ɔ v
žrát	ʒ r aː t
žvýkat	ʒ v iː k a t
žvýkačka	ʒ v iː k a t͡ʃ k a
žába	ʒ aː b a
žák	ʒ aː k
žákyně	ʒ aː k ɪ ɲ ɛ
žánr	ʒ aː n r̩
žár	ʒ aː r
žít	ʒ iː t
žížala	ʒ iː ʒ a l a
